Date,Hour,NUCLEAR,GAS,HYDRO,WIND,SOLAR,BIOFUEL,Total Output
1/1/2016,1,11188,919,2994,1255,0,3,16359
1/1/2016,2,11021,918,2999,1483,0,3,16424
1/1/2016,3,10904,920,3012,1133,0,8,15977
1/1/2016,4,10425,922,3005,1347,0,7,15706
1/1/2016,5,10411,921,3030,1176,0,2,15540
1/1/2016,6,10412,920,2998,1252,0,2,15584
1/1/2016,7,10411,921,3074,1469,0,2,15877
1/1/2016,8,10415,922,3127,1762,0,2,16228
1/1/2016,9,10412,920,3362,1652,1,2,16349
1/1/2016,10,10414,919,3482,1766,12,2,16595
1/1/2016,11,10414,921,3747,2024,33,3,17142
1/1/2016,12,10409,918,3779,2324,103,2,17535
1/1/2016,13,10410,914,3804,2684,89,2,17903
1/1/2016,14,10485,911,3738,2806,71,2,18013
1/1/2016,15,10710,910,3644,2609,25,2,17900
1/1/2016,16,10715,913,3667,2569,25,2,17891
1/1/2016,17,11045,917,4183,2244,3,2,18394
1/1/2016,18,11425,924,4882,2154,0,2,19387
1/1/2016,19,11542,923,4897,2022,0,2,19386
1/1/2016,20,11543,920,4663,1862,0,2,18990
1/1/2016,21,11539,921,4361,1804,0,2,18627
1/1/2016,22,11521,921,4114,1741,0,2,18299
1/1/2016,23,11528,923,3426,1415,0,2,17294
1/1/2016,24,11523,922,3125,1412,0,2,16984
1/2/2016,1,11385,920,3166,1125,0,2,16598
1/2/2016,2,11018,922,3193,1238,0,2,16373
1/2/2016,3,11012,918,3098,1131,0,2,16161
1/2/2016,4,11012,921,3079,837,0,2,15851
1/2/2016,5,11020,921,3075,946,0,2,15964
1/2/2016,6,11018,920,3131,1020,0,2,16091
1/2/2016,7,11021,920,3215,1429,0,2,16587
1/2/2016,8,11181,920,3218,1306,0,2,16627
1/2/2016,9,11488,922,3339,1338,6,2,17095
1/2/2016,10,11560,921,3679,1566,4,2,17732
1/2/2016,11,11563,918,4057,1608,14,2,18162
1/2/2016,12,11559,917,4128,1744,19,2,18369
1/2/2016,13,11561,917,3930,1922,32,2,18364
1/2/2016,14,11520,918,3899,1552,21,2,17912
1/2/2016,15,11556,914,3895,1552,12,2,17931
1/2/2016,16,11557,934,3967,1901,5,7,18371
1/2/2016,17,11555,940,4139,2220,0,6,18860
1/2/2016,18,11557,945,4563,2735,0,6,19806
1/2/2016,19,11565,911,4573,2806,0,6,19861
1/2/2016,20,11570,908,4351,2714,0,6,19549
1/2/2016,21,11563,904,4192,2098,0,6,18763
1/2/2016,22,11555,911,3921,2071,0,6,18464
1/2/2016,23,11557,915,3432,1895,0,6,17805
1/2/2016,24,11494,915,3098,1892,0,6,17405
1/3/2016,1,11091,915,3114,1834,0,6,16960
1/3/2016,2,10726,911,3052,1542,0,6,16237
1/3/2016,3,10414,915,3127,1552,0,6,16014
1/3/2016,4,10416,915,3131,1395,0,5,15862
1/3/2016,5,10415,918,3173,1296,0,5,15807
1/3/2016,6,10414,921,3145,1582,0,5,16067
1/3/2016,7,10659,918,3220,1609,0,5,16411
1/3/2016,8,11142,913,3239,1523,0,5,16822
1/3/2016,9,11445,955,3325,1073,1,4,16803
1/3/2016,10,11561,1013,3400,1251,11,6,17242
1/3/2016,11,11558,1022,3444,1895,46,8,17973
1/3/2016,12,11566,1048,3564,1789,44,14,18025
1/3/2016,13,11568,1152,3723,1734,39,9,18225
1/3/2016,14,11563,1236,4041,1354,46,17,18257
1/3/2016,15,11561,1273,4078,1255,41,18,18226
1/3/2016,16,11564,1278,4160,1372,32,7,18413
1/3/2016,17,11559,1358,4539,1779,3,8,19246
1/3/2016,18,11556,1372,5675,1786,0,6,20395
1/3/2016,19,11546,1362,5960,1664,0,3,20535
1/3/2016,20,11547,1442,6013,1296,0,1,20299
1/3/2016,21,11541,1333,5772,993,0,1,19640
1/3/2016,22,11538,1416,5520,845,0,2,19321
1/3/2016,23,11543,1145,5062,798,0,11,18559
1/3/2016,24,11536,979,4465,765,0,28,17773
1/4/2016,1,11547,1005,4193,694,0,36,17475
1/4/2016,2,11552,1024,3920,662,0,41,17199
1/4/2016,3,11565,1167,3891,343,0,48,17014
1/4/2016,4,11408,1351,3946,183,0,42,16930
1/4/2016,5,11092,1621,3963,454,0,40,17170
1/4/2016,6,11015,1890,4032,907,0,46,17890
1/4/2016,7,11289,2301,4386,1007,0,54,19037
1/4/2016,8,11564,2346,4927,1275,0,57,20169
1/4/2016,9,11559,2380,5160,1209,25,56,20389
1/4/2016,10,11556,2405,5273,1321,104,58,20717
1/4/2016,11,11554,2320,4724,1529,173,53,20353
1/4/2016,12,11595,2482,4577,1427,180,56,20317
1/4/2016,13,11599,2302,4484,1406,140,51,19982
1/4/2016,14,11604,2356,4550,1468,142,46,20166
1/4/2016,15,11605,2642,4622,1306,104,47,20326
1/4/2016,16,11602,3062,4752,1208,58,50,20732
1/4/2016,17,11552,3775,5985,895,10,64,22281
1/4/2016,18,11548,5043,6219,686,0,111,23607
1/4/2016,19,11547,5026,6017,648,0,176,23414
1/4/2016,20,11544,4551,5986,637,0,133,22851
1/4/2016,21,11535,4387,5933,620,0,155,22630
1/4/2016,22,11527,3957,5930,512,0,173,22099
1/4/2016,23,11522,2881,5618,511,0,143,20675
1/4/2016,24,11530,2200,5144,480,0,81,19435
1/5/2016,1,11530,1840,5142,455,0,35,19002
1/5/2016,2,11532,1369,5076,421,0,20,18418
1/5/2016,3,11538,1396,5053,355,0,19,18361
1/5/2016,4,11541,1458,4985,420,0,12,18416
1/5/2016,5,11539,1891,4595,480,0,18,18523
1/5/2016,6,11537,2619,4590,545,0,21,19312
1/5/2016,7,11545,3510,5639,564,0,29,21287
1/5/2016,8,11542,4183,6004,632,0,36,22397
1/5/2016,9,11534,4521,6068,689,29,37,22878
1/5/2016,10,11537,3783,5850,659,104,45,21978
1/5/2016,11,11535,3501,5700,674,161,57,21628
1/5/2016,12,11543,3385,5443,884,174,93,21522
1/5/2016,13,11541,2885,5168,1351,97,100,21142
1/5/2016,14,11736,2442,4276,1406,90,97,20047
1/5/2016,15,11767,1960,4402,1539,59,87,19814
1/5/2016,16,11762,2193,4740,1452,47,86,20280
1/5/2016,17,11759,2765,5672,1380,10,106,21692
1/5/2016,18,11754,3343,5989,1494,0,158,22738
1/5/2016,19,11747,3391,6025,1706,0,156,23025
1/5/2016,20,11710,3060,5846,1959,0,100,22675
1/5/2016,21,11702,2726,5341,2104,0,93,21966
1/5/2016,22,11701,2495,4614,2140,0,87,21037
1/5/2016,23,11711,1749,3656,2195,0,86,19397
1/5/2016,24,11952,1231,3277,1723,0,77,18260
1/6/2016,1,12155,971,3022,1421,0,50,17619
1/6/2016,2,12141,942,3068,1168,0,23,17342
1/6/2016,3,12117,1049,3056,1090,0,22,17334
1/6/2016,4,11884,1231,3047,1158,0,22,17342
1/6/2016,5,11879,1339,2970,1066,0,22,17276
1/6/2016,6,11881,1339,3125,1361,0,28,17734
1/6/2016,7,12021,1339,3700,1540,0,34,18634
1/6/2016,8,12146,1356,5077,1501,0,37,20117
1/6/2016,9,12149,1357,5256,1309,21,35,20127
1/6/2016,10,12153,1359,4993,1073,93,31,19702
1/6/2016,11,12153,1074,4795,899,113,38,19072
1/6/2016,12,12163,1044,4482,839,154,37,18719
1/6/2016,13,12162,1195,4401,882,128,37,18805
1/6/2016,14,12110,1497,4503,935,141,37,19223
1/6/2016,15,12008,1819,4519,902,97,37,19382
1/6/2016,16,11796,2039,4681,1106,63,37,19722
1/6/2016,17,11802,2165,5144,1000,9,38,20158
1/6/2016,18,11801,2358,6057,1116,0,38,21370
1/6/2016,19,11809,2209,5984,1208,0,38,21248
1/6/2016,20,11811,2174,5876,1262,0,38,21161
1/6/2016,21,11802,2055,5401,1321,0,37,20616
1/6/2016,22,11798,1933,4961,1323,0,37,20052
1/6/2016,23,11796,1440,4583,1253,0,37,19109
1/6/2016,24,11792,1023,4305,1050,0,26,18196
1/7/2016,1,11797,932,3946,809,0,26,17510
1/7/2016,2,11808,940,3902,597,0,25,17272
1/7/2016,3,11835,1058,3628,572,0,23,17116
1/7/2016,4,11833,1216,3587,388,0,21,17045
1/7/2016,5,11823,1344,3649,292,0,21,17129
1/7/2016,6,11822,1378,4361,234,0,27,17822
1/7/2016,7,11830,1515,5066,182,0,35,18628
1/7/2016,8,11826,1549,5740,176,0,59,19350
1/7/2016,9,11813,1628,5710,176,29,95,19451
1/7/2016,10,11809,1628,5459,190,92,125,19303
1/7/2016,11,11814,1543,5397,196,90,120,19160
1/7/2016,12,11824,1610,5543,157,96,187,19417
1/7/2016,13,11824,1616,5334,127,84,215,19200
1/7/2016,14,11824,1925,5034,109,87,202,19181
1/7/2016,15,11829,2221,4975,94,79,161,19359
1/7/2016,16,11836,2402,5069,70,54,117,19548
1/7/2016,17,11834,2488,5362,66,10,102,19862
1/7/2016,18,11833,2615,5956,119,0,117,20640
1/7/2016,19,11833,2608,6179,250,0,193,21063
1/7/2016,20,11828,2351,5997,395,0,215,20786
1/7/2016,21,11825,2209,5675,543,0,155,20407
1/7/2016,22,11825,1663,5267,678,0,38,19471
1/7/2016,23,11506,1254,5012,776,0,37,18585
1/7/2016,24,11345,1123,4749,777,0,27,18021
1/8/2016,1,11345,952,4343,843,0,21,17504
1/8/2016,2,11342,922,3895,955,0,25,17139
1/8/2016,3,11344,922,3851,846,0,22,16985
1/8/2016,4,11332,920,3836,822,0,24,16934
1/8/2016,5,11335,920,3935,892,0,28,17110
1/8/2016,6,11339,923,3944,960,0,26,17192
1/8/2016,7,11336,926,4690,923,0,33,17908
1/8/2016,8,11339,947,5392,1056,0,36,18770
1/8/2016,9,11337,999,5400,1074,15,36,18861
1/8/2016,10,11336,948,5518,1025,43,37,18907
1/8/2016,11,11346,948,5863,856,69,39,19121
1/8/2016,12,11351,948,5806,805,71,57,19038
1/8/2016,13,11344,970,5620,707,72,74,18787
1/8/2016,14,11343,1040,5755,625,49,152,18964
1/8/2016,15,11346,1297,5417,596,29,198,18883
1/8/2016,16,11352,1352,5472,741,14,191,19122
1/8/2016,17,11351,1522,5762,960,2,179,19776
1/8/2016,18,11353,1537,5739,1240,0,159,20028
1/8/2016,19,11358,1534,5768,1378,0,131,20169
1/8/2016,20,11361,1533,5805,1414,0,103,20216
1/8/2016,21,11359,1335,5807,1538,0,142,20181
1/8/2016,22,11351,964,5406,1670,0,160,19551
1/8/2016,23,11354,943,4218,1847,0,128,18490
1/8/2016,24,11346,920,3436,1781,0,76,17559
1/9/2016,1,11351,911,3226,1263,0,26,16777
1/9/2016,2,11224,910,3221,1222,0,7,16584
1/9/2016,3,10684,910,3219,1506,0,8,16327
1/9/2016,4,10526,910,3153,1574,0,3,16166
1/9/2016,5,10529,909,3143,1570,0,0,16151
1/9/2016,6,10578,910,3166,1779,0,0,16433
1/9/2016,7,10824,908,3280,1567,0,0,16579
1/9/2016,8,10881,911,3412,1706,0,0,16910
1/9/2016,9,11243,906,3502,2290,1,0,17942
1/9/2016,10,11364,893,4092,2107,5,0,18461
1/9/2016,11,11363,857,4443,1882,12,0,18557
1/9/2016,12,11359,858,4693,1693,19,0,18622
1/9/2016,13,11357,956,4638,1512,15,0,18478
1/9/2016,14,11355,1028,4834,1311,16,0,18544
1/9/2016,15,11353,1287,5029,1069,12,0,18750
1/9/2016,16,11354,1512,5175,814,5,0,18860
1/9/2016,17,11354,1534,5733,655,1,0,19277
1/9/2016,18,11359,1700,6159,529,0,0,19747
1/9/2016,19,11361,1713,6186,559,0,0,19819
1/9/2016,20,11361,1698,5510,937,0,0,19506
1/9/2016,21,11354,1656,4523,1332,0,0,18865
1/9/2016,22,11352,1369,4022,1547,0,0,18290
1/9/2016,23,11354,987,3605,1377,0,0,17323
1/9/2016,24,11348,903,3212,1560,0,0,17023
1/10/2016,1,11210,905,3113,1149,0,0,16377
1/10/2016,2,10690,906,3109,1143,0,0,15848
1/10/2016,3,10523,890,3181,1252,0,0,15846
1/10/2016,4,10522,883,3050,1366,0,0,15821
1/10/2016,5,10533,889,3102,1400,0,0,15924
1/10/2016,6,10543,896,3230,1238,0,0,15907
1/10/2016,7,10829,880,3881,854,0,0,16444
1/10/2016,8,11119,862,4075,574,0,0,16630
1/10/2016,9,11344,858,3849,928,0,0,16979
1/10/2016,10,11344,854,3643,1691,1,0,17533
1/10/2016,11,11347,852,3958,2081,9,0,18247
1/10/2016,12,11350,853,3946,2307,8,0,18464
1/10/2016,13,11360,856,3700,2632,18,0,18566
1/10/2016,14,11352,860,3727,2610,12,0,18561
1/10/2016,15,11335,866,3728,2683,7,0,18619
1/10/2016,16,11365,868,3981,2802,2,0,19018
1/10/2016,17,11358,880,4542,2962,1,0,19743
1/10/2016,18,11360,890,5333,3126,0,0,20709
1/10/2016,19,11354,912,5540,2803,0,1,20610
1/10/2016,20,11360,917,4790,3042,0,0,20109
1/10/2016,21,11343,918,4444,3061,0,0,19766
1/10/2016,22,11341,914,4059,2892,0,0,19206
1/10/2016,23,11343,913,3669,2751,0,0,18676
1/10/2016,24,11349,917,3349,2478,0,0,18093
1/11/2016,1,11358,916,3309,1854,0,0,17437
1/11/2016,2,11202,917,3373,1279,0,4,16775
1/11/2016,3,10892,910,3391,1508,0,12,16713
1/11/2016,4,10817,912,3359,1744,0,14,16846
1/11/2016,5,10847,918,3239,2507,0,14,17525
1/11/2016,6,11176,920,3489,2115,0,22,17722
1/11/2016,7,11361,963,4331,2462,0,30,19147
1/11/2016,8,11363,1027,5182,2439,1,31,20043
1/11/2016,9,11362,1087,4980,2668,20,30,20147
1/11/2016,10,11365,1216,4499,2541,66,27,19714
1/11/2016,11,11346,1379,4385,2445,101,28,19684
1/11/2016,12,11342,1472,4535,2103,129,27,19608
1/11/2016,13,11357,1626,4654,1780,182,26,19625
1/11/2016,14,11360,1855,4688,1994,130,27,20054
1/11/2016,15,11358,2116,4617,1848,124,26,20089
1/11/2016,16,11361,2388,4741,1630,83,26,20229
1/11/2016,17,11363,2633,5018,1263,11,24,20312
1/11/2016,18,11366,2766,5639,1296,0,24,21091
1/11/2016,19,11363,2781,5697,1241,0,26,21108
1/11/2016,20,11366,2797,5959,1128,0,31,21281
1/11/2016,21,11360,2938,5794,1076,0,31,21199
1/11/2016,22,11362,2485,5470,1090,0,24,20431
1/11/2016,23,11364,1609,5215,1212,0,25,19425
1/11/2016,24,11369,1134,4859,1262,0,25,18649
1/12/2016,1,11373,913,4643,1453,0,21,18403
1/12/2016,2,11374,906,4433,1599,0,19,18331
1/12/2016,3,11374,910,4235,1733,0,20,18272
1/12/2016,4,11379,1017,3954,2085,0,19,18454
1/12/2016,5,11378,1203,3589,2197,0,20,18387
1/12/2016,6,11379,1310,3648,2117,0,24,18478
1/12/2016,7,11378,1315,4580,2082,0,30,19385
1/12/2016,8,11376,1337,5463,2310,0,26,20512
1/12/2016,9,11377,1348,5565,2401,1,25,20717
1/12/2016,10,11378,1437,5351,2490,3,32,20691
1/12/2016,11,11376,1439,5301,2573,7,32,20728
1/12/2016,12,11382,1294,5211,2820,13,32,20752
1/12/2016,13,11385,1416,4705,2938,23,33,20500
1/12/2016,14,11381,1661,4495,2959,59,32,20587
1/12/2016,15,11374,1901,4336,2956,56,32,20655
1/12/2016,16,11374,2015,4541,2808,25,32,20795
1/12/2016,17,11371,2187,4757,3085,8,32,21440
1/12/2016,18,11378,2248,5318,3205,0,32,22181
1/12/2016,19,11381,2380,5410,3179,0,32,22382
1/12/2016,20,11378,2382,5404,3111,0,32,22307
1/12/2016,21,11374,2384,5216,2987,0,32,21993
1/12/2016,22,11360,1900,4571,2928,0,33,20792
1/12/2016,23,11357,1332,4095,2708,0,33,19525
1/12/2016,24,11366,1111,3960,2532,0,26,18995
1/13/2016,1,11373,942,3577,2178,0,25,18095
1/13/2016,2,11383,924,3617,2283,0,25,18232
1/13/2016,3,11385,924,3574,2335,0,27,18245
1/13/2016,4,11387,929,3570,2336,0,27,18249
1/13/2016,5,11384,1037,3632,2204,0,24,18281
1/13/2016,6,11382,1224,3863,1866,0,43,18378
1/13/2016,7,11391,1339,4937,1791,0,60,19518
1/13/2016,8,11387,1365,5379,1985,0,56,20172
1/13/2016,9,11390,1368,5216,2033,23,58,20088
1/13/2016,10,11375,1435,5413,1905,82,32,20242
1/13/2016,11,11360,1460,4948,2013,145,29,19955
1/13/2016,12,11359,1676,4816,1986,151,29,20017
1/13/2016,13,11362,1706,4803,1988,190,27,20076
1/13/2016,14,11352,1824,4824,1960,169,30,20159
1/13/2016,15,11331,2086,4542,2120,121,29,20229
1/13/2016,16,11328,2345,4483,2379,30,36,20601
1/13/2016,17,11325,2717,4977,2276,5,34,21334
1/13/2016,18,11327,2785,5762,2232,0,32,22138
1/13/2016,19,11325,2788,5883,2246,0,40,22282
1/13/2016,20,11328,2772,5598,2333,0,51,22082
1/13/2016,21,11320,2614,5268,2463,0,54,21719
1/13/2016,22,11313,2020,4891,2584,0,50,20858
1/13/2016,23,11319,1340,4207,2660,0,37,19563
1/13/2016,24,11319,926,4123,2596,0,22,18986
1/14/2016,1,11319,914,3619,2397,0,14,18263
1/14/2016,2,11326,921,3431,2176,0,13,17867
1/14/2016,3,11322,1012,3543,1855,0,13,17745
1/14/2016,4,11325,1257,3725,1549,0,14,17870
1/14/2016,5,11329,1540,3841,1239,0,17,17966
1/14/2016,6,11332,1802,4238,1008,0,23,18403
1/14/2016,7,11334,2000,5304,843,0,29,19510
1/14/2016,8,11337,2370,5921,733,1,41,20403
1/14/2016,9,11333,2529,6003,714,4,41,20624
1/14/2016,10,11382,2214,5958,570,12,41,20177
1/14/2016,11,11389,2236,5889,507,20,40,20081
1/14/2016,12,11383,2401,5838,455,16,44,20137
1/14/2016,13,11367,2254,5416,360,31,40,19468
1/14/2016,14,11367,2279,5533,247,32,42,19500
1/14/2016,15,11367,2401,5561,216,16,40,19601
1/14/2016,16,11367,2521,5708,167,5,35,19803
1/14/2016,17,11376,2708,5815,142,1,34,20076
1/14/2016,18,11331,3031,6067,279,0,34,20742
1/14/2016,19,11329,2912,6051,681,0,34,21007
1/14/2016,20,11333,2580,5779,965,0,34,20691
1/14/2016,21,11327,2664,5653,1035,0,34,20713
1/14/2016,22,11322,2292,5201,1122,0,34,19971
1/14/2016,23,11322,1394,4997,1097,0,34,18844
1/14/2016,24,11327,1020,4398,1049,0,22,17816
1/15/2016,1,11326,924,4051,1086,0,16,17403
1/15/2016,2,11330,924,3804,1345,0,16,17419
1/15/2016,3,11328,922,3528,1508,0,14,17300
1/15/2016,4,11328,924,3283,1770,0,15,17320
1/15/2016,5,11323,921,3305,1642,0,18,17209
1/15/2016,6,11255,923,3677,2107,0,21,17983
1/15/2016,7,10794,923,4624,2206,0,28,18575
1/15/2016,8,10492,939,5398,2400,0,34,19263
1/15/2016,9,10489,955,5406,2326,4,35,19215
1/15/2016,10,10480,1019,5729,2253,15,36,19532
1/15/2016,11,10477,1070,5511,2357,29,35,19479
1/15/2016,12,10544,1080,5181,2396,36,35,19272
1/15/2016,13,11166,1335,4734,2055,47,35,19372
1/15/2016,14,11306,1557,5273,1809,22,35,20002
1/15/2016,15,11309,1689,5390,1586,22,35,20031
1/15/2016,16,11313,1623,5439,1728,7,34,20144
1/15/2016,17,11370,1591,5072,1854,0,46,19933
1/15/2016,18,11222,1737,5299,2000,0,37,20295
1/15/2016,19,11002,1734,5447,1970,0,33,20186
1/15/2016,20,10914,1737,5201,2231,0,33,20116
1/15/2016,21,10790,1739,4994,2375,0,34,19932
1/15/2016,22,10654,1597,4653,2536,0,34,19474
1/15/2016,23,10602,1069,4132,2490,0,34,18327
1/15/2016,24,10621,925,3717,2150,0,21,17434
1/16/2016,1,10695,912,3593,1839,0,3,17042
1/16/2016,2,10761,912,3319,1762,0,2,16756
1/16/2016,3,10768,911,3204,1597,0,2,16482
1/16/2016,4,10774,912,3109,1415,0,2,16212
1/16/2016,5,10774,912,3079,1570,0,2,16337
1/16/2016,6,10769,911,3190,1630,0,3,16503
1/16/2016,7,10766,914,3635,1678,0,2,16995
1/16/2016,8,10769,905,3768,2211,0,2,17655
1/16/2016,9,10766,872,4163,2372,0,2,18175
1/16/2016,10,10760,910,5076,2300,3,3,19052
1/16/2016,11,10756,920,5201,2204,13,4,19098
1/16/2016,12,10743,937,4739,2009,28,5,18461
1/16/2016,13,10748,909,4788,2171,45,2,18663
1/16/2016,14,10751,1017,4318,2392,36,2,18516
1/16/2016,15,10750,1128,4226,2379,78,2,18563
1/16/2016,16,10751,1538,4467,2052,14,2,18824
1/16/2016,17,10676,1825,4901,1898,2,2,19304
1/16/2016,18,10804,1900,5502,1626,0,2,19834
1/16/2016,19,10926,1899,5474,1438,0,2,19739
1/16/2016,20,10932,1894,5649,1160,0,2,19637
1/16/2016,21,10930,1754,5669,940,0,2,19295
1/16/2016,22,11006,1509,5384,953,0,2,18854
1/16/2016,23,11020,1258,4547,1054,0,2,17881
1/16/2016,24,11016,1100,4070,1212,0,2,17400
1/17/2016,1,11019,1101,3371,1312,0,2,16805
1/17/2016,2,11020,944,3315,1180,0,2,16461
1/17/2016,3,11019,914,3280,1116,0,2,16331
1/17/2016,4,11020,917,3206,1099,0,2,16244
1/17/2016,5,11017,916,3293,1024,0,2,16252
1/17/2016,6,11021,915,3313,1034,0,2,16285
1/17/2016,7,11027,916,3474,1319,0,2,16738
1/17/2016,8,11030,915,3791,1548,0,2,17286
1/17/2016,9,11026,919,4115,1526,0,2,17588
1/17/2016,10,11026,1010,4432,1611,12,2,18093
1/17/2016,11,11036,1173,4705,1494,20,2,18430
1/17/2016,12,11047,1453,4648,1446,17,2,18613
1/17/2016,13,11043,1589,4939,1423,15,2,19011
1/17/2016,14,11015,1567,4733,1678,9,2,19004
1/17/2016,15,11037,1749,4397,2041,5,2,19231
1/17/2016,16,11048,1989,4437,2084,5,2,19565
1/17/2016,17,11085,2152,4448,2265,1,2,19953
1/17/2016,18,11085,2113,5050,2522,0,2,20772
1/17/2016,19,11084,2074,5488,2475,0,2,21123
1/17/2016,20,11087,2078,4995,2658,0,2,20820
1/17/2016,21,11083,1503,4820,2715,0,2,20123
1/17/2016,22,11074,993,4970,2686,0,1,19724
1/17/2016,23,11076,922,4315,2619,0,1,18933
1/17/2016,24,11079,923,3546,2595,0,1,18144
1/18/2016,1,11062,923,3360,2163,0,8,17516
1/18/2016,2,11076,919,3438,1888,0,22,17343
1/18/2016,3,11080,925,3358,2153,0,23,17539
1/18/2016,4,11084,930,3282,2168,0,23,17487
1/18/2016,5,11084,928,3261,2318,0,21,17612
1/18/2016,6,11080,955,3538,2554,0,26,18153
1/18/2016,7,11084,1116,4162,2499,0,43,18904
1/18/2016,8,11085,1188,5057,2590,0,72,19992
1/18/2016,9,11079,1343,5406,2633,3,121,20585
1/18/2016,10,11083,1372,5442,2742,17,97,20753
1/18/2016,11,11083,1389,4933,2747,49,92,20293
1/18/2016,12,11070,1521,4980,2740,93,96,20500
1/18/2016,13,11069,1754,4830,2717,101,170,20641
1/18/2016,14,11074,1902,4698,2694,102,152,20622
1/18/2016,15,11069,2175,4601,2627,85,88,20645
1/18/2016,16,11075,2427,4623,2510,46,86,20767
1/18/2016,17,11075,2694,4853,2210,11,86,20929
1/18/2016,18,11077,2699,5433,2443,0,86,21738
1/18/2016,19,11098,2607,5566,2483,0,84,21838
1/18/2016,20,11094,2600,5540,2418,0,106,21758
1/18/2016,21,11081,2267,5354,2340,0,191,21233
1/18/2016,22,11093,1602,5489,2192,0,210,20586
1/18/2016,23,11116,1044,4396,2167,0,212,18935
1/18/2016,24,11121,913,4118,2047,0,186,18385
1/19/2016,1,11123,912,3613,2034,0,96,17778
1/19/2016,2,11145,956,3868,1933,0,34,17936
1/19/2016,3,11145,973,3761,1935,0,22,17836
1/19/2016,4,11149,1006,3669,1803,0,22,17649
1/19/2016,5,11134,1098,3577,1562,0,20,17391
1/19/2016,6,11138,1257,3994,1630,0,28,18047
1/19/2016,7,11142,1376,5036,1636,0,35,19225
1/19/2016,8,11142,1548,5556,1853,0,37,20136
1/19/2016,9,11141,1550,5341,2053,14,54,20153
1/19/2016,10,11140,1628,5428,2075,41,90,20402
1/19/2016,11,11131,1651,5105,2179,75,165,20306
1/19/2016,12,11133,1688,4816,2114,98,229,20078
1/19/2016,13,11080,1610,5029,2012,76,222,20029
1/19/2016,14,11000,1764,4894,2047,69,215,19989
1/19/2016,15,11069,2147,4670,2161,45,186,20278
1/19/2016,16,11147,2462,4541,1908,18,110,20186
1/19/2016,17,11143,2827,5127,1887,5,154,21143
1/19/2016,18,11161,3053,5833,1673,0,100,21820
1/19/2016,19,11240,2967,5780,1549,0,121,21657
1/19/2016,20,11259,2965,5948,1296,0,149,21617
1/19/2016,21,11252,3093,5793,1105,0,208,21451
1/19/2016,22,11243,2534,5496,997,0,214,20484
1/19/2016,23,11234,1371,5117,892,0,173,18787
1/19/2016,24,11215,964,4862,716,0,84,17841
1/20/2016,1,11219,954,4598,615,0,44,17430
1/20/2016,2,11238,908,4192,447,0,23,16808
1/20/2016,3,11277,952,4109,384,0,21,16743
1/20/2016,4,11278,1170,3286,367,0,21,16122
1/20/2016,5,11326,1737,3346,388,0,22,16819
1/20/2016,6,11125,2331,3274,138,0,25,16893
1/20/2016,7,11101,2719,4653,306,0,33,18812
1/20/2016,8,11232,2860,5771,207,0,36,20106
1/20/2016,9,11339,3044,5778,155,11,35,20362
1/20/2016,10,11340,2692,5696,106,44,35,19913
1/20/2016,11,11332,2578,5823,61,59,35,19888
1/20/2016,12,11347,2513,5780,66,82,35,19823
1/20/2016,13,11323,2580,5571,60,107,35,19676
1/20/2016,14,11170,2744,5391,51,81,35,19472
1/20/2016,15,11251,2781,5322,62,45,51,19512
1/20/2016,16,11293,2922,5577,60,32,86,19970
1/20/2016,17,11280,3051,5537,57,5,103,20033
1/20/2016,18,11281,3407,5926,74,0,90,20778
1/20/2016,19,11277,3778,5741,105,0,87,20988
1/20/2016,20,11278,3630,5718,178,0,87,20891
1/20/2016,21,11277,3359,5604,246,0,81,20567
1/20/2016,22,11265,3035,5410,338,0,35,20083
1/20/2016,23,11262,2495,4960,399,0,36,19152
1/20/2016,24,11279,1820,4695,503,0,27,18324
1/21/2016,1,11279,1080,4210,629,0,22,17220
1/21/2016,2,11279,949,3996,841,0,21,17086
1/21/2016,3,11277,1148,3570,956,0,22,16973
1/21/2016,4,11280,1570,3245,810,0,24,16929
1/21/2016,5,11279,1870,3162,648,0,23,16982
1/21/2016,6,11279,2076,3859,574,0,24,17812
1/21/2016,7,11281,2287,4904,507,0,34,19013
1/21/2016,8,11283,2564,5592,516,0,35,19990
1/21/2016,9,11277,2552,5770,420,18,37,20074
1/21/2016,10,11278,2549,5686,302,54,36,19905
1/21/2016,11,11282,2418,5403,242,74,37,19456
1/21/2016,12,11278,2467,5095,290,96,36,19262
1/21/2016,13,11282,2487,5137,279,88,36,19309
1/21/2016,14,11283,2535,5006,192,76,37,19129
1/21/2016,15,11286,2625,5163,162,90,63,19389
1/21/2016,16,11284,2679,5270,164,22,104,19523
1/21/2016,17,11282,2898,5283,157,5,180,19805
1/21/2016,18,11278,3569,5900,144,0,185,21076
1/21/2016,19,11281,3737,5888,155,0,210,21271
1/21/2016,20,11280,3550,5937,146,0,211,21124
1/21/2016,21,11284,3259,5811,159,0,214,20727
1/21/2016,22,11271,2895,5422,168,0,185,19941
1/21/2016,23,11271,2503,4849,178,0,97,18898
1/21/2016,24,11267,1985,4868,185,0,34,18339
1/22/2016,1,11283,1594,4461,162,0,22,17522
1/22/2016,2,11278,1501,4436,154,0,21,17390
1/22/2016,3,11284,1414,4134,165,0,21,17018
1/22/2016,4,11294,1390,4208,196,0,20,17108
1/22/2016,5,11305,1738,4153,192,0,20,17408
1/22/2016,6,11298,2170,4221,221,0,27,17937
1/22/2016,7,11301,2368,4905,321,0,32,18927
1/22/2016,8,11307,2439,5417,625,1,47,19836
1/22/2016,9,11288,2376,5330,798,30,49,19871
1/22/2016,10,11295,2345,4966,826,61,52,19545
1/22/2016,11,11299,2345,5117,840,68,54,19723
1/22/2016,12,11293,2467,4972,873,84,54,19743
1/22/2016,13,11300,2124,4801,859,89,54,19227
1/22/2016,14,11303,2073,4996,838,84,47,19341
1/22/2016,15,11301,2028,5103,774,71,36,19313
1/22/2016,16,11302,2177,5113,910,38,35,19575
1/22/2016,17,11307,2301,5188,932,10,35,19773
1/22/2016,18,11301,2559,5752,779,0,34,20425
1/22/2016,19,11304,2926,5514,891,0,34,20669
1/22/2016,20,11306,2624,5358,1058,0,34,20380
1/22/2016,21,11298,2526,5159,1213,0,34,20230
1/22/2016,22,11301,2054,4678,1300,0,34,19367
1/22/2016,23,11305,1527,4037,1440,0,33,18342
1/22/2016,24,11287,1041,4055,1508,0,9,17900
1/23/2016,1,11290,940,3448,1605,0,2,17285
1/23/2016,2,11300,937,3218,1522,0,3,16980
1/23/2016,3,11309,947,2924,1625,0,3,16808
1/23/2016,4,11308,1075,2810,1483,0,3,16679
1/23/2016,5,11311,1251,2814,1359,0,3,16738
1/23/2016,6,11305,1341,3091,1266,0,3,17006
1/23/2016,7,11298,1251,3299,1763,0,3,17614
1/23/2016,8,11298,1206,4155,2028,0,3,18690
1/23/2016,9,11294,1321,4504,1745,8,3,18875
1/23/2016,10,11299,1588,4416,1460,41,3,18807
1/23/2016,11,11289,1738,4210,1429,72,2,18740
1/23/2016,12,11302,1852,3704,1528,112,3,18501
1/23/2016,13,11300,1935,3835,1247,117,3,18437
1/23/2016,14,11298,2045,3725,1068,113,3,18252
1/23/2016,15,11250,2033,3875,1041,101,4,18304
1/23/2016,16,11305,1983,4237,993,98,2,18618
1/23/2016,17,11398,1881,5178,889,30,2,19378
1/23/2016,18,11459,2377,5630,863,0,3,20332
1/23/2016,19,11482,2777,5602,751,0,3,20615
1/23/2016,20,11481,2715,5589,640,0,2,20427
1/23/2016,21,11477,2522,5581,456,0,2,20038
1/23/2016,22,11479,2202,5392,306,0,2,19381
1/23/2016,23,11484,2139,4830,241,0,2,18696
1/23/2016,24,11481,1615,4694,232,0,3,18025
1/24/2016,1,11482,1469,4386,204,0,3,17544
1/24/2016,2,11486,1127,4293,195,0,2,17103
1/24/2016,3,11491,986,4123,224,0,2,16826
1/24/2016,4,11490,911,4001,282,0,2,16686
1/24/2016,5,11496,916,3796,453,0,2,16663
1/24/2016,6,11486,919,3908,486,0,2,16801
1/24/2016,7,11489,921,4161,566,0,2,17139
1/24/2016,8,11489,923,4699,743,0,4,17858
1/24/2016,9,11485,921,4708,869,14,4,18001
1/24/2016,10,11494,974,4823,963,51,3,18308
1/24/2016,11,11488,1051,4869,889,69,4,18370
1/24/2016,12,11491,1150,5113,949,87,4,18794
1/24/2016,13,11488,1469,4717,1258,57,4,18993
1/24/2016,14,11483,1916,3875,1679,37,3,18993
1/24/2016,15,11482,2160,3885,1354,21,3,18905
1/24/2016,16,11483,2236,4015,1379,22,3,19138
1/24/2016,17,11479,2504,4386,1514,9,3,19895
1/24/2016,18,11480,2527,5443,1365,0,4,20819
1/24/2016,19,11486,2608,5744,1095,0,4,20937
1/24/2016,20,11482,2540,5715,935,0,4,20676
1/24/2016,21,11480,2364,5510,738,0,4,20096
1/24/2016,22,11487,2127,4853,562,0,4,19033
1/24/2016,23,11511,1483,4639,627,0,3,18263
1/24/2016,24,11537,1022,4184,644,0,3,17390
1/25/2016,1,11534,920,3750,646,0,18,16868
1/25/2016,2,11529,930,3426,642,0,18,16545
1/25/2016,3,11534,1059,3332,409,0,17,16351
1/25/2016,4,11535,1238,3176,384,0,16,16349
1/25/2016,5,11541,1328,3237,349,0,16,16471
1/25/2016,6,11539,1328,3682,585,0,16,17150
1/25/2016,7,11536,1341,4840,680,0,26,18423
1/25/2016,8,11535,1282,5402,848,0,38,19105
1/25/2016,9,11535,1152,5517,980,10,43,19237
1/25/2016,10,11531,1142,5580,1084,23,46,19406
1/25/2016,11,11533,1178,5482,1213,39,45,19490
1/25/2016,12,11535,1139,5050,1244,43,43,19054
1/25/2016,13,11538,981,4631,1486,73,38,18747
1/25/2016,14,11538,945,4240,1709,68,37,18537
1/25/2016,15,11541,939,3955,1951,94,37,18517
1/25/2016,16,11537,934,4028,2011,74,49,18633
1/25/2016,17,11539,934,4182,2087,22,79,18843
1/25/2016,18,11538,937,5038,2399,0,137,20049
1/25/2016,19,11538,935,5261,2527,0,204,20465
1/25/2016,20,11538,935,5212,2625,0,207,20517
1/25/2016,21,11531,931,4652,2572,0,206,19892
1/25/2016,22,11523,935,3689,2623,0,181,18951
1/25/2016,23,11525,933,3359,2181,0,100,18098
1/25/2016,24,11467,918,3218,1729,0,39,17371
1/26/2016,1,11084,908,3228,1489,0,23,16732
1/26/2016,2,10782,909,3079,1350,0,22,16142
1/26/2016,3,10630,908,3102,1570,0,22,16232
1/26/2016,4,10625,907,3120,1600,0,22,16274
1/26/2016,5,10633,905,3052,1680,0,23,16293
1/26/2016,6,10710,908,3154,1627,0,27,16426
1/26/2016,7,10936,909,3829,1784,0,33,17491
1/26/2016,8,11041,933,4299,2647,0,38,18958
1/26/2016,9,11260,933,4337,2576,0,37,19143
1/26/2016,10,11535,935,4247,2502,7,37,19263
1/26/2016,11,11561,939,3897,2516,38,37,18988
1/26/2016,12,11554,937,3886,2684,27,38,19126
1/26/2016,13,11543,936,3846,2837,12,37,19211
1/26/2016,14,11543,931,3728,2958,20,41,19221
1/26/2016,15,11548,934,3773,2887,13,47,19202
1/26/2016,16,11547,934,4198,2382,4,38,19103
1/26/2016,17,11545,932,4395,2476,1,38,19387
1/26/2016,18,11544,933,5031,2443,0,37,19988
1/26/2016,19,11555,939,5042,2400,0,36,19972
1/26/2016,20,11553,941,5117,2209,0,37,19857
1/26/2016,21,11556,940,5333,2049,0,37,19915
1/26/2016,22,11553,940,4448,2115,0,37,19093
1/26/2016,23,11546,939,3833,1872,0,35,18225
1/26/2016,24,11554,920,3693,1086,0,32,17285
1/27/2016,1,11419,925,3469,1074,0,24,16911
1/27/2016,2,11269,927,3392,1166,0,23,16777
1/27/2016,3,11269,979,3380,988,0,21,16637
1/27/2016,4,11267,1009,3208,1155,0,22,16661
1/27/2016,5,11282,1095,3193,1065,0,21,16656
1/27/2016,6,11283,1122,3421,1200,0,26,17052
1/27/2016,7,11355,1174,4334,1132,0,33,18028
1/27/2016,8,11576,1364,5365,963,0,45,19313
1/27/2016,9,11577,1429,5834,601,4,45,19490
1/27/2016,10,11577,1435,5707,459,47,43,19268
1/27/2016,11,11580,1342,4819,574,86,38,18439
1/27/2016,12,11579,1332,4417,735,118,36,18217
1/27/2016,13,11578,1214,4458,812,170,37,18269
1/27/2016,14,11580,1323,4473,1024,154,38,18592
1/27/2016,15,11588,1190,4295,1172,117,64,18426
1/27/2016,16,11431,1138,4798,1456,65,101,18989
1/27/2016,17,11519,1136,4912,1768,17,187,19539
1/27/2016,18,11586,1145,5387,1998,0,190,20306
1/27/2016,19,11588,1157,5276,2370,0,115,20506
1/27/2016,20,11590,1132,5092,2665,0,91,20570
1/27/2016,21,11586,1131,4688,2960,0,53,20418
1/27/2016,22,11572,1130,4107,2630,0,36,19475
1/27/2016,23,11569,964,3790,2403,0,36,18762
1/27/2016,24,11574,912,3547,1891,0,29,17953
1/28/2016,1,11502,905,3340,1606,0,16,17369
1/28/2016,2,11211,905,3253,1824,0,6,17199
1/28/2016,3,10973,905,3199,1989,0,6,17072
1/28/2016,4,10974,902,3146,2091,0,6,17119
1/28/2016,5,10984,901,3152,2106,0,6,17149
1/28/2016,6,11058,901,3248,2201,0,6,17414
1/28/2016,7,11375,902,3599,2355,0,5,18236
1/28/2016,8,11591,928,4320,2468,0,5,19312
1/28/2016,9,11600,931,4516,2789,6,5,19847
1/28/2016,10,11605,931,4608,3005,14,5,20168
1/28/2016,11,11603,931,4302,2824,25,16,19701
1/28/2016,12,11601,927,4171,2440,48,12,19199
1/28/2016,13,11598,929,4128,2479,46,4,19184
1/28/2016,14,11597,928,4352,2176,32,4,19089
1/28/2016,15,11601,931,4392,2225,22,22,19193
1/28/2016,16,11603,933,4528,2534,11,50,19659
1/28/2016,17,11600,932,4722,2383,1,114,19752
1/28/2016,18,11601,937,5451,2272,0,113,20374
1/28/2016,19,11598,991,5730,2185,0,73,20577
1/28/2016,20,11598,964,5622,2156,0,96,20436
1/28/2016,21,11594,942,5341,2008,0,150,20035
1/28/2016,22,11587,937,4458,1964,0,125,19071
1/28/2016,23,11593,937,4039,1642,0,61,18272
1/28/2016,24,11588,911,3685,1600,0,16,17800
1/29/2016,1,11586,907,3421,1827,0,4,17745
1/29/2016,2,11571,908,3460,1728,0,4,17671
1/29/2016,3,11313,911,3451,1757,0,4,17436
1/29/2016,4,11294,908,3337,1862,0,2,17403
1/29/2016,5,11297,907,3363,2026,0,2,17595
1/29/2016,6,11520,905,3427,1997,0,2,17851
1/29/2016,7,11595,916,3927,2390,0,2,18830
1/29/2016,8,11593,947,4621,2482,0,2,19645
1/29/2016,9,11504,951,5068,2565,3,2,20093
1/29/2016,10,11494,994,4831,2539,19,2,19879
1/29/2016,11,11493,1013,4518,2486,63,2,19575
1/29/2016,12,11492,971,4542,2294,96,2,19397
1/29/2016,13,11496,1006,4568,2094,100,1,19265
1/29/2016,14,11494,1040,4758,1801,100,1,19194
1/29/2016,15,11566,1104,4759,1650,89,25,19193
1/29/2016,16,11590,1244,4991,1412,58,60,19355
1/29/2016,17,11594,1451,5645,1082,26,143,19941
1/29/2016,18,11591,1900,5966,870,1,187,20515
1/29/2016,19,11589,2222,6032,682,0,178,20703
1/29/2016,20,11597,2180,5916,524,0,105,20322
1/29/2016,21,11596,1903,5907,426,0,79,19911
1/29/2016,22,11587,1856,5444,618,0,94,19599
1/29/2016,23,11582,1285,4945,943,0,172,18927
1/29/2016,24,11580,846,4231,1279,0,149,18085
1/30/2016,1,11580,773,3819,1377,0,67,17616
1/30/2016,2,11583,766,3420,1340,0,28,17137
1/30/2016,3,11582,767,3341,1408,0,6,17104
1/30/2016,4,11582,769,3195,1265,0,6,16817
1/30/2016,5,11583,768,3226,755,0,6,16338
1/30/2016,6,11509,765,3310,1295,0,5,16884
1/30/2016,7,11345,717,3452,1909,0,6,17429
1/30/2016,8,11355,708,3509,2590,0,6,18168
1/30/2016,9,11555,696,3587,2535,8,7,18388
1/30/2016,10,11594,695,3620,2714,53,6,18682
1/30/2016,11,11593,694,3592,2703,78,6,18666
1/30/2016,12,11598,689,3641,2666,92,6,18692
1/30/2016,13,11599,690,3537,2667,116,6,18615
1/30/2016,14,11555,686,3498,2608,145,6,18498
1/30/2016,15,11595,686,3498,2559,70,6,18414
1/30/2016,16,11596,686,3931,2116,39,5,18373
1/30/2016,17,11598,680,4514,1940,15,5,18752
1/30/2016,18,11594,640,4843,1958,1,5,19041
1/30/2016,19,11592,715,5078,2129,0,5,19519
1/30/2016,20,11590,753,4869,1883,0,6,19101
1/30/2016,21,11595,756,4625,1939,0,6,18921
1/30/2016,22,11591,755,4316,1375,0,6,18043
1/30/2016,23,11577,734,3686,1228,0,6,17231
1/30/2016,24,11354,700,3332,1339,0,6,16731
1/31/2016,1,11347,700,3221,1321,0,6,16595
1/31/2016,2,11340,700,3321,996,0,6,16363
1/31/2016,3,11061,701,3304,970,0,6,16042
1/31/2016,4,10803,703,3227,974,0,6,15713
1/31/2016,5,10750,703,3258,1301,0,15,16027
1/31/2016,6,10744,702,3273,1368,0,11,16098
1/31/2016,7,10933,707,3449,1267,0,6,16362
1/31/2016,8,11130,708,3684,1514,0,6,17042
1/31/2016,9,11558,708,3700,1341,8,5,17320
1/31/2016,10,11601,708,3796,1405,33,6,17549
1/31/2016,11,11603,710,4021,1441,63,6,17844
1/31/2016,12,11605,707,3778,1626,73,6,17795
1/31/2016,13,11600,707,3825,1529,62,5,17728
1/31/2016,14,11570,707,3887,1498,26,4,17692
1/31/2016,15,11556,703,3912,1508,21,3,17703
1/31/2016,16,11546,707,3938,1938,17,3,18149
1/31/2016,17,11545,706,4307,2616,1,2,19177
1/31/2016,18,11543,706,4746,2954,0,3,19952
1/31/2016,19,11539,707,4669,2755,0,3,19673
1/31/2016,20,11546,706,4744,2402,0,3,19401
1/31/2016,21,11540,706,4434,2315,0,3,18998
1/31/2016,22,11525,706,3948,2099,0,3,18281
1/31/2016,23,11499,747,3623,1363,0,3,17235
1/31/2016,24,11078,766,3275,1253,0,4,16376
2/1/2016,1,10577,762,3291,1385,0,21,16036
2/1/2016,2,10280,760,3322,1652,0,23,16037
2/1/2016,3,9956,759,3390,1377,0,23,15505
2/1/2016,4,9725,760,3298,2054,0,29,15866
2/1/2016,5,9724,760,3393,1979,0,25,15881
2/1/2016,6,9725,786,3638,1585,0,27,15761
2/1/2016,7,10057,801,4571,1261,0,39,16729
2/1/2016,8,10951,957,5160,1153,0,47,18268
2/1/2016,9,11491,1001,4905,928,33,45,18403
2/1/2016,10,11499,1028,4789,603,62,51,18032
2/1/2016,11,11334,1075,4607,433,68,56,17573
2/1/2016,12,10981,1136,4704,577,138,51,17587
2/1/2016,13,10960,1183,4709,617,117,40,17626
2/1/2016,14,10970,1235,4719,684,149,38,17795
2/1/2016,15,11149,1368,4681,694,127,49,18068
2/1/2016,16,11500,1561,4465,421,56,70,18073
2/1/2016,17,11509,1734,4638,426,23,120,18450
2/1/2016,18,11505,1732,5316,530,1,200,19284
2/1/2016,19,11500,1824,5808,467,0,213,19812
2/1/2016,20,11503,1734,5817,400,0,212,19666
2/1/2016,21,11492,1733,5779,358,0,208,19570
2/1/2016,22,11486,1555,5216,279,0,209,18745
2/1/2016,23,11485,1348,4576,205,0,188,17802
2/1/2016,24,10971,1326,4387,155,0,101,16940
2/2/2016,1,10648,1020,4687,160,0,31,16546
2/2/2016,2,10660,924,4678,146,0,16,16424
2/2/2016,3,10659,923,4418,138,0,18,16156
2/2/2016,4,10659,923,4511,108,0,21,16222
2/2/2016,5,10849,923,4554,87,0,22,16435
2/2/2016,6,11101,925,4391,155,0,25,16597
2/2/2016,7,11546,928,5067,247,0,31,17819
2/2/2016,8,11558,1015,5600,320,1,36,18530
2/2/2016,9,11558,943,5366,478,28,41,18414
2/2/2016,10,11557,940,5094,655,72,42,18360
2/2/2016,11,11556,938,4674,603,97,57,17925
2/2/2016,12,11504,938,4530,687,114,59,17832
2/2/2016,13,11508,938,4066,1028,122,43,17705
2/2/2016,14,11510,960,4065,1211,106,42,17894
2/2/2016,15,11508,965,4031,1216,83,58,17861
2/2/2016,16,11503,964,4095,1332,27,107,18028
2/2/2016,17,11498,965,4160,1814,9,202,18648
2/2/2016,18,11502,968,4731,2218,0,221,19640
2/2/2016,19,11500,969,4810,2181,0,198,19658
2/2/2016,20,11500,972,4742,2350,0,122,19686
2/2/2016,21,11491,945,4491,2336,0,106,19369
2/2/2016,22,11476,937,4032,2206,0,143,18794
2/2/2016,23,11468,940,3967,1847,0,85,18307
2/2/2016,24,11470,919,3958,1642,0,36,18025
2/3/2016,1,11471,917,3568,1907,0,18,17881
2/3/2016,2,11480,915,3366,1521,0,18,17300
2/3/2016,3,11182,912,3352,1447,0,17,16910
2/3/2016,4,10878,909,3300,1466,0,19,16572
2/3/2016,5,10883,904,3235,1498,0,20,16540
2/3/2016,6,10905,918,3473,1743,0,22,17061
2/3/2016,7,11271,933,3747,1623,0,28,17602
2/3/2016,8,11296,960,4341,1884,0,36,18517
2/3/2016,9,11305,974,4603,1790,2,36,18710
2/3/2016,10,11304,1004,4323,2146,10,35,18822
2/3/2016,11,11310,1118,4273,2358,14,35,19108
2/3/2016,12,11528,1112,4252,1951,34,35,18912
2/3/2016,13,11604,1110,4221,1798,45,35,18813
2/3/2016,14,11607,1106,4103,1774,28,34,18652
2/3/2016,15,11603,1105,4127,1462,19,34,18350
2/3/2016,16,11582,1106,4236,1247,26,34,18231
2/3/2016,17,11597,1108,4236,1758,19,34,18752
2/3/2016,18,11598,1112,4580,2130,2,34,19456
2/3/2016,19,11588,1112,4596,2522,0,34,19852
2/3/2016,20,11588,1112,4549,2541,0,34,19824
2/3/2016,21,11587,956,4333,2666,0,34,19576
2/3/2016,22,11573,930,3902,2510,0,34,18949
2/3/2016,23,11576,933,3561,2116,0,34,18220
2/3/2016,24,11513,916,3440,1767,0,24,17660
2/4/2016,1,10981,913,3369,1068,0,16,16347
2/4/2016,2,10650,913,3429,1267,0,16,16275
2/4/2016,3,10466,913,3365,1239,0,16,15999
2/4/2016,4,10293,911,3356,1547,0,17,16124
2/4/2016,5,10289,912,3297,1004,0,24,15526
2/4/2016,6,10452,909,3609,1684,0,26,16680
2/4/2016,7,10856,859,4395,1339,0,28,17477
2/4/2016,8,11340,881,4985,1124,0,33,18363
2/4/2016,9,11576,883,5174,894,8,33,18568
2/4/2016,10,11579,883,5575,675,70,33,18815
2/4/2016,11,11576,920,5098,577,95,33,18299
2/4/2016,12,11576,927,4872,534,126,33,18068
2/4/2016,13,11579,969,4652,426,141,33,17800
2/4/2016,14,11574,1038,4714,339,114,33,17812
2/4/2016,15,11574,1081,4616,341,82,33,17727
2/4/2016,16,11571,1091,4845,379,45,49,17980
2/4/2016,17,11569,1129,5277,352,20,80,18427
2/4/2016,18,11567,1269,5899,328,0,172,19235
2/4/2016,19,11570,1315,6023,334,0,222,19464
2/4/2016,20,11574,1349,5771,405,0,228,19327
2/4/2016,21,11571,1344,5805,366,0,216,19302
2/4/2016,22,11571,1173,5430,451,0,186,18811
2/4/2016,23,11555,1129,4654,492,0,100,17930
2/4/2016,24,11547,950,4313,529,0,30,17369
2/5/2016,1,11555,924,4099,505,0,18,17101
2/5/2016,2,11559,923,3728,613,0,24,16847
2/5/2016,3,11558,924,3609,802,0,24,16917
2/5/2016,4,11559,923,3515,623,0,22,16642
2/5/2016,5,11574,925,3525,618,0,22,16664
2/5/2016,6,11575,923,3967,503,0,24,16992
2/5/2016,7,11580,927,5008,398,0,29,17942
2/5/2016,8,11578,970,5590,425,3,34,18600
2/5/2016,9,11576,961,5305,330,37,33,18242
2/5/2016,10,11576,940,5368,224,87,33,18228
2/5/2016,11,11578,935,4913,272,139,33,17870
2/5/2016,12,11578,919,4927,547,168,46,18185
2/5/2016,13,11574,933,4668,424,110,74,17783
2/5/2016,14,11576,935,4661,809,124,131,18236
2/5/2016,15,11583,944,4759,844,116,210,18456
2/5/2016,16,11580,1026,4952,732,68,205,18563
2/5/2016,17,11583,1292,5107,645,29,212,18868
2/5/2016,18,11581,1526,5689,705,2,218,19721
2/5/2016,19,11590,1517,5652,830,0,203,19792
2/5/2016,20,11593,1518,5588,872,0,198,19769
2/5/2016,21,11587,1518,5307,912,0,214,19538
2/5/2016,22,11579,1516,4701,859,0,181,18836
2/5/2016,23,11569,1344,4440,659,0,106,18118
2/5/2016,24,11578,985,4057,740,0,39,17399
2/6/2016,1,11575,919,3584,578,0,11,16667
2/6/2016,2,11226,918,3622,563,0,0,16329
2/6/2016,3,10871,919,3632,875,0,0,16297
2/6/2016,4,10742,920,3586,809,0,0,16057
2/6/2016,5,10740,916,3557,870,0,0,16083
2/6/2016,6,10740,920,3634,933,0,0,16227
2/6/2016,7,10897,919,3833,823,0,0,16472
2/6/2016,8,11045,917,4229,1007,0,0,17198
2/6/2016,9,11226,919,4659,1107,4,0,17915
2/6/2016,10,11349,906,4685,1202,12,0,18154
2/6/2016,11,11476,866,4465,1341,52,0,18200
2/6/2016,12,11594,872,4223,1247,88,0,18024
2/6/2016,13,11588,875,4108,1275,108,0,17954
2/6/2016,14,11587,879,3773,958,88,0,17285
2/6/2016,15,11591,911,3823,796,36,0,17157
2/6/2016,16,11591,914,3903,825,95,0,17328
2/6/2016,17,11588,915,4145,1185,40,0,17873
2/6/2016,18,11588,920,4489,1873,3,0,18873
2/6/2016,19,11590,923,4928,1978,0,0,19419
2/6/2016,20,11589,921,4765,1737,0,3,19015
2/6/2016,21,11581,923,4587,1461,0,4,18556
2/6/2016,22,11563,925,4049,1271,0,4,17812
2/6/2016,23,11558,924,3480,1176,0,3,17141
2/6/2016,24,11503,924,3380,780,0,3,16590
2/7/2016,1,11165,926,3382,627,0,3,16103
2/7/2016,2,10661,923,3436,668,0,3,15691
2/7/2016,3,10418,923,3433,1035,0,3,15812
2/7/2016,4,10401,924,3357,1025,0,3,15710
2/7/2016,5,10417,926,3277,1017,0,3,15640
2/7/2016,6,10420,926,3316,1052,0,3,15717
2/7/2016,7,10589,927,3522,1050,0,3,16091
2/7/2016,8,11002,926,3611,738,3,2,16282
2/7/2016,9,11017,927,3694,916,55,3,16612
2/7/2016,10,11016,928,3874,934,130,3,16885
2/7/2016,11,11004,928,3985,1172,168,3,17260
2/7/2016,12,11242,924,4028,1069,151,2,17416
2/7/2016,13,11329,919,3886,1466,132,3,17735
2/7/2016,14,11305,922,3826,1427,102,3,17585
2/7/2016,15,11555,920,3840,1407,54,3,17779
2/7/2016,16,11577,920,3868,1718,61,3,18147
2/7/2016,17,11575,918,4329,1930,11,2,18765
2/7/2016,18,11574,919,4817,2069,3,2,19384
2/7/2016,19,11575,919,4791,2434,0,2,19721
2/7/2016,20,11573,917,4737,1888,0,3,19118
2/7/2016,21,11566,917,4764,1481,0,3,18731
2/7/2016,22,11573,919,4232,1457,0,3,18184
2/7/2016,23,10807,921,3962,1838,0,3,17531
2/7/2016,24,10739,919,3594,1433,0,3,16688
2/8/2016,1,10736,950,3400,1142,0,3,16231
2/8/2016,2,10740,964,3439,1109,0,14,16266
2/8/2016,3,10736,995,3372,758,0,20,15881
2/8/2016,4,10631,1021,3301,574,0,22,15549
2/8/2016,5,10494,1054,3329,788,0,20,15685
2/8/2016,6,10493,1125,3543,782,0,24,15967
2/8/2016,7,10672,1236,4528,568,0,31,17035
2/8/2016,8,10727,1358,5544,446,0,41,18116
2/8/2016,9,10722,1366,5474,394,13,58,18027
2/8/2016,10,10722,1379,5228,403,42,60,17834
2/8/2016,11,10723,1465,5228,414,72,62,17964
2/8/2016,12,10723,1542,5252,346,75,62,18000
2/8/2016,13,10721,1754,5428,305,77,76,18361
2/8/2016,14,10722,1870,5302,285,51,71,18301
2/8/2016,15,10728,1920,5338,346,39,61,18432
2/8/2016,16,10736,2192,5538,400,21,62,18949
2/8/2016,17,10733,2325,5433,440,5,62,18998
2/8/2016,18,10722,2445,5895,474,0,49,19585
2/8/2016,19,10721,2410,6065,523,0,45,19764
2/8/2016,20,10722,2199,6012,647,0,47,19627
2/8/2016,21,10712,1595,5843,727,0,42,18919
2/8/2016,22,10707,1343,5544,764,0,36,18394
2/8/2016,23,10695,1028,4940,822,0,35,17520
2/8/2016,24,10694,944,4481,857,0,27,17003
2/9/2016,1,10691,920,4356,831,0,23,16821
2/9/2016,2,10692,927,3936,884,0,20,16459
2/9/2016,3,10700,928,3649,875,0,20,16172
2/9/2016,4,10701,944,3574,954,0,22,16195
2/9/2016,5,10706,943,3636,989,0,28,16302
2/9/2016,6,10704,989,4020,1051,0,42,16806
2/9/2016,7,10723,1296,4716,1019,0,50,17804
2/9/2016,8,10730,1324,5595,1188,0,54,18891
2/9/2016,9,10720,1334,5536,1267,7,47,18911
2/9/2016,10,10730,1335,5651,1377,13,50,19156
2/9/2016,11,10726,1258,5675,1425,15,59,19158
2/9/2016,12,10726,1173,5066,1547,17,71,18600
2/9/2016,13,10730,1160,5007,1584,16,78,18575
2/9/2016,14,10725,1193,5225,1511,16,77,18747
2/9/2016,15,10727,1253,5231,1484,16,58,18769
2/9/2016,16,10726,1298,5052,1629,12,75,18792
2/9/2016,17,10722,1349,4997,1795,5,76,18944
2/9/2016,18,10720,1348,4959,2011,0,60,19098
2/9/2016,19,10723,1347,5457,2210,0,52,19789
2/9/2016,20,10718,1351,5417,2284,0,49,19819
2/9/2016,21,10705,1229,5301,2245,0,50,19530
2/9/2016,22,10698,1088,4873,2239,0,42,18940
2/9/2016,23,10702,1025,4314,2170,0,41,18252
2/9/2016,24,10707,918,3977,2031,0,30,17663
2/10/2016,1,10702,919,3589,1648,0,24,16882
2/10/2016,2,10705,913,3542,1117,0,22,16299
2/10/2016,3,10702,966,3519,1283,0,23,16493
2/10/2016,4,10700,1003,3466,1349,0,24,16542
2/10/2016,5,10698,1068,3441,1651,0,25,16883
2/10/2016,6,10698,1085,3595,1523,0,27,16928
2/10/2016,7,10704,1117,4463,1609,0,31,17924
2/10/2016,8,10704,1106,5326,1645,1,33,18815
2/10/2016,9,10705,1100,4987,1780,9,34,18615
2/10/2016,10,10700,1123,5100,1956,23,43,18945
2/10/2016,11,10698,1213,4767,2053,42,62,18835
2/10/2016,12,10695,1350,4761,2062,55,88,19011
2/10/2016,13,10697,1617,4588,2174,55,42,19173
2/10/2016,14,10696,1728,4398,2155,44,58,19079
2/10/2016,15,10710,1619,4482,2002,29,50,18892
2/10/2016,16,10715,1736,4678,2049,23,53,19254
2/10/2016,17,10872,2030,4913,1864,20,45,19744
2/10/2016,18,10909,2068,5304,1756,2,42,20081
2/10/2016,19,10908,2215,5451,1895,0,41,20510
2/10/2016,20,10911,2177,5121,2041,0,36,20286
2/10/2016,21,10907,2133,4924,2208,0,34,20206
2/10/2016,22,10932,1626,4386,2346,0,34,19324
2/10/2016,23,11098,890,4169,2390,0,33,18580
2/10/2016,24,11303,817,3755,2209,0,25,18109
2/11/2016,1,11341,819,3535,2178,0,22,17895
2/11/2016,2,11344,824,3564,2115,0,21,17868
2/11/2016,3,11344,826,3603,2192,0,21,17986
2/11/2016,4,11344,896,3514,2178,0,22,17954
2/11/2016,5,11359,970,3460,1714,0,22,17525
2/11/2016,6,11358,998,3782,2039,0,28,18205
2/11/2016,7,11364,1094,4763,1817,0,33,19071
2/11/2016,8,11374,1176,5420,1905,3,34,19912
2/11/2016,9,11378,1217,5688,1850,36,35,20204
2/11/2016,10,11378,1235,5539,1777,79,35,20043
2/11/2016,11,11431,1308,5266,1648,104,37,19794
2/11/2016,12,11486,1505,4957,1723,105,61,19837
2/11/2016,13,11483,1814,4776,1476,106,63,19718
2/11/2016,14,11485,1911,4468,1690,98,64,19716
2/11/2016,15,11484,1483,4598,1714,94,68,19441
2/11/2016,16,11498,1457,4709,1691,77,45,19477
2/11/2016,17,11507,1571,4995,1458,45,88,19664
2/11/2016,18,11501,2551,5545,1146,4,93,20840
2/11/2016,19,11496,2997,5649,971,0,109,21222
2/11/2016,20,11491,3045,5746,808,0,102,21192
2/11/2016,21,11486,2839,5562,805,0,113,20805
2/11/2016,22,11483,2343,5263,1245,0,187,20521
2/11/2016,23,11495,1385,4784,1558,0,153,19375
2/11/2016,24,11504,1212,3969,1935,0,81,18701
2/12/2016,1,11509,891,3815,2235,0,37,18487
2/12/2016,2,11515,952,3661,1977,0,23,18128
2/12/2016,3,11519,1091,3643,1696,0,22,17971
2/12/2016,4,11516,1227,3570,1473,0,22,17808
2/12/2016,5,11518,1292,3560,1559,0,23,17952
2/12/2016,6,11516,1274,3856,1877,0,27,18550
2/12/2016,7,11516,1295,4820,2156,0,32,19819
2/12/2016,8,11518,1467,5490,2308,2,36,20821
2/12/2016,9,11515,1485,5557,2472,15,35,21079
2/12/2016,10,11519,1478,4705,2448,40,36,20226
2/12/2016,11,11500,1518,4475,2606,55,36,20190
2/12/2016,12,11516,1414,4394,2557,66,40,19987
2/12/2016,13,11525,1037,4321,2959,44,63,19949
2/12/2016,14,11520,981,4189,2977,53,92,19812
2/12/2016,15,11517,1018,4242,2863,24,90,19754
2/12/2016,16,11520,1032,4397,2738,19,96,19802
2/12/2016,17,11521,1054,4623,2762,15,95,20070
2/12/2016,18,11514,1095,5089,2663,4,95,20460
2/12/2016,19,11518,1097,5110,2811,0,51,20587
2/12/2016,20,11512,1069,5084,2906,0,37,20608
2/12/2016,21,11513,1074,5069,2979,0,36,20671
2/12/2016,22,11511,1076,4434,2851,0,36,19908
2/12/2016,23,11512,1092,4017,2468,0,36,19125
2/12/2016,24,11504,957,3930,2292,0,30,18713
2/13/2016,1,11495,914,4022,1850,0,23,18304
2/13/2016,2,11494,916,3778,1965,0,3,18156
2/13/2016,3,11502,919,4308,1380,0,3,18112
2/13/2016,4,11509,917,4254,1655,0,3,18338
2/13/2016,5,11507,910,4250,1722,0,3,18392
2/13/2016,6,11508,914,4299,1904,0,3,18628
2/13/2016,7,11518,904,4314,1927,0,2,18665
2/13/2016,8,11520,909,4821,2093,3,8,19354
2/13/2016,9,11503,1158,5185,1881,39,30,19796
2/13/2016,10,11528,1245,5184,1540,84,59,19640
2/13/2016,11,11522,1111,5091,1498,113,61,19396
2/13/2016,12,11524,1221,4994,1692,118,56,19605
2/13/2016,13,11518,1484,4989,1523,119,52,19685
2/13/2016,14,11524,1736,4844,1630,118,49,19901
2/13/2016,15,11518,1729,4889,1484,114,49,19783
2/13/2016,16,11523,1829,5019,1498,94,47,20010
2/13/2016,17,11522,2084,5317,1947,49,71,20990
2/13/2016,18,11523,2618,5926,1979,6,132,22184
2/13/2016,19,11525,3158,6101,1708,0,75,22567
2/13/2016,20,11536,3537,6186,1459,0,13,22731
2/13/2016,21,11538,3205,5993,1224,0,39,21999
2/13/2016,22,11537,2515,5748,1033,0,74,20907
2/13/2016,23,11527,1766,5565,853,0,101,19812
2/13/2016,24,11513,1596,5533,638,0,12,19292
2/14/2016,1,11527,1584,5057,534,0,0,18702
2/14/2016,2,11537,1643,5114,497,0,6,18797
2/14/2016,3,11531,1528,4921,442,0,8,18430
2/14/2016,4,11532,1717,4786,399,0,13,18447
2/14/2016,5,11544,2152,4714,464,0,3,18877
2/14/2016,6,11548,2453,4779,411,0,3,19194
2/14/2016,7,11545,2767,4891,428,0,7,19638
2/14/2016,8,11545,3164,5141,477,5,24,20356
2/14/2016,9,11541,3005,5238,485,47,59,20375
2/14/2016,10,11527,2884,5042,439,96,63,20051
2/14/2016,11,11541,2749,5191,405,122,91,20099
2/14/2016,12,11541,2635,4643,419,132,67,19437
2/14/2016,13,11542,2188,4715,437,141,62,19085
2/14/2016,14,11502,2199,4192,497,132,66,18588
2/14/2016,15,11537,2356,3955,451,131,24,18454
2/14/2016,16,11539,2391,4233,674,111,7,18955
2/14/2016,17,11540,2560,4934,676,55,6,19771
2/14/2016,18,11560,3427,5696,801,4,6,21494
2/14/2016,19,11557,3771,5791,1167,0,7,22293
2/14/2016,20,11555,3481,5496,1503,0,42,22077
2/14/2016,21,11557,3441,4814,1562,0,55,21429
2/14/2016,22,11556,2722,4450,2025,0,55,20808
2/14/2016,23,11555,2012,4213,1954,0,55,19789
2/14/2016,24,11557,1048,4133,2099,0,55,18892
2/15/2016,1,11550,931,3942,1769,0,35,18227
2/15/2016,2,11561,933,3710,1670,0,6,17880
2/15/2016,3,11552,930,3730,1743,0,6,17961
2/15/2016,4,11544,939,3622,1590,0,6,17701
2/15/2016,5,11542,949,3615,1708,0,6,17820
2/15/2016,6,11540,998,3922,1893,0,6,18359
2/15/2016,7,11534,1163,4562,1870,0,6,19135
2/15/2016,8,11552,1482,4872,1796,3,6,19711
2/15/2016,9,11560,1384,4658,1840,20,6,19468
2/15/2016,10,11558,1272,4251,1772,32,6,18891
2/15/2016,11,11570,1341,3985,1832,36,6,18770
2/15/2016,12,11565,1239,4369,1638,35,6,18852
2/15/2016,13,11556,1331,4817,1417,25,6,19152
2/15/2016,14,11553,1635,4801,1270,16,6,19281
2/15/2016,15,11558,1999,4796,1045,10,6,19414
2/15/2016,16,11564,2214,5050,992,8,6,19834
2/15/2016,17,11567,2599,5527,911,3,6,20613
2/15/2016,18,11568,2663,5524,808,0,6,20569
2/15/2016,19,11582,2821,5542,640,0,6,20591
2/15/2016,20,11588,2437,5410,568,0,6,20009
2/15/2016,21,11591,2213,5409,550,0,5,19768
2/15/2016,22,11584,2040,5163,444,0,6,19237
2/15/2016,23,11585,1571,4819,336,0,6,18317
2/15/2016,24,11590,1134,4853,257,0,5,17839
2/16/2016,1,11584,1063,4342,194,0,6,17189
2/16/2016,2,11595,1069,3909,135,0,6,16714
2/16/2016,3,11410,1265,3960,96,0,16,16747
2/16/2016,4,11277,1622,3765,77,0,19,16760
2/16/2016,5,11048,1894,3667,129,0,22,16760
2/16/2016,6,11053,1884,4155,218,0,29,17339
2/16/2016,7,11332,1883,5016,298,0,33,18562
2/16/2016,8,11611,1939,5456,386,0,37,19429
2/16/2016,9,11261,2103,5548,355,0,44,19311
2/16/2016,10,10820,2485,5979,339,0,43,19666
2/16/2016,11,10825,2270,5557,391,0,50,19093
2/16/2016,12,10827,2202,5397,373,0,48,18847
2/16/2016,13,10821,1989,5475,302,0,50,18637
2/16/2016,14,10827,2237,5287,333,0,45,18729
2/16/2016,15,10825,2537,5388,352,0,38,19140
2/16/2016,16,10831,2593,5492,467,0,38,19421
2/16/2016,17,10827,2609,5412,710,0,37,19595
2/16/2016,18,10822,2867,5688,683,0,37,20097
2/16/2016,19,10825,3024,5910,730,0,37,20526
2/16/2016,20,10828,3001,5792,702,0,38,20361
2/16/2016,21,10818,2844,5714,558,0,38,19972
2/16/2016,22,10818,2615,5232,501,0,38,19204
2/16/2016,23,10822,1418,5008,469,0,38,17755
2/16/2016,24,10821,1101,4618,506,0,30,17076
2/17/2016,1,10822,851,4183,628,0,25,16509
2/17/2016,2,10823,812,4404,594,0,23,16656
2/17/2016,3,10826,820,4477,546,0,23,16692
2/17/2016,4,10834,820,4517,470,0,24,16665
2/17/2016,5,10829,821,4558,506,0,26,16740
2/17/2016,6,10831,866,4625,680,0,33,17035
2/17/2016,7,10824,986,4976,788,0,48,17622
2/17/2016,8,10820,990,5154,952,0,88,18004
2/17/2016,9,10814,977,5055,1128,0,121,18095
2/17/2016,10,10807,991,5348,1253,0,128,18527
2/17/2016,11,10809,1282,5340,1319,10,132,18892
2/17/2016,12,10815,1488,4908,1527,21,127,18886
2/17/2016,13,10818,1571,4738,1479,26,126,18758
2/17/2016,14,10694,1723,4726,1448,29,115,18735
2/17/2016,15,10801,1761,4668,1455,42,106,18833
2/17/2016,16,10812,2070,4785,1259,45,114,19085
2/17/2016,17,10811,2386,4952,1228,35,112,19524
2/17/2016,18,10800,2779,5439,1312,5,113,20448
2/17/2016,19,10798,3138,5640,1262,0,111,20949
2/17/2016,20,10800,3114,5642,1004,0,104,20664
2/17/2016,21,10789,3112,5694,764,0,55,20414
2/17/2016,22,10785,2970,5477,621,0,34,19887
2/17/2016,23,10788,2464,4826,477,0,35,18590
2/17/2016,24,10797,1834,4799,310,0,19,17759
2/18/2016,1,10789,1437,4826,260,0,17,17329
2/18/2016,2,10790,1440,4701,240,0,17,17188
2/18/2016,3,10774,1508,4733,236,0,21,17272
2/18/2016,4,10761,1494,4820,252,0,24,17351
2/18/2016,5,10761,1539,4983,299,0,24,17606
2/18/2016,6,10780,1629,4902,278,0,29,17618
2/18/2016,7,10773,1913,5469,281,0,57,18493
2/18/2016,8,10773,2348,5668,382,10,73,19254
2/18/2016,9,10771,2238,5449,479,57,89,19083
2/18/2016,10,10760,2268,5118,510,101,135,18892
2/18/2016,11,10760,2276,5137,564,137,134,19008
2/18/2016,12,10757,2267,5058,610,168,123,18983
2/18/2016,13,10752,2449,4699,684,188,126,18898
2/18/2016,14,10749,2209,4548,620,193,145,18464
2/18/2016,15,10750,2173,4591,617,190,156,18477
2/18/2016,16,10749,2297,4627,520,142,148,18483
2/18/2016,17,10744,2333,4666,980,80,148,18951
2/18/2016,18,10753,2210,5297,1455,5,138,19858
2/18/2016,19,10746,2787,5437,1810,0,142,20922
2/18/2016,20,10739,2897,5153,1738,0,144,20671
2/18/2016,21,10736,2365,5100,1435,0,82,19718
2/18/2016,22,10719,1747,5028,1894,0,59,19447
2/18/2016,23,10728,1137,4692,1851,0,56,18464
2/18/2016,24,10916,929,4037,1990,0,38,17910
2/19/2016,1,11015,926,3940,1645,0,29,17555
2/19/2016,2,11140,924,3909,1401,0,35,17409
2/19/2016,3,11139,925,4010,1146,0,28,17248
2/19/2016,4,11151,924,3895,1085,0,33,17088
2/19/2016,5,11302,925,3852,1160,0,35,17274
2/19/2016,6,11304,922,4008,1445,0,57,17736
2/19/2016,7,11308,925,4249,1898,0,78,18458
2/19/2016,8,11317,937,4688,2676,4,127,19749
2/19/2016,9,11314,934,4744,2707,23,140,19862
2/19/2016,10,11235,909,4809,2517,33,141,19644
2/19/2016,11,11219,879,4654,2559,78,142,19531
2/19/2016,12,11216,878,4501,2520,91,137,19343
2/19/2016,13,11303,876,4472,2515,125,129,19420
2/19/2016,14,11370,875,4546,2088,58,126,19063
2/19/2016,15,11370,911,4516,2064,50,127,19038
2/19/2016,16,11369,916,4620,2143,15,123,19186
2/19/2016,17,11393,918,4530,2466,6,123,19436
2/19/2016,18,11532,917,4674,2093,0,128,19344
2/19/2016,19,11544,921,4546,2507,0,127,19645
2/19/2016,20,11554,921,4510,2333,0,130,19448
2/19/2016,21,11547,920,4316,2738,0,98,19619
2/19/2016,22,11552,914,4148,2270,0,87,18971
2/19/2016,23,11551,916,3775,1540,0,87,17869
2/19/2016,24,11572,793,3640,788,0,61,16854
2/20/2016,1,11478,771,3582,535,0,53,16419
2/20/2016,2,10985,769,3600,385,0,56,15795
2/20/2016,3,10559,769,3650,705,0,57,15740
2/20/2016,4,10455,757,3616,786,0,55,15669
2/20/2016,5,10454,715,3587,807,0,56,15619
2/20/2016,6,10450,715,3666,704,0,53,15588
2/20/2016,7,10450,699,3712,796,0,45,15702
2/20/2016,8,10456,671,3683,1243,6,47,16106
2/20/2016,9,10454,672,3877,1153,41,17,16214
2/20/2016,10,10451,672,4143,1446,57,7,16776
2/20/2016,11,10466,672,3913,1723,109,7,16890
2/20/2016,12,10718,669,3992,1359,112,8,16858
2/20/2016,13,10752,668,3852,1775,111,6,17164
2/20/2016,14,11008,666,3854,1264,91,6,16889
2/20/2016,15,10994,668,3793,1201,120,6,16782
2/20/2016,16,11042,673,4243,984,50,7,16999
2/20/2016,17,11063,699,4276,1069,47,7,17161
2/20/2016,18,11405,701,4914,1278,8,7,18313
2/20/2016,19,11603,713,5003,1751,0,7,19077
2/20/2016,20,11605,714,4970,1190,0,7,18486
2/20/2016,21,11595,714,4370,1229,0,7,17915
2/20/2016,22,11592,716,4179,1013,0,7,17507
2/20/2016,23,11596,727,3825,988,0,6,17142
2/20/2016,24,11595,666,3710,808,0,5,16784
2/21/2016,1,11425,665,3534,691,0,4,16319
2/21/2016,2,11047,669,3555,496,0,4,15771
2/21/2016,3,10449,674,3681,502,0,4,15310
2/21/2016,4,10141,674,3980,464,0,4,15263
2/21/2016,5,10142,675,4048,492,0,4,15361
2/21/2016,6,10142,705,4030,661,0,4,15542
2/21/2016,7,10142,729,3952,825,0,4,15652
2/21/2016,8,10143,734,3959,894,0,4,15734
2/21/2016,9,10136,739,4184,1042,8,4,16113
2/21/2016,10,10322,742,4346,891,39,4,16344
2/21/2016,11,10391,748,4256,895,107,4,16401
2/21/2016,12,10392,713,4536,876,136,4,16657
2/21/2016,13,10392,694,5183,725,95,4,17093
2/21/2016,14,10530,743,5379,620,40,4,17316
2/21/2016,15,10991,742,4826,694,36,4,17293
2/21/2016,16,10989,750,5166,640,27,3,17575
2/21/2016,17,11136,752,5471,762,7,3,18131
2/21/2016,18,11436,781,5597,846,1,15,18676
2/21/2016,19,11589,942,6038,802,0,14,19385
2/21/2016,20,11594,1051,5429,907,0,11,18992
2/21/2016,21,11580,1028,5159,904,0,3,18674
2/21/2016,22,11571,755,5204,799,0,3,18332
2/21/2016,23,11567,754,4527,724,0,6,17578
2/21/2016,24,11581,753,4137,600,0,19,17090
2/22/2016,1,11401,803,4019,227,0,19,16469
2/22/2016,2,11035,870,4116,466,0,19,16506
2/22/2016,3,11035,995,4125,370,0,19,16544
2/22/2016,4,11038,1064,4042,457,0,19,16620
2/22/2016,5,11035,1130,4104,327,0,18,16614
2/22/2016,6,11033,1304,4296,393,0,20,17046
2/22/2016,7,11033,1615,5222,278,0,32,18180
2/22/2016,8,11313,1738,5400,235,7,43,18736
2/22/2016,9,11585,1701,5374,120,10,47,18837
2/22/2016,10,11389,1702,4987,80,17,48,18223
2/22/2016,11,10590,1736,5096,137,144,48,17751
2/22/2016,12,10432,1634,5259,146,187,53,17711
2/22/2016,13,10429,1661,5102,126,175,57,17550
2/22/2016,14,10431,1887,4998,133,169,57,17675
2/22/2016,15,10429,1738,5173,145,140,57,17682
2/22/2016,16,10867,1751,5112,154,94,64,18042
2/22/2016,17,11328,1834,5064,163,48,84,18521
2/22/2016,18,11588,1748,5626,177,7,141,19287
2/22/2016,19,11589,1964,6015,222,0,205,19995
2/22/2016,20,11589,1882,5811,307,0,213,19802
2/22/2016,21,11588,1876,5502,387,0,211,19564
2/22/2016,22,11581,1720,5495,428,0,204,19428
2/22/2016,23,11585,1132,5004,542,0,131,18394
2/22/2016,24,11581,893,4606,636,0,76,17792
2/23/2016,1,11585,895,3936,736,0,33,17185
2/23/2016,2,11452,900,3762,695,0,26,16835
2/23/2016,3,11339,899,3820,884,0,24,16966
2/23/2016,4,11342,896,3788,914,0,24,16964
2/23/2016,5,11330,895,3730,945,0,21,16921
2/23/2016,6,11330,895,3808,973,0,24,17030
2/23/2016,7,11520,894,4511,954,0,32,17911
2/23/2016,8,11576,913,5292,497,10,35,18323
2/23/2016,9,11575,916,5047,603,53,37,18231
2/23/2016,10,11575,987,5171,599,101,37,18470
2/23/2016,11,11576,1003,5043,682,136,37,18477
2/23/2016,12,11573,1065,5029,708,125,38,18538
2/23/2016,13,11574,1100,5122,742,117,38,18693
2/23/2016,14,11574,1103,5020,858,109,37,18701
2/23/2016,15,11578,1111,4965,713,93,57,18517
2/23/2016,16,11585,1110,5079,732,93,88,18687
2/23/2016,17,11583,1134,5135,982,45,153,19032
2/23/2016,18,11586,1295,5700,1103,8,200,19892
2/23/2016,19,11582,1454,5718,1215,0,213,20182
2/23/2016,20,11568,1331,5676,1339,0,226,20140
2/23/2016,21,11562,1304,4959,1511,0,225,19561
2/23/2016,22,11550,978,4916,1440,0,194,19078
2/23/2016,23,11532,897,4070,1505,0,98,18102
2/23/2016,24,11520,881,3716,1354,0,36,17507
2/24/2016,1,11539,882,3387,1562,0,21,17391
2/24/2016,2,11559,882,3182,1599,0,21,17243
2/24/2016,3,11572,882,3155,1417,0,23,17049
2/24/2016,4,11574,881,3188,1330,0,22,16995
2/24/2016,5,11572,880,3183,1417,0,22,17074
2/24/2016,6,11575,883,3281,1356,0,24,17119
2/24/2016,7,11576,917,4029,1809,0,27,18358
2/24/2016,8,11572,932,4882,1856,0,34,19276
2/24/2016,9,11564,936,4989,2131,2,34,19656
2/24/2016,10,11563,1082,5063,2400,2,35,20145
2/24/2016,11,11558,1094,4823,2802,3,33,20313
2/24/2016,12,11563,1109,4588,2801,4,34,20099
2/24/2016,13,11566,1313,4744,2879,7,34,20543
2/24/2016,14,11567,1256,4924,2453,5,37,20242
2/24/2016,15,11570,1238,4668,2592,8,37,20113
2/24/2016,16,11568,1311,4705,2226,4,36,19850
2/24/2016,17,11559,1398,5378,2535,0,37,20907
2/24/2016,18,11554,1656,5696,2130,0,37,21073
2/24/2016,19,11556,1589,5750,1891,0,37,20823
2/24/2016,20,11554,1555,5674,1768,0,42,20593
2/24/2016,21,11557,1526,5416,1767,0,40,20306
2/24/2016,22,11552,1306,4847,1901,0,37,19643
2/24/2016,23,11549,1272,4499,1659,0,37,19016
2/24/2016,24,11551,972,4347,1297,0,28,18195
2/25/2016,1,11556,886,3959,1178,0,25,17604
2/25/2016,2,11557,883,3448,1254,0,23,17165
2/25/2016,3,11559,887,3316,1387,0,22,17171
2/25/2016,4,11558,886,3130,1132,0,23,16729
2/25/2016,5,11551,886,3252,1063,0,22,16774
2/25/2016,6,11549,886,3402,1425,0,27,17289
2/25/2016,7,11560,886,4183,1582,0,27,18238
2/25/2016,8,11565,902,4464,1662,1,27,18621
2/25/2016,9,11558,909,4653,2092,7,27,19246
2/25/2016,10,11560,907,4952,1798,13,28,19258
2/25/2016,11,11558,912,4909,2069,18,32,19498
2/25/2016,12,11559,912,4795,2398,27,33,19724
2/25/2016,13,11559,986,4810,2283,36,43,19717
2/25/2016,14,11559,1015,4430,2343,54,32,19433
2/25/2016,15,11563,1195,4528,2325,38,18,19667
2/25/2016,16,11562,1645,4556,2171,20,8,19962
2/25/2016,17,11556,1706,4876,1568,4,7,19717
2/25/2016,18,11552,1699,4976,2153,0,5,20385
2/25/2016,19,11555,1696,5375,2203,0,5,20834
2/25/2016,20,11554,1553,5337,2406,0,5,20855
2/25/2016,21,11550,1505,5264,2342,0,5,20666
2/25/2016,22,11537,1344,4993,2171,0,5,20050
2/25/2016,23,11541,1321,4219,2066,0,5,19152
2/25/2016,24,11548,1304,3702,2052,0,5,18611
2/26/2016,1,11556,993,3155,2298,0,6,18008
2/26/2016,2,11553,904,3121,2232,0,6,17816
2/26/2016,3,11558,921,3143,2173,0,7,17802
2/26/2016,4,11556,924,3008,1935,0,5,17428
2/26/2016,5,11560,1034,3104,2079,0,5,17782
2/26/2016,6,11561,1367,3233,1936,0,5,18102
2/26/2016,7,11560,1565,4450,1831,0,7,19413
2/26/2016,8,11551,1653,5071,1600,13,7,19895
2/26/2016,9,11550,1651,4767,1549,57,5,19579
2/26/2016,10,11399,1454,5165,1433,115,9,19575
2/26/2016,11,11440,1356,5168,1065,182,7,19218
2/26/2016,12,11484,1435,5053,1252,186,6,19416
2/26/2016,13,11527,1591,5011,1021,167,7,19324
2/26/2016,14,11546,1762,4787,819,148,19,19081
2/26/2016,15,11539,1878,4813,613,128,17,18988
2/26/2016,16,11539,1824,4807,588,111,6,18875
2/26/2016,17,11552,1887,5071,633,53,5,19201
2/26/2016,18,11553,1899,5867,513,9,5,19846
2/26/2016,19,11549,2153,6379,447,0,5,20533
2/26/2016,20,11550,2269,6113,543,0,5,20480
2/26/2016,21,11537,2137,5914,729,0,5,20322
2/26/2016,22,11527,1195,5449,1047,0,5,19223
2/26/2016,23,11530,922,4879,1303,0,6,18640
2/26/2016,24,11530,760,4485,1472,0,5,18252
2/27/2016,1,11530,750,3509,1773,0,5,17567
2/27/2016,2,11531,749,3223,1890,0,5,17398
2/27/2016,3,11530,747,3192,1790,0,5,17264
2/27/2016,4,11528,746,3114,1856,0,5,17249
2/27/2016,5,11530,747,3137,1750,0,5,17169
2/27/2016,6,11526,746,3169,2017,0,5,17463
2/27/2016,7,11530,744,3729,1380,0,5,17388
2/27/2016,8,11537,742,3919,1727,4,5,17934
2/27/2016,9,11533,742,4100,2127,17,5,18524
2/27/2016,10,11532,740,4047,2087,63,5,18474
2/27/2016,11,11524,737,3942,2436,73,5,18717
2/27/2016,12,11523,739,3769,2568,121,5,18725
2/27/2016,13,11523,743,3791,2514,144,8,18723
2/27/2016,14,11482,742,3686,2675,137,6,18728
2/27/2016,15,11520,742,3747,2650,103,5,18767
2/27/2016,16,11532,746,3747,2816,57,5,18903
2/27/2016,17,11528,749,4176,2476,17,5,18951
2/27/2016,18,11528,782,4843,2296,3,5,19457
2/27/2016,19,11527,789,4910,2637,0,5,19868
2/27/2016,20,11510,800,4863,2395,0,5,19573
2/27/2016,21,11500,799,4825,1828,0,5,18957
2/27/2016,22,11519,802,4157,1716,0,5,18199
2/27/2016,23,11516,804,3658,1894,0,5,17877
2/27/2016,24,11448,803,3623,814,0,5,16693
2/28/2016,1,11206,804,3228,1364,0,5,16607
2/28/2016,2,11206,805,3372,769,0,5,16157
2/28/2016,3,10946,809,3359,768,0,5,15887
2/28/2016,4,10922,808,3239,728,0,5,15702
2/28/2016,5,10919,806,3203,957,0,5,15890
2/28/2016,6,10921,803,3312,1140,0,5,16181
2/28/2016,7,10932,807,3722,1162,0,4,16627
2/28/2016,8,10935,803,3864,1259,13,9,16883
2/28/2016,9,10937,801,4016,1210,54,12,17030
2/28/2016,10,11225,801,3936,1415,89,9,17475
2/28/2016,11,11526,801,3868,1176,106,6,17483
2/28/2016,12,11525,800,3812,1259,149,6,17551
2/28/2016,13,11525,794,3824,1256,146,5,17550
2/28/2016,14,11523,796,3779,1177,134,5,17414
2/28/2016,15,11525,791,3782,1096,95,8,17297
2/28/2016,16,11529,788,3880,1258,92,9,17556
2/28/2016,17,11521,789,3917,1901,58,10,18196
2/28/2016,18,11518,791,4193,2466,10,17,18995
2/28/2016,19,11512,788,4523,2578,0,20,19421
2/28/2016,20,11502,788,4456,2515,0,28,19289
2/28/2016,21,11501,788,4125,2421,0,21,18856
2/28/2016,22,11495,791,3854,2109,0,10,18259
2/28/2016,23,11490,791,3694,1802,0,9,17786
2/28/2016,24,11491,788,3607,1274,0,9,17169
2/29/2016,1,11376,795,3295,849,0,7,16322
2/29/2016,2,10946,794,3300,473,0,9,15522
2/29/2016,3,10058,794,3266,449,0,13,14580
2/29/2016,4,9638,797,3314,1346,0,14,15109
2/29/2016,5,9898,797,3369,1890,0,18,15972
2/29/2016,6,10323,823,3472,2472,0,17,17107
2/29/2016,7,10942,872,4052,2083,1,15,17965
2/29/2016,8,11441,945,4497,1904,5,16,18808
2/29/2016,9,11494,953,4584,1921,19,10,18981
2/29/2016,10,11491,955,4638,1833,50,7,18974
2/29/2016,11,11496,956,4490,2089,111,4,19146
2/29/2016,12,11496,954,4279,2223,119,5,19076
2/29/2016,13,11496,990,4122,2434,105,2,19149
2/29/2016,14,11495,998,4033,2154,83,3,18766
2/29/2016,15,11494,1020,3946,2353,49,1,18863
2/29/2016,16,11488,1062,3983,2944,23,2,19502
2/29/2016,17,11469,1117,4261,3244,7,6,20104
2/29/2016,18,11369,1172,4806,3083,1,0,20431
2/29/2016,19,11364,1169,5238,2741,0,0,20512
2/29/2016,20,11357,1181,5409,2683,0,0,20630
2/29/2016,21,11358,1176,5335,2756,0,0,20625
2/29/2016,22,11357,1169,5179,2273,0,0,19978
2/29/2016,23,11358,1170,5012,1910,0,0,19450
2/29/2016,24,11358,991,4825,1533,0,0,18707
3/1/2016,1,11356,938,4559,797,0,0,17650
3/1/2016,2,11360,931,4531,478,0,6,17306
3/1/2016,3,11353,930,4293,393,0,6,16975
3/1/2016,4,11327,987,4435,356,0,17,17122
3/1/2016,5,11289,1086,4478,455,0,21,17329
3/1/2016,6,11287,1145,4676,630,0,20,17758
3/1/2016,7,11293,1235,5158,591,0,25,18302
3/1/2016,8,11290,1158,5554,312,4,29,18347
3/1/2016,9,11289,1153,5464,626,28,25,18585
3/1/2016,10,11294,1152,5410,808,70,27,18761
3/1/2016,11,11127,1165,4993,1490,73,24,18872
3/1/2016,12,11278,1034,4735,1730,87,30,18894
3/1/2016,13,11287,1000,4535,1879,70,32,18803
3/1/2016,14,11292,1096,4300,2347,59,35,19129
3/1/2016,15,11021,1272,4501,2400,45,30,19269
3/1/2016,16,11016,1621,4526,2205,39,31,19438
3/1/2016,17,11014,1714,4818,2251,15,35,19847
3/1/2016,18,11024,2005,5594,2018,3,36,20680
3/1/2016,19,11025,2220,5825,1970,0,35,21075
3/1/2016,20,11026,2109,5873,1975,0,33,21016
3/1/2016,21,11021,2143,5787,2050,0,32,21033
3/1/2016,22,11007,2014,5718,1993,0,33,20765
3/1/2016,23,11006,1452,4890,1998,0,28,19374
3/1/2016,24,11010,1073,4529,1981,0,24,18617
3/2/2016,1,11014,937,4124,1852,0,23,17950
3/2/2016,2,11019,945,3919,1845,0,18,17746
3/2/2016,3,11022,1006,3836,1753,0,18,17635
3/2/2016,4,11006,1161,3929,1556,0,17,17669
3/2/2016,5,11005,1291,4024,1484,0,19,17823
3/2/2016,6,11009,1466,4511,1333,0,21,18340
3/2/2016,7,11010,1626,5128,1329,0,28,19121
3/2/2016,8,11011,1723,5495,1088,8,50,19375
3/2/2016,9,11007,1732,5786,1075,36,93,19729
3/2/2016,10,11012,1767,5415,1071,76,163,19504
3/2/2016,11,11029,1723,5427,1084,142,183,19588
3/2/2016,12,11033,1653,5172,1079,188,185,19310
3/2/2016,13,11038,1649,4774,830,188,161,18640
3/2/2016,14,10912,1695,4671,883,182,181,18524
3/2/2016,15,10882,1761,4765,871,131,163,18573
3/2/2016,16,10903,1806,4941,758,96,149,18653
3/2/2016,17,11043,1945,5254,681,43,181,19147
3/2/2016,18,11045,2405,5979,710,10,128,20277
3/2/2016,19,11043,3126,6302,437,0,100,21008
3/2/2016,20,11046,3058,6129,329,0,109,20671
3/2/2016,21,11046,2938,6084,287,0,140,20495
3/2/2016,22,11036,2908,5823,232,0,181,20180
3/2/2016,23,11038,2423,5333,214,0,173,19181
3/2/2016,24,11038,1886,4814,271,0,115,18124
3/3/2016,1,11046,1814,4392,354,0,22,17628
3/3/2016,2,11047,1810,4268,439,0,15,17579
3/3/2016,3,11051,1737,4543,441,0,14,17786
3/3/2016,4,11052,1830,4590,360,0,14,17846
3/3/2016,5,11047,1939,4614,378,0,14,17992
3/3/2016,6,11046,2187,4223,413,0,19,17888
3/3/2016,7,11059,2444,5046,451,1,29,19030
3/3/2016,8,11060,2529,5401,596,23,32,19641
3/3/2016,9,11062,2583,5120,565,70,34,19434
3/3/2016,10,11062,2586,4794,358,109,53,18962
3/3/2016,11,11059,2076,5122,238,163,128,18786
3/3/2016,12,11062,1693,5205,233,175,144,18512
3/3/2016,13,11062,1729,5029,261,122,118,18321
3/3/2016,14,11062,1939,4744,302,126,104,18277
3/3/2016,15,11064,1983,4726,226,127,142,18268
3/3/2016,16,11074,2289,4770,195,104,140,18572
3/3/2016,17,11072,2619,5219,206,57,160,19333
3/3/2016,18,11067,2649,5745,246,12,154,19873
3/3/2016,19,11073,2820,6102,284,0,97,20376
3/3/2016,20,11076,2963,6145,366,0,115,20665
3/3/2016,21,11071,3111,5981,424,0,136,20723
3/3/2016,22,11068,2643,5695,452,0,136,19994
3/3/2016,23,11072,2189,5237,417,0,118,19033
3/3/2016,24,11069,2010,4950,372,0,37,18438
3/4/2016,1,10286,2052,4777,344,0,15,17474
3/4/2016,2,10200,1857,4808,376,0,17,17258
3/4/2016,3,10205,1735,4613,401,0,16,16970
3/4/2016,4,10199,1806,4627,361,0,14,17007
3/4/2016,5,10193,2008,4772,293,0,15,17281
3/4/2016,6,10194,2281,4996,258,0,23,17752
3/4/2016,7,10201,2522,5567,238,0,29,18557
3/4/2016,8,10200,2372,5918,219,8,70,18787
3/4/2016,9,10199,2340,5885,143,49,114,18730
3/4/2016,10,10137,2342,5510,105,144,171,18409
3/4/2016,11,10133,2199,5043,79,194,211,17859
3/4/2016,12,10136,2154,5119,85,193,230,17917
3/4/2016,13,10192,2171,4767,118,184,237,17669
3/4/2016,14,10195,1790,5034,99,173,232,17523
3/4/2016,15,10195,1849,4985,77,169,234,17509
3/4/2016,16,10189,1974,5052,82,132,233,17662
3/4/2016,17,10178,2060,5329,60,80,212,17919
3/4/2016,18,10190,2356,6022,36,26,180,18810
3/4/2016,19,10199,2691,6044,27,0,201,19162
3/4/2016,20,10201,3050,5957,60,0,210,19478
3/4/2016,21,10198,3089,5874,102,0,203,19466
3/4/2016,22,10197,2470,5626,135,0,208,18636
3/4/2016,23,10188,2051,5184,222,0,182,17827
3/4/2016,24,10182,2110,4742,287,0,94,17415
3/5/2016,1,10191,2182,4558,314,0,43,17288
3/5/2016,2,10199,1615,4201,373,0,28,16416
3/5/2016,3,10199,1558,3989,372,0,30,16148
3/5/2016,4,10197,1448,4021,381,0,34,16081
3/5/2016,5,10203,1388,4053,326,0,32,16002
3/5/2016,6,10209,1474,4139,255,0,27,16104
3/5/2016,7,10205,1728,3971,177,1,28,16110
3/5/2016,8,10211,1543,4055,354,12,59,16234
3/5/2016,9,10204,1486,4455,405,42,95,16687
3/5/2016,10,10209,1496,5114,364,95,185,17463
3/5/2016,11,10220,1491,5325,299,121,204,17660
3/5/2016,12,10220,1549,4907,237,118,203,17234
3/5/2016,13,10220,1680,5064,141,114,200,17419
3/5/2016,14,10216,1705,5137,87,77,172,17394
3/5/2016,15,10218,1419,4700,76,69,152,16634
3/5/2016,16,10214,1394,4820,90,63,162,16743
3/5/2016,17,10213,1770,5274,109,36,137,17539
3/5/2016,18,10210,2117,4991,65,7,163,17553
3/5/2016,19,10204,2354,5623,105,0,201,18487
3/5/2016,20,10206,2608,5487,91,0,168,18560
3/5/2016,21,10199,2646,5122,139,0,187,18293
3/5/2016,22,10199,2489,4568,154,0,191,17601
3/5/2016,23,10213,1906,4545,173,0,165,17002
3/5/2016,24,10210,1693,4305,159,0,74,16441
3/6/2016,1,10196,1370,4289,157,0,30,16042
3/6/2016,2,10206,1291,4273,170,0,15,15955
3/6/2016,3,10188,1292,3949,175,0,14,15618
3/6/2016,4,10205,1337,4018,201,0,15,15776
3/6/2016,5,10212,1039,3880,193,0,16,15340
3/6/2016,6,10206,941,4447,202,0,15,15811
3/6/2016,7,10216,957,4978,247,1,19,16418
3/6/2016,8,10218,921,4753,308,40,38,16278
3/6/2016,9,10213,892,4502,230,53,70,15960
3/6/2016,10,10211,888,4260,421,164,85,16029
3/6/2016,11,10212,888,4369,572,194,151,16386
3/6/2016,12,10217,890,4158,907,173,120,16465
3/6/2016,13,10217,963,4018,1405,167,91,16861
3/6/2016,14,10217,1132,3795,1241,176,172,16733
3/6/2016,15,10214,1295,3823,1201,142,189,16864
3/6/2016,16,10217,1357,3791,1499,115,192,17171
3/6/2016,17,10221,1330,4203,1517,83,178,17532
3/6/2016,18,10219,1354,4982,1778,21,203,18557
3/6/2016,19,10225,1440,5560,2020,0,205,19450
3/6/2016,20,10355,1447,5112,2131,0,165,19210
3/6/2016,21,10454,1446,4514,2109,0,160,18683
3/6/2016,22,10451,1353,4352,2016,0,180,18352
3/6/2016,23,10455,1344,3667,2155,0,181,17802
3/6/2016,24,10456,995,3712,1565,0,96,16824
3/7/2016,1,10456,916,3616,1125,0,47,16160
3/7/2016,2,10422,918,3637,780,0,36,15793
3/7/2016,3,10426,916,3591,703,0,27,15663
3/7/2016,4,10478,918,3535,726,0,20,15677
3/7/2016,5,10266,917,3538,1074,0,21,15816
3/7/2016,6,10357,918,3599,1535,0,26,16435
3/7/2016,7,10819,921,3886,2045,0,38,17709
3/7/2016,8,10897,930,4322,2278,10,82,18519
3/7/2016,9,10897,927,4508,2262,34,129,18757
3/7/2016,10,10899,923,4705,2219,38,195,18979
3/7/2016,11,10900,928,4319,1876,84,227,18334
3/7/2016,12,10902,931,4112,1544,150,225,17864
3/7/2016,13,10974,927,3955,1016,187,228,17287
3/7/2016,14,11058,917,3906,951,185,230,17247
3/7/2016,15,11055,942,4201,1042,178,226,17644
3/7/2016,16,11059,941,4669,1109,135,222,18135
3/7/2016,17,11054,954,4648,1073,74,223,18026
3/7/2016,18,11058,977,5102,1110,18,222,18487
3/7/2016,19,11056,1116,5181,1490,0,221,19064
3/7/2016,20,11060,1117,4953,1434,0,219,18783
3/7/2016,21,11047,1118,4963,1643,0,229,19000
3/7/2016,22,11051,1115,4722,1370,0,234,18492
3/7/2016,23,11047,943,4270,1570,0,188,18018
3/7/2016,24,11049,871,3654,1003,0,81,16658
3/8/2016,1,11056,873,3516,1017,0,27,16489
3/8/2016,2,11088,868,3630,600,0,18,16204
3/8/2016,3,10702,868,3579,673,0,22,15844
3/8/2016,4,10483,868,3590,861,0,23,15825
3/8/2016,5,10483,870,3666,1451,0,22,16492
3/8/2016,6,10753,872,3777,1305,0,25,16732
3/8/2016,7,11097,873,4055,1480,0,30,17535
3/8/2016,8,11102,887,4430,1428,6,36,17889
3/8/2016,9,11099,884,4520,1388,23,39,17953
3/8/2016,10,11112,879,4498,1336,43,44,17912
3/8/2016,11,11113,905,4177,1367,95,37,17694
3/8/2016,12,11100,910,4236,1409,136,37,17828
3/8/2016,13,11098,901,4124,1592,129,37,17881
3/8/2016,14,11094,899,4003,1744,121,36,17897
3/8/2016,15,11092,878,4030,1838,92,36,17966
3/8/2016,16,11094,849,4060,1755,46,36,17840
3/8/2016,17,11094,871,4233,1904,43,44,18189
3/8/2016,18,11090,894,4993,1986,7,46,19016
3/8/2016,19,11094,902,5015,2391,0,54,19456
3/8/2016,20,11088,875,5052,2564,0,59,19638
3/8/2016,21,11082,876,4807,2346,0,46,19157
3/8/2016,22,11086,874,4207,2475,0,35,18677
3/8/2016,23,11080,876,3750,1946,0,35,17687
3/8/2016,24,11080,878,3528,1172,0,22,16680
3/9/2016,1,10755,868,3504,806,0,20,15953
3/9/2016,2,10050,860,3571,744,0,19,15244
3/9/2016,3,9923,873,3587,1154,0,19,15556
3/9/2016,4,9926,877,3565,1081,0,20,15469
3/9/2016,5,9921,856,3514,1260,0,21,15572
3/9/2016,6,10049,878,3546,1757,0,24,16254
3/9/2016,7,10457,891,3887,1378,0,27,16640
3/9/2016,8,10782,906,4294,1611,13,35,17641
3/9/2016,9,10694,905,4411,1615,41,36,17702
3/9/2016,10,10691,900,4305,1656,83,36,17671
3/9/2016,11,10768,896,4134,1900,94,35,17827
3/9/2016,12,11086,882,4177,1653,58,35,17891
3/9/2016,13,11091,883,4102,1397,35,34,17542
3/9/2016,14,11095,902,4047,1265,28,34,17371
3/9/2016,15,11093,911,4020,1382,11,34,17451
3/9/2016,16,11091,911,4052,1342,51,34,17481
3/9/2016,17,11088,906,4066,1379,32,35,17506
3/9/2016,18,11089,907,4329,1750,3,37,18115
3/9/2016,19,11088,903,4537,1494,0,37,18059
3/9/2016,20,11093,894,4568,1529,0,37,18121
3/9/2016,21,11089,915,4576,1415,0,36,18031
3/9/2016,22,11074,916,4098,1370,0,36,17494
3/9/2016,23,11070,915,3771,781,0,34,16571
3/9/2016,24,10849,905,3632,357,0,16,15759
3/10/2016,1,10340,902,3501,540,0,3,15286
3/10/2016,2,10081,886,3478,215,0,2,14662
3/10/2016,3,9706,856,3508,215,0,2,14287
3/10/2016,4,9628,856,3419,432,0,2,14337
3/10/2016,5,9629,895,3494,462,0,2,14482
3/10/2016,6,10019,909,3763,576,0,14,15281
3/10/2016,7,10544,910,4682,533,0,39,16708
3/10/2016,8,10847,914,4792,530,1,62,17146
3/10/2016,9,11067,923,5180,470,6,125,17771
3/10/2016,10,11066,921,5009,403,10,180,17589
3/10/2016,11,11067,920,5198,376,12,205,17778
3/10/2016,12,11063,915,4924,334,21,201,17458
3/10/2016,13,11054,919,4821,381,27,195,17397
3/10/2016,14,11053,920,4832,405,27,129,17366
3/10/2016,15,11049,918,4704,603,21,79,17374
3/10/2016,16,11038,917,4493,804,13,38,17303
3/10/2016,17,11042,913,4722,893,6,34,17610
3/10/2016,18,11049,918,4991,997,0,34,17989
3/10/2016,19,11047,919,5306,750,0,34,18056
3/10/2016,20,11047,964,5696,543,0,33,18283
3/10/2016,21,11046,967,5667,524,0,33,18237
3/10/2016,22,11034,960,5034,840,0,34,17902
3/10/2016,23,11041,918,3890,936,0,34,16819
3/10/2016,24,11040,909,3591,598,0,25,16163
3/11/2016,1,10900,906,3608,402,0,19,15835
3/11/2016,2,10389,910,3610,312,0,17,15238
3/11/2016,3,9965,910,3546,452,0,18,14891
3/11/2016,4,9893,912,3499,560,0,17,14881
3/11/2016,5,9893,912,3530,556,0,17,14908
3/11/2016,6,10108,912,3647,817,0,23,15507
3/11/2016,7,10461,911,4448,674,0,29,16523
3/11/2016,8,10881,919,4873,454,11,34,17172
3/11/2016,9,11047,911,5127,295,45,34,17459
3/11/2016,10,11044,910,5129,334,54,33,17504
3/11/2016,11,11050,917,4926,414,88,34,17429
3/11/2016,12,11052,937,4779,217,115,40,17140
3/11/2016,13,11053,940,4463,149,97,40,16742
3/11/2016,14,11055,968,4406,84,130,33,16676
3/11/2016,15,11053,988,4181,200,186,38,16646
3/11/2016,16,11062,1114,4149,244,160,44,16773
3/11/2016,17,11064,1124,4504,241,90,75,17098
3/11/2016,18,11063,1145,4555,301,15,120,17199
3/11/2016,19,11059,1270,4919,350,0,131,17729
3/11/2016,20,11057,1285,5213,347,0,104,18006
3/11/2016,21,11055,1290,4961,336,0,86,17728
3/11/2016,22,11052,1219,4750,431,0,80,17532
3/11/2016,23,11054,964,4146,557,0,40,16761
3/11/2016,24,11057,562,3971,750,0,26,16366
3/12/2016,1,10907,428,3399,650,0,19,15403
3/12/2016,2,10761,430,3394,596,0,12,15193
3/12/2016,3,10758,431,3487,547,0,14,15237
3/12/2016,4,10542,430,3537,655,0,14,15178
3/12/2016,5,10448,378,3673,817,0,15,15331
3/12/2016,6,10599,375,3667,787,0,15,15443
3/12/2016,7,10759,377,3715,873,1,20,15745
3/12/2016,8,10761,375,3947,501,14,21,15619
3/12/2016,9,10758,374,4054,622,49,23,15880
3/12/2016,10,10756,375,4116,500,115,22,15884
3/12/2016,11,10756,372,4220,607,158,21,16134
3/12/2016,12,10757,373,4212,607,170,20,16139
3/12/2016,13,10758,373,3976,489,190,22,15808
3/12/2016,14,10756,368,3724,701,188,21,15758
3/12/2016,15,10752,365,3695,640,142,20,15614
3/12/2016,16,10751,367,3881,598,100,31,15728
3/12/2016,17,10775,366,4177,555,40,83,15996
3/12/2016,18,11038,369,4535,632,17,23,16614
3/12/2016,19,11060,373,5054,777,0,24,17288
3/12/2016,20,11062,395,4883,916,0,24,17280
3/12/2016,21,11060,430,4550,877,0,23,16940
3/12/2016,22,11055,434,4533,630,0,23,16675
3/12/2016,23,11055,426,3910,521,0,22,15934
3/12/2016,24,11046,425,3491,437,0,23,15422
3/13/2016,1,10583,425,3336,245,0,23,14612
3/13/2016,2,10294,425,3374,262,0,23,14378
3/13/2016,3,10045,426,3341,320,0,23,14155
3/13/2016,4,9639,426,3403,415,0,23,13906
3/13/2016,5,9474,426,3330,475,0,23,13728
3/13/2016,6,9322,425,3354,1063,0,22,14186
3/13/2016,7,9324,427,3423,1731,2,21,14928
3/13/2016,8,9484,425,3564,1604,25,22,15124
3/13/2016,9,10089,423,3739,796,0,21,15068
3/13/2016,10,10507,421,3687,960,0,20,15595
3/13/2016,11,10514,419,3618,942,0,21,15514
3/13/2016,12,10516,416,3701,1078,25,21,15757
3/13/2016,13,10402,415,3785,828,9,22,15461
3/13/2016,14,10489,414,3772,1033,74,21,15803
3/13/2016,15,10513,422,3817,1112,58,22,15944
3/13/2016,16,10743,422,3877,1228,62,21,16353
3/13/2016,17,11010,422,3870,1386,32,21,16741
3/13/2016,18,11066,421,3927,1767,7,21,17209
3/13/2016,19,11067,423,4026,2315,0,22,17853
3/13/2016,20,11066,425,3991,2426,0,21,17929
3/13/2016,21,11066,421,4078,2065,0,20,17650
3/13/2016,22,11065,423,3953,1486,0,20,16947
3/13/2016,23,11062,422,3635,870,0,20,16009
3/13/2016,24,10847,423,3359,452,0,20,15101
3/14/2016,1,10270,424,3386,850,0,19,14949
3/14/2016,2,10077,424,3444,833,0,20,14798
3/14/2016,3,9922,441,3394,816,0,18,14591
3/14/2016,4,9923,484,3382,648,0,18,14455
3/14/2016,5,9921,542,3416,1209,0,24,15112
3/14/2016,6,10081,701,3385,1772,0,34,15973
3/14/2016,7,10618,847,3747,1914,0,56,17182
3/14/2016,8,11037,863,3926,1675,3,59,17563
3/14/2016,9,11057,856,4218,1984,11,57,18183
3/14/2016,10,11055,854,4290,2041,24,55,18319
3/14/2016,11,11058,853,4058,1838,25,52,17884
3/14/2016,12,11060,858,3808,1615,32,56,17429
3/14/2016,13,11042,796,3872,1546,32,55,17343
3/14/2016,14,11045,840,3884,1489,35,52,17345
3/14/2016,15,11045,869,4031,1204,26,50,17225
3/14/2016,16,11049,872,4895,928,19,48,17811
3/14/2016,17,11051,884,5455,592,8,59,18049
3/14/2016,18,11045,891,5521,479,5,90,18031
3/14/2016,19,11053,959,5497,480,0,134,18123
3/14/2016,20,11044,1086,5407,494,0,176,18207
3/14/2016,21,11050,1096,5066,446,0,200,17858
3/14/2016,22,11053,1096,4550,384,0,187,17270
3/14/2016,23,11058,1086,3986,335,0,122,16587
3/14/2016,24,11061,953,3546,373,0,36,15969
3/15/2016,1,10899,895,3385,265,0,20,15464
3/15/2016,2,10338,897,3370,185,0,19,14809
3/15/2016,3,10162,894,3369,325,0,20,14770
3/15/2016,4,10160,895,3395,440,0,20,14910
3/15/2016,5,10231,899,3881,454,0,23,15488
3/15/2016,6,10630,899,4177,470,0,25,16201
3/15/2016,7,11046,908,4345,327,0,33,16659
3/15/2016,8,11059,911,4837,292,5,34,17138
3/15/2016,9,11060,900,5207,297,13,34,17511
3/15/2016,10,11066,893,5164,349,29,40,17541
3/15/2016,11,11066,890,4993,302,35,50,17336
3/15/2016,12,11064,891,4960,212,34,83,17244
3/15/2016,13,11068,898,4902,171,24,82,17145
3/15/2016,14,11066,900,4709,118,20,82,16895
3/15/2016,15,11069,912,4696,71,20,84,16852
3/15/2016,16,11067,977,4740,36,23,153,16996
3/15/2016,17,11068,1042,4853,62,9,209,17243
3/15/2016,18,11113,1079,4843,119,2,189,17345
3/15/2016,19,11115,1083,5252,201,0,163,17814
3/15/2016,20,11116,1087,5570,295,0,132,18200
3/15/2016,21,11101,983,4857,477,0,94,17512
3/15/2016,22,11058,907,4286,505,0,85,16841
3/15/2016,23,11060,831,3721,783,0,50,16445
3/15/2016,24,10995,795,3408,339,0,21,15558
3/16/2016,1,10380,795,3350,348,0,20,14893
3/16/2016,2,9707,793,3334,521,0,21,14376
3/16/2016,3,9523,794,3377,452,0,21,14167
3/16/2016,4,9519,794,3339,1022,0,22,14696
3/16/2016,5,9522,795,3386,884,0,23,14610
3/16/2016,6,9785,805,3662,1672,0,28,15952
3/16/2016,7,10388,828,3833,2131,0,33,17213
3/16/2016,8,10946,830,4277,1649,5,34,17741
3/16/2016,9,11076,850,4280,1739,21,35,18001
3/16/2016,10,11055,893,3989,2301,37,35,18310
3/16/2016,11,11056,981,3711,2606,41,34,18429
3/16/2016,12,11061,978,3744,2282,74,34,18173
3/16/2016,13,11063,982,3879,2191,52,35,18202
3/16/2016,14,11052,1029,3865,1899,88,36,17969
3/16/2016,15,11052,1058,3914,1552,94,35,17705
3/16/2016,16,11059,1085,3961,1461,86,35,17687
3/16/2016,17,11062,929,4159,1536,57,36,17779
3/16/2016,18,11063,905,4044,2088,21,36,18157
3/16/2016,19,11060,905,4411,2252,1,35,18664
3/16/2016,20,11061,904,4336,2511,0,35,18847
3/16/2016,21,11055,907,4219,2138,0,35,18354
3/16/2016,22,11055,908,4001,1133,0,35,17132
3/16/2016,23,11060,899,3623,650,0,25,16257
3/16/2016,24,10793,896,3577,591,0,21,15878
3/17/2016,1,10310,893,3506,579,0,20,15308
3/17/2016,2,10092,893,3496,491,0,20,14992
3/17/2016,3,9859,890,3431,516,0,20,14716
3/17/2016,4,9848,896,3382,648,0,19,14793
3/17/2016,5,9846,899,3442,1070,0,21,15278
3/17/2016,6,10154,909,3496,1662,1,26,16248
3/17/2016,7,10601,929,3906,1667,5,34,17142
3/17/2016,8,10824,935,4083,1442,34,34,17352
3/17/2016,9,11044,936,4204,948,69,34,17235
3/17/2016,10,11050,935,4261,743,86,35,17110
3/17/2016,11,11052,933,3956,1044,116,34,17135
3/17/2016,12,11052,932,3852,1354,183,36,17409
3/17/2016,13,11048,1026,3775,1497,191,35,17572
3/17/2016,14,11049,984,3666,1208,182,35,17124
3/17/2016,15,11043,920,3678,1401,117,34,17193
3/17/2016,16,11035,916,3753,1573,34,34,17345
3/17/2016,17,11032,917,3865,1710,22,35,17581
3/17/2016,18,11036,924,4106,1560,9,35,17670
3/17/2016,19,11031,924,4232,1899,0,34,18120
3/17/2016,20,11029,924,4214,1710,0,34,17911
3/17/2016,21,11016,924,4294,1612,0,34,17880
3/17/2016,22,11010,925,3970,1514,0,35,17454
3/17/2016,23,10993,921,3948,670,0,24,16556
3/17/2016,24,10729,919,3477,846,0,20,15991
3/18/2016,1,10711,912,3404,488,0,19,15534
3/18/2016,2,10464,911,3358,298,0,19,15050
3/18/2016,3,10130,914,3374,507,0,19,14944
3/18/2016,4,10106,910,3431,981,0,19,15447
3/18/2016,5,10404,912,3460,1043,0,21,15840
3/18/2016,6,10704,911,4015,883,0,27,16540
3/18/2016,7,10850,923,4525,787,1,34,17120
3/18/2016,8,10993,927,4785,704,8,35,17452
3/18/2016,9,10939,930,4631,756,33,34,17323
3/18/2016,10,10878,928,4368,780,85,35,17074
3/18/2016,11,10884,928,4164,557,102,35,16670
3/18/2016,12,10886,925,4056,704,109,36,16716
3/18/2016,13,10875,924,3956,990,136,38,16919
3/18/2016,14,10994,922,3998,656,113,36,16719
3/18/2016,15,11054,921,3965,540,70,37,16587
3/18/2016,16,11046,923,3987,538,42,38,16574
3/18/2016,17,11051,922,4017,657,45,36,16728
3/18/2016,18,11056,924,4019,746,10,36,16791
3/18/2016,19,11062,927,4324,1206,0,36,17555
3/18/2016,20,11061,929,4648,1589,0,36,18263
3/18/2016,21,11061,929,4723,1283,0,36,18032
3/18/2016,22,11065,921,4183,1103,0,36,17308
3/18/2016,23,11065,796,3930,1040,0,26,16857
3/18/2016,24,11064,782,3602,590,0,20,16058
3/19/2016,1,10939,785,3601,467,0,5,15797
3/19/2016,2,10621,774,3606,349,0,5,15355
3/19/2016,3,10515,736,3608,416,0,5,15280
3/19/2016,4,10518,734,3560,444,0,5,15261
3/19/2016,5,10515,737,3600,647,0,5,15504
3/19/2016,6,10816,736,3704,861,0,5,16122
3/19/2016,7,11062,736,3903,812,6,4,16523
3/19/2016,8,11063,734,3958,763,60,3,16581
3/19/2016,9,11063,736,3934,371,109,4,16217
3/19/2016,10,11064,734,4028,294,110,6,16236
3/19/2016,11,11068,730,4079,302,176,5,16360
3/19/2016,12,11072,729,4164,389,194,3,16551
3/19/2016,13,11073,726,3874,421,186,4,16284
3/19/2016,14,11078,723,3669,241,146,4,15861
3/19/2016,15,11037,722,3677,140,20,4,15600
3/19/2016,16,11071,723,3704,310,112,5,15925
3/19/2016,17,11069,724,3830,631,107,5,16366
3/19/2016,18,11062,726,4285,977,30,11,17091
3/19/2016,19,11061,733,4655,936,1,6,17392
3/19/2016,20,11058,774,5168,904,0,6,17910
3/19/2016,21,11062,777,5083,807,0,6,17735
3/19/2016,22,11058,775,4591,661,0,6,17091
3/19/2016,23,11044,778,3971,616,0,6,16415
3/19/2016,24,10705,779,3537,451,0,7,15479
3/20/2016,1,10511,779,3521,684,0,7,15502
3/20/2016,2,10514,771,3562,502,0,7,15356
3/20/2016,3,10512,732,3444,474,0,6,15168
3/20/2016,4,10509,729,3471,491,0,6,15206
3/20/2016,5,10507,734,3487,597,0,6,15331
3/20/2016,6,10532,751,3585,695,0,6,15569
3/20/2016,7,10819,753,3760,572,6,6,15916
3/20/2016,8,11059,751,3768,432,51,6,16067
3/20/2016,9,11068,749,3826,150,41,6,15840
3/20/2016,10,11062,746,3943,102,21,6,15880
3/20/2016,11,10806,761,3950,179,178,6,15880
3/20/2016,12,10777,758,4043,197,179,6,15960
3/20/2016,13,10775,798,3992,265,172,6,16008
3/20/2016,14,11000,848,3906,179,123,6,16062
3/20/2016,15,11079,900,3839,111,23,9,15961
3/20/2016,16,11076,947,4021,162,26,24,16256
3/20/2016,17,11077,962,4264,505,106,56,16970
3/20/2016,18,11078,980,4600,486,36,105,17285
3/20/2016,19,11076,1113,5118,517,1,173,17998
3/20/2016,20,11071,1158,5798,401,0,170,18598
3/20/2016,21,11071,1176,5401,320,0,172,18140
3/20/2016,22,11071,1011,4930,264,0,166,17442
3/20/2016,23,11074,827,4245,287,0,96,16529
3/20/2016,24,11072,774,3482,305,0,36,15669
3/21/2016,1,11073,773,3477,416,0,22,15761
3/21/2016,2,11075,787,3483,408,0,22,15775
3/21/2016,3,11075,800,3392,436,0,21,15724
3/21/2016,4,11064,804,3489,276,0,21,15654
3/21/2016,5,11074,848,3510,721,0,28,16181
3/21/2016,6,11070,916,4026,1269,0,30,17311
3/21/2016,7,11070,1103,4444,1406,5,40,18068
3/21/2016,8,11070,1109,4411,1233,40,37,17900
3/21/2016,9,11061,1110,4562,549,81,33,17396
3/21/2016,10,11058,1111,4528,764,141,35,17637
3/21/2016,11,11061,1105,4344,882,148,36,17576
3/21/2016,12,11064,1106,4179,925,171,39,17484
3/21/2016,13,11068,952,4107,1033,165,23,17348
3/21/2016,14,11063,922,4168,975,132,1,17261
3/21/2016,15,11067,924,4085,1004,110,29,17219
3/21/2016,16,11065,928,4140,1081,89,54,17357
3/21/2016,17,11063,966,4362,1029,51,93,17564
3/21/2016,18,11068,1113,4699,765,22,172,17839
3/21/2016,19,11066,1123,5538,539,0,207,18473
3/21/2016,20,11063,1158,6006,362,0,212,18801
3/21/2016,21,11064,1166,5555,254,0,210,18249
3/21/2016,22,11063,1124,4816,328,0,195,17526
3/21/2016,23,11057,1107,4113,423,0,100,16800
3/21/2016,24,11055,937,3558,290,0,38,15878
3/22/2016,1,10931,918,3552,392,0,21,15814
3/22/2016,2,10815,918,3463,313,0,20,15529
3/22/2016,3,10816,918,3416,267,0,20,15437
3/22/2016,4,10820,919,3516,383,0,19,15657
3/22/2016,5,10812,920,3849,413,0,24,16018
3/22/2016,6,10961,943,4796,513,0,27,17240
3/22/2016,7,11083,1024,5213,778,8,29,18135
3/22/2016,8,11084,1117,4917,1038,45,25,18226
3/22/2016,9,11082,1112,4536,984,93,26,17833
3/22/2016,10,11082,1107,4452,792,117,26,17576
3/22/2016,11,11082,1102,4549,1138,138,25,18034
3/22/2016,12,11078,1097,4263,1007,114,33,17592
3/22/2016,13,11072,1102,4040,1213,143,39,17609
3/22/2016,14,11075,1102,4038,1530,85,39,17869
3/22/2016,15,11075,1100,4118,1406,57,37,17793
3/22/2016,16,11074,1099,4786,1494,31,37,18521
3/22/2016,17,11075,1096,4692,1361,14,38,18276
3/22/2016,18,11076,932,4815,1232,2,37,18094
3/22/2016,19,11079,918,5147,1598,0,37,18779
3/22/2016,20,11065,919,5323,1554,0,37,18898
3/22/2016,21,10977,921,4756,1566,0,37,18257
3/22/2016,22,10257,925,4297,1432,0,37,16948
3/22/2016,23,10251,918,3773,1457,0,31,16430
3/22/2016,24,10261,919,3539,1321,0,25,16065
3/23/2016,1,10270,917,3457,969,0,22,15635
3/23/2016,2,10266,920,3449,569,0,20,15224
3/23/2016,3,10269,920,3360,680,0,20,15249
3/23/2016,4,10271,921,3378,738,0,20,15328
3/23/2016,5,10269,920,3768,440,0,26,15423
3/23/2016,6,10256,937,4587,994,0,30,16804
3/23/2016,7,10270,975,5220,1074,0,34,17573
3/23/2016,8,10266,1123,5388,1086,6,37,17906
3/23/2016,9,10265,1121,5346,1086,20,37,17875
3/23/2016,10,10268,1120,4823,1371,35,37,17654
3/23/2016,11,10274,1119,4662,1268,51,37,17411
3/23/2016,12,10273,1118,4552,1047,52,37,17079
3/23/2016,13,10268,1119,4596,1032,81,37,17133
3/23/2016,14,10262,1087,4438,1129,96,38,17050
3/23/2016,15,10257,1037,4571,1195,74,37,17171
3/23/2016,16,10256,1076,4511,1497,29,37,17406
3/23/2016,17,10258,1127,4906,1621,15,37,17964
3/23/2016,18,10252,1022,5289,1698,5,37,18303
3/23/2016,19,10254,934,5487,1932,0,37,18644
3/23/2016,20,10252,932,5497,1877,0,37,18595
3/23/2016,21,10243,932,4916,2297,0,38,18426
3/23/2016,22,10246,934,4505,1665,0,38,17388
3/23/2016,23,10251,926,4319,1492,0,27,17015
3/23/2016,24,10246,925,3846,1410,0,23,16450
3/24/2016,1,10246,925,3454,1547,0,22,16194
3/24/2016,2,10245,929,3443,1371,0,19,16007
3/24/2016,3,10244,930,3415,1277,0,20,15886
3/24/2016,4,10234,928,3443,1350,0,20,15975
3/24/2016,5,10249,925,3507,1853,0,28,16562
3/24/2016,6,10251,932,4201,2016,0,33,17433
3/24/2016,7,10254,997,4810,2014,1,33,18109
3/24/2016,8,10253,1119,5025,2096,4,30,18527
3/24/2016,9,10253,1117,5297,2083,8,36,18794
3/24/2016,10,10260,1114,5409,1932,23,36,18774
3/24/2016,11,10259,1115,5544,1933,32,34,18917
3/24/2016,12,10260,1167,5698,1675,21,37,18858
3/24/2016,13,10261,1336,5814,1347,31,39,18828
3/24/2016,14,10257,1430,5792,1050,55,40,18624
3/24/2016,15,10258,1546,5006,985,62,50,17907
3/24/2016,16,10260,1531,4706,1103,30,65,17695
3/24/2016,17,10258,1415,4772,1403,10,130,17988
3/24/2016,18,10264,1526,4769,1745,1,201,18506
3/24/2016,19,10261,1758,4718,1863,0,183,18783
3/24/2016,20,10260,1855,4625,1736,0,138,18614
3/24/2016,21,9683,1924,4636,1394,0,87,17724
3/24/2016,22,9139,1925,4376,1323,0,92,16855
3/24/2016,23,9105,1553,4280,1046,0,22,16006
3/24/2016,24,9108,1437,3958,719,0,3,15225
3/25/2016,1,9104,1237,3457,966,0,3,14767
3/25/2016,2,9101,843,3432,918,0,3,14297
3/25/2016,3,9101,588,3394,945,0,0,14028
3/25/2016,4,9103,568,3437,825,0,0,13933
3/25/2016,5,9108,571,3369,1012,0,0,14060
3/25/2016,6,9111,572,3334,1076,0,0,14093
3/25/2016,7,9108,569,3404,1243,0,0,14324
3/25/2016,8,9102,568,3467,1266,10,2,14415
3/25/2016,9,9102,594,3917,1384,14,3,15014
3/25/2016,10,9101,650,4506,1167,32,1,15457
3/25/2016,11,9103,616,4796,1031,52,0,15598
3/25/2016,12,9551,616,4332,1081,63,1,15644
3/25/2016,13,10010,459,4313,670,47,0,15499
3/25/2016,14,10000,428,4295,588,65,0,15376
3/25/2016,15,9997,431,4334,597,59,0,15418
3/25/2016,16,9996,437,4354,324,42,0,15153
3/25/2016,17,10120,440,4431,301,22,0,15314
3/25/2016,18,10200,499,4581,128,8,0,15416
3/25/2016,19,10196,614,4953,97,1,0,15861
3/25/2016,20,10189,642,5195,129,0,0,16155
3/25/2016,21,10193,620,4674,154,0,0,15641
3/25/2016,22,10186,615,4384,148,0,0,15333
3/25/2016,23,10195,605,4168,117,0,0,15085
3/25/2016,24,10030,606,3795,207,0,0,14638
3/26/2016,1,9792,604,3495,312,0,0,14203
3/26/2016,2,9787,605,3405,346,0,0,14143
3/26/2016,3,9789,604,3515,285,0,0,14193
3/26/2016,4,9797,604,3621,298,0,0,14320
3/26/2016,5,9891,606,3885,266,0,0,14648
3/26/2016,6,10179,606,4141,215,1,0,15142
3/26/2016,7,10258,606,4052,101,2,1,15020
3/26/2016,8,10256,607,4507,179,34,1,15584
3/26/2016,9,10256,619,4610,144,66,0,15695
3/26/2016,10,10259,607,4400,130,110,0,15506
3/26/2016,11,10258,606,4238,155,145,0,15402
3/26/2016,12,10256,603,4483,126,170,0,15638
3/26/2016,13,10257,604,4017,120,176,8,15182
3/26/2016,14,10259,603,3704,145,186,10,14907
3/26/2016,15,10253,605,3679,163,173,16,14889
3/26/2016,16,10251,605,3672,256,149,19,14952
3/26/2016,17,10247,601,4138,258,95,15,15354
3/26/2016,18,10243,607,4726,239,34,12,15861
3/26/2016,19,10250,663,5301,198,1,14,16427
3/26/2016,20,10248,685,5791,269,0,14,17007
3/26/2016,21,10240,661,5371,451,0,9,16732
3/26/2016,22,10219,614,4544,544,0,1,15922
3/26/2016,23,10242,606,4089,778,0,0,15715
3/26/2016,24,10240,605,3345,522,0,0,14712
3/27/2016,1,10070,604,3331,392,0,0,14397
3/27/2016,2,9929,603,3283,402,0,3,14220
3/27/2016,3,9781,605,3322,393,0,5,14106
3/27/2016,4,9631,606,3392,456,0,5,14090
3/27/2016,5,9698,604,3385,509,0,5,14201
3/27/2016,6,9937,603,3453,540,0,5,14538
3/27/2016,7,9940,604,3708,569,11,5,14837
3/27/2016,8,9936,604,4235,437,51,5,15268
3/27/2016,9,9934,604,4246,345,103,6,15238
3/27/2016,10,9935,601,3905,300,141,6,14888
3/27/2016,11,9933,601,3642,317,187,6,14686
3/27/2016,12,9873,600,3726,437,195,7,14838
3/27/2016,13,9633,599,3758,380,195,6,14571
3/27/2016,14,9633,601,3674,385,192,6,14491
3/27/2016,15,9633,602,3704,299,180,6,14424
3/27/2016,16,9630,602,3733,438,158,6,14567
3/27/2016,17,9647,600,3971,655,99,5,14977
3/27/2016,18,10072,598,4060,528,32,5,15295
3/27/2016,19,10250,598,4325,756,1,4,15934
3/27/2016,20,10246,600,4328,1381,0,4,16559
3/27/2016,21,10247,579,4325,973,0,4,16128
3/27/2016,22,10317,417,4066,621,0,4,15425
3/27/2016,23,10046,417,3568,217,0,4,14252
3/27/2016,24,9751,419,3335,694,0,5,14204
3/28/2016,1,9749,415,3308,469,0,10,13951
3/28/2016,2,9752,415,3291,542,0,21,14021
3/28/2016,3,9751,421,3302,432,0,21,13927
3/28/2016,4,9759,489,3259,504,0,22,14033
3/28/2016,5,9758,545,3342,688,0,27,14360
3/28/2016,6,10021,689,3401,1061,0,32,15204
3/28/2016,7,10616,859,3399,1512,0,37,16423
3/28/2016,8,11054,877,3574,1537,3,45,17090
3/28/2016,9,11062,892,4004,1584,11,45,17598
3/28/2016,10,11065,898,4007,1786,15,46,17817
3/28/2016,11,11062,903,3642,2199,37,51,17894
3/28/2016,12,11057,907,3680,1992,42,48,17726
3/28/2016,13,11062,905,3675,2224,28,37,17931
3/28/2016,14,11062,904,3735,1907,78,30,17716
3/28/2016,15,11066,904,4203,1458,97,25,17753
3/28/2016,16,11057,904,4277,1752,33,24,18047
3/28/2016,17,11062,901,4011,2315,17,24,18330
3/28/2016,18,11060,894,4334,1970,6,25,18289
3/28/2016,19,11061,901,4330,2359,1,28,18680
3/28/2016,20,11055,910,4591,2006,0,28,18590
3/28/2016,21,11058,911,4525,1753,0,29,18276
3/28/2016,22,11062,915,4046,1704,0,29,17756
3/28/2016,23,11062,920,3762,822,0,23,16589
3/28/2016,24,10848,918,3369,539,0,20,15694
3/29/2016,1,10504,920,3401,669,0,19,15513
3/29/2016,2,10502,922,3326,653,0,15,15418
3/29/2016,3,10506,923,3314,521,0,15,15279
3/29/2016,4,10500,922,3335,672,0,16,15445
3/29/2016,5,10502,923,3314,856,0,22,15617
3/29/2016,6,10718,924,3917,1362,0,25,16946
3/29/2016,7,11041,928,4094,1274,13,29,17379
3/29/2016,8,11034,924,4194,640,52,30,16874
3/29/2016,9,11052,925,4003,298,41,48,16367
3/29/2016,10,11062,926,4031,387,97,71,16574
3/29/2016,11,10873,927,3966,443,112,90,16411
3/29/2016,12,10594,927,3523,793,194,116,16147
3/29/2016,13,10514,920,3660,619,196,188,16097
3/29/2016,14,10514,917,4006,472,194,196,16299
3/29/2016,15,10602,914,3959,366,193,197,16231
3/29/2016,16,10955,916,3736,272,172,186,16237
3/29/2016,17,11066,916,3954,231,76,100,16343
3/29/2016,18,11064,918,4474,214,40,116,16826
3/29/2016,19,11064,923,4998,280,2,178,17445
3/29/2016,20,11055,924,5076,389,0,206,17650
3/29/2016,21,11057,926,4857,392,0,205,17437
3/29/2016,22,11058,926,4050,462,0,181,16677
3/29/2016,23,10865,924,3793,538,0,79,16199
3/29/2016,24,10444,921,3367,536,0,20,15288
3/30/2016,1,9955,921,3364,596,0,14,14850
3/30/2016,2,9914,920,3287,841,0,15,14977
3/30/2016,3,9918,919,3359,747,0,13,14956
3/30/2016,4,9920,918,3382,562,0,15,14797
3/30/2016,5,9921,916,3282,1022,0,18,15159
3/30/2016,6,9936,915,3916,1527,0,18,16312
3/30/2016,7,10440,918,4577,1489,14,16,17454
3/30/2016,8,10794,913,4473,1030,67,15,17292
3/30/2016,9,10825,908,4376,508,134,14,16765
3/30/2016,10,10468,906,4301,592,170,30,16467
3/30/2016,11,10063,904,4039,818,194,22,16040
3/30/2016,12,10062,903,3908,847,191,17,15928
3/30/2016,13,10062,901,3706,1378,172,18,16237
3/30/2016,14,10061,900,3628,1500,179,15,16283
3/30/2016,15,10062,899,3796,1398,152,17,16324
3/30/2016,16,10350,898,3830,1549,122,15,16764
3/30/2016,17,10853,897,3929,1465,64,19,17227
3/30/2016,18,10948,899,4329,803,1,23,17003
3/30/2016,19,11078,899,4623,741,0,23,17364
3/30/2016,20,11071,899,4603,1234,0,23,17830
3/30/2016,21,11062,898,4371,1035,0,25,17391
3/30/2016,22,10993,899,3851,653,0,24,16420
3/30/2016,23,10399,905,3408,415,0,19,15146
3/30/2016,24,9516,906,3379,518,0,16,14335
3/31/2016,1,9144,911,3276,533,0,14,13878
3/31/2016,2,8971,912,3235,361,0,14,13493
3/31/2016,3,8838,912,3220,493,0,14,13477
3/31/2016,4,8780,909,3132,773,0,14,13608
3/31/2016,5,8770,906,3296,1073,0,17,14062
3/31/2016,6,9042,912,3447,2023,0,20,15444
3/31/2016,7,9835,913,3699,2261,0,26,16734
3/31/2016,8,10319,915,3941,1741,2,27,16945
3/31/2016,9,10326,912,4019,1934,9,32,17232
3/31/2016,10,10325,909,3986,1914,15,37,17186
3/31/2016,11,10313,908,3949,1594,7,32,16803
3/31/2016,12,10311,907,3959,1681,17,31,16906
3/31/2016,13,10318,908,3898,1718,21,29,16892
3/31/2016,14,10314,906,3804,1615,15,28,16682
3/31/2016,15,10316,903,3681,1678,18,33,16629
3/31/2016,16,10316,902,3746,2014,9,29,17016
3/31/2016,17,10319,905,3898,2050,26,20,17218
3/31/2016,18,10316,924,4008,1880,10,18,17156
3/31/2016,19,10323,934,4310,2249,1,17,17834
3/31/2016,20,10320,930,4289,2577,0,17,18133
3/31/2016,21,10308,929,4013,2063,0,15,17328
3/31/2016,22,10251,929,3728,1559,0,14,16481
3/31/2016,23,9789,934,3577,1078,0,15,15393
3/31/2016,24,9256,938,3504,811,0,17,14526
4/1/2016,1,8816,903,3437,593,0,18,13767
4/1/2016,2,8767,913,3253,387,0,18,13338
4/1/2016,3,8768,937,3302,410,0,19,13436
4/1/2016,4,8767,944,3485,433,0,19,13648
4/1/2016,5,8765,956,3669,672,0,21,14083
4/1/2016,6,9096,1003,4053,1386,1,24,15563
4/1/2016,7,10100,1108,4207,1059,3,29,16506
4/1/2016,8,10297,1102,4186,1264,31,30,16910
4/1/2016,9,10304,1102,4154,1041,72,30,16703
4/1/2016,10,10303,1104,4075,949,119,31,16581
4/1/2016,11,10304,1102,4090,1151,68,30,16745
4/1/2016,12,10300,1101,4037,1184,68,31,16721
4/1/2016,13,10307,1132,4059,1036,33,33,16600
4/1/2016,14,10307,1153,3936,920,56,34,16406
4/1/2016,15,10306,1171,3970,767,42,51,16307
4/1/2016,16,10297,1183,3967,798,24,81,16350
4/1/2016,17,10295,1238,4406,546,29,91,16605
4/1/2016,18,10284,1154,4643,717,17,86,16901
4/1/2016,19,10293,1195,4720,873,0,82,17163
4/1/2016,20,10287,1228,5076,1038,0,82,17711
4/1/2016,21,10290,1138,4653,1060,0,89,17230
4/1/2016,22,10295,1137,4142,1165,0,39,16778
4/1/2016,23,10230,929,3694,1218,0,10,16081
4/1/2016,24,9970,691,3630,860,0,0,15151
4/2/2016,1,9669,650,3436,842,0,0,14597
4/2/2016,2,9445,654,3352,1042,0,0,14493
4/2/2016,3,9449,664,3293,1142,0,0,14548
4/2/2016,4,9448,677,3368,947,0,0,14440
4/2/2016,5,9520,676,3527,916,0,0,14639
4/2/2016,6,9738,677,3985,657,0,0,15057
4/2/2016,7,9888,683,4401,516,4,0,15492
4/2/2016,8,10033,654,4635,499,38,1,15860
4/2/2016,9,10035,657,4792,800,51,0,16335
4/2/2016,10,10032,656,4408,1127,86,0,16309
4/2/2016,11,10031,658,4221,1209,143,0,16262
4/2/2016,12,10031,655,4115,1232,172,0,16205
4/2/2016,13,9989,641,4126,1278,104,0,16138
4/2/2016,14,10022,640,4076,1122,126,1,15987
4/2/2016,15,10026,641,4234,1109,77,0,16087
4/2/2016,16,10221,641,4446,1041,60,0,16409
4/2/2016,17,10270,643,4987,1071,41,1,17013
4/2/2016,18,10274,641,4625,1795,22,0,17357
4/2/2016,19,10274,655,4334,2130,1,0,17394
4/2/2016,20,10254,683,4267,2524,0,0,17728
4/2/2016,21,10217,684,4296,2109,0,0,17306
4/2/2016,22,10240,686,4172,2071,0,0,17169
4/2/2016,23,10257,662,3801,1787,0,0,16507
4/2/2016,24,10203,659,3672,1295,0,0,15829
4/3/2016,1,10021,661,3780,998,0,0,15460
4/3/2016,2,9798,663,3807,982,0,0,15250
4/3/2016,3,9717,660,3836,1037,0,0,15250
4/3/2016,4,9710,658,3915,923,0,0,15206
4/3/2016,5,9704,652,3937,973,0,0,15266
4/3/2016,6,9702,652,4053,1172,1,0,15580
4/3/2016,7,9702,653,4162,1181,8,0,15706
4/3/2016,8,9701,650,4362,1433,37,0,16183
4/3/2016,9,9701,650,4465,1227,113,0,16156
4/3/2016,10,9699,648,4595,1077,158,0,16177
4/3/2016,11,9697,654,4723,1031,149,0,16254
4/3/2016,12,9844,705,4749,1218,142,0,16658
4/3/2016,13,10000,779,4347,1202,132,0,16460
4/3/2016,14,9995,909,4294,1024,120,0,16342
4/3/2016,15,10005,1131,4553,783,114,0,16586
4/3/2016,16,10224,1164,4930,713,101,0,17132
4/3/2016,17,10241,1327,5632,618,54,0,17872
4/3/2016,18,10239,1348,5700,697,14,0,17998
4/3/2016,19,10246,1447,5153,1210,0,0,18056
4/3/2016,20,10237,1446,5127,1678,0,0,18488
4/3/2016,21,10239,957,4972,2093,0,0,18261
4/3/2016,22,10241,815,4758,2003,0,0,17817
4/3/2016,23,10244,676,4209,1998,0,0,17127
4/3/2016,24,10242,626,3912,1735,0,4,16519
4/4/2016,1,10247,627,3918,1531,0,21,16344
4/4/2016,2,10243,645,3853,1499,0,17,16257
4/4/2016,3,10232,756,3790,1552,0,13,16343
4/4/2016,4,10167,997,3819,1424,0,12,16419
4/4/2016,5,9928,1166,3837,1447,0,21,16399
4/4/2016,6,9691,1174,4138,1998,0,27,17028
4/4/2016,7,9907,1236,4508,2124,2,35,17812
4/4/2016,8,10237,1303,4554,2144,10,45,18293
4/4/2016,9,10229,1304,4513,2119,31,39,18235
4/4/2016,10,10228,1320,4261,1947,70,35,17861
4/4/2016,11,10228,1007,4293,1691,100,30,17349
4/4/2016,12,10224,919,4220,1473,129,33,16998
4/4/2016,13,10217,919,4211,1209,145,34,16735
4/4/2016,14,10202,1033,4241,1117,164,42,16799
4/4/2016,15,10199,1215,4110,983,152,45,16704
4/4/2016,16,10197,1338,4363,923,129,39,16989
4/4/2016,17,10195,1380,4485,848,88,31,17027
4/4/2016,18,10194,1515,4676,552,29,31,16997
4/4/2016,19,10186,1531,4771,975,3,32,17498
4/4/2016,20,10190,1533,4829,1647,0,31,18230
4/4/2016,21,10183,1532,4664,1415,0,33,17827
4/4/2016,22,10177,1221,4533,1119,0,32,17082
4/4/2016,23,10176,984,4399,820,0,20,16399
4/4/2016,24,10179,936,4148,531,0,16,15810
4/5/2016,1,10186,936,4058,392,0,14,15586
4/5/2016,2,9993,1057,4004,353,0,14,15421
4/5/2016,3,9714,1245,4009,313,0,15,15296
4/5/2016,4,9628,1381,4031,338,0,15,15393
4/5/2016,5,9622,1449,4641,322,0,17,16051
4/5/2016,6,9724,2006,5298,276,1,21,17326
4/5/2016,7,10174,2042,5608,270,17,30,18141
4/5/2016,8,10166,1846,5185,206,79,31,17513
4/5/2016,9,10163,1886,4624,64,90,31,16858
4/5/2016,10,10163,1468,4564,78,75,31,16379
4/5/2016,11,10166,1161,4626,109,107,31,16200
4/5/2016,12,10163,1140,4428,66,145,31,15973
4/5/2016,13,10165,1245,4460,92,117,31,16110
4/5/2016,14,10155,1375,4471,167,48,31,16247
4/5/2016,15,10144,1493,4230,236,50,31,16184
4/5/2016,16,10148,1528,4386,280,107,32,16481
4/5/2016,17,10155,1695,4386,373,102,32,16743
4/5/2016,18,10143,1837,4455,256,26,31,16748
4/5/2016,19,10144,1934,4613,489,2,31,17213
4/5/2016,20,10138,1953,5051,848,0,31,18021
4/5/2016,21,10117,1961,4659,869,0,31,17637
4/5/2016,22,10121,1350,4259,1060,0,31,16821
4/5/2016,23,10106,1009,4099,1011,0,19,16244
4/5/2016,24,10089,915,4004,478,0,16,15502
4/6/2016,1,10091,916,3617,357,0,18,14999
4/6/2016,2,9959,917,3648,299,0,17,14840
4/6/2016,3,9730,917,3659,341,0,22,14669
4/6/2016,4,9546,914,3608,672,0,26,14766
4/6/2016,5,9540,916,3606,1157,0,48,15267
4/6/2016,6,9846,914,3897,1899,0,60,16616
4/6/2016,7,10101,918,4237,1739,6,66,17067
4/6/2016,8,10100,918,4423,1842,24,66,17373
4/6/2016,9,10093,915,4494,1970,63,64,17599
4/6/2016,10,10101,915,4613,2493,49,64,18235
4/6/2016,11,10101,913,4212,2512,45,65,17848
4/6/2016,12,10053,910,4127,2414,39,65,17608
4/6/2016,13,9997,910,4172,2410,49,63,17601
4/6/2016,14,9998,907,4148,2463,23,67,17606
4/6/2016,15,9991,906,4326,2442,20,62,17747
4/6/2016,16,9989,913,4357,2489,10,68,17826
4/6/2016,17,10117,907,4475,2362,5,68,17934
4/6/2016,18,10198,906,4418,2241,2,66,17831
4/6/2016,19,10201,905,4629,2301,0,67,18103
4/6/2016,20,10200,908,4550,2542,0,61,18261
4/6/2016,21,10191,906,4563,2043,0,49,17752
4/6/2016,22,10192,906,4274,1696,0,50,17118
4/6/2016,23,10196,901,3968,762,0,38,15865
4/6/2016,24,9979,902,3661,467,0,27,15036
4/7/2016,1,9449,900,3626,711,0,19,14705
4/7/2016,2,9352,904,3586,479,0,19,14340
4/7/2016,3,9317,902,3597,344,0,19,14179
4/7/2016,4,9053,905,3622,641,0,17,14238
4/7/2016,5,9045,903,3656,1357,0,19,14980
4/7/2016,6,9117,899,4176,2075,0,25,16292
4/7/2016,7,9867,916,4773,1984,2,29,17571
4/7/2016,8,10201,906,4521,1596,7,30,17261
4/7/2016,9,10192,907,4745,1327,14,30,17215
4/7/2016,10,10187,906,4855,1163,34,30,17175
4/7/2016,11,10188,907,4841,1012,38,30,17016
4/7/2016,12,10189,901,4776,911,50,30,16857
4/7/2016,13,10212,905,4612,880,62,30,16701
4/7/2016,14,10171,905,4456,976,80,29,16617
4/7/2016,15,10168,906,4463,975,73,29,16614
4/7/2016,16,10177,906,4501,982,52,30,16648
4/7/2016,17,10177,908,4459,1823,25,30,17422
4/7/2016,18,10172,912,4741,1617,11,32,17485
4/7/2016,19,10174,911,4761,1842,2,32,17722
4/7/2016,20,10175,911,4761,2137,0,35,18019
4/7/2016,21,10164,916,4344,2083,0,31,17538
4/7/2016,22,9785,908,3716,2205,0,30,16644
4/7/2016,23,9431,905,3782,2056,0,21,16195
4/7/2016,24,9288,906,3731,1384,0,17,15326
4/8/2016,1,9294,909,3736,1010,0,15,14964
4/8/2016,2,9289,978,3748,771,0,15,14801
4/8/2016,3,9289,1001,3762,695,0,16,14763
4/8/2016,4,9285,1045,3740,826,0,15,14911
4/8/2016,5,9286,1193,3723,1398,0,18,15618
4/8/2016,6,9276,1305,4076,2126,0,24,16807
4/8/2016,7,9303,1311,4717,2089,2,29,17451
4/8/2016,8,9312,1326,5067,1867,18,29,17619
4/8/2016,9,9309,1353,4884,1792,44,29,17411
4/8/2016,10,9297,1383,4874,1435,90,29,17108
4/8/2016,11,9292,1399,4848,1084,102,29,16754
4/8/2016,12,9300,1229,4846,1022,114,29,16540
4/8/2016,13,9304,1178,4746,846,129,31,16234
4/8/2016,14,9303,1430,4565,700,115,32,16145
4/8/2016,15,9297,1770,4531,596,130,30,16354
4/8/2016,16,9294,1753,4626,388,99,29,16189
4/8/2016,17,9286,1711,4774,540,74,29,16414
4/8/2016,18,9290,1712,4987,529,27,29,16574
4/8/2016,19,9288,1743,5328,644,3,29,17035
4/8/2016,20,9284,1979,5882,604,0,29,17778
4/8/2016,21,9285,1829,5388,811,0,29,17342
4/8/2016,22,9287,1156,5000,1106,0,30,16579
4/8/2016,23,9287,883,4295,1397,0,20,15882
4/8/2016,24,9277,869,3751,1207,0,17,15121
4/9/2016,1,9299,880,3525,1002,0,15,14721
4/9/2016,2,9300,871,3552,784,0,14,14521
4/9/2016,3,9299,847,3571,629,0,15,14361
4/9/2016,4,9301,868,3578,573,0,16,14336
4/9/2016,5,9294,877,3565,805,0,15,14556
4/9/2016,6,9292,881,3538,1275,0,15,15001
4/9/2016,7,9300,881,3721,1486,19,18,15425
4/9/2016,8,9300,886,4043,1511,65,17,15822
4/9/2016,9,9296,883,4167,1215,121,17,15699
4/9/2016,10,9296,852,4257,964,149,15,15533
4/9/2016,11,9295,851,4108,1052,184,16,15506
4/9/2016,12,9293,849,3853,1154,195,15,15359
4/9/2016,13,9292,874,3677,1169,183,15,15210
4/9/2016,14,9329,890,3640,901,161,15,14936
4/9/2016,15,9364,991,3718,649,125,14,14861
4/9/2016,16,9366,1151,3835,714,65,14,15145
4/9/2016,17,9361,1268,4156,846,68,14,15713
4/9/2016,18,9368,1252,4423,980,40,14,16077
4/9/2016,19,9384,1309,4821,998,4,13,16529
4/9/2016,20,9378,1491,5520,594,0,14,16997
4/9/2016,21,9360,1587,5757,354,0,14,17072
4/9/2016,22,9382,1480,5573,226,0,13,16674
4/9/2016,23,9380,1152,5010,221,0,14,15777
4/9/2016,24,9385,948,4516,212,0,15,15076
4/10/2016,1,9387,895,4119,267,0,16,14684
4/10/2016,2,9386,895,3905,253,0,16,14455
4/10/2016,3,9386,896,3624,355,0,16,14277
4/10/2016,4,9389,895,3542,494,0,15,14335
4/10/2016,5,9388,895,3571,650,0,15,14519
4/10/2016,6,9393,890,3683,869,1,17,14853
4/10/2016,7,9393,890,3980,717,21,16,15017
4/10/2016,8,9392,862,4009,1002,69,15,15349
4/10/2016,9,9388,849,4117,985,115,15,15469
4/10/2016,10,9392,834,4000,1538,120,15,15899
4/10/2016,11,9396,826,3941,1862,81,19,16125
4/10/2016,12,9402,819,3908,1764,92,17,16002
4/10/2016,13,9408,817,3908,1577,75,16,15801
4/10/2016,14,9338,834,3925,1571,72,17,15757
4/10/2016,15,9404,874,4058,1464,92,15,15907
4/10/2016,16,9407,870,4185,2043,69,16,16590
4/10/2016,17,9409,871,4557,2371,22,16,17246
4/10/2016,18,9412,874,5042,2090,3,16,17437
4/10/2016,19,9411,890,5750,1615,0,16,17682
4/10/2016,20,9402,921,5701,1469,0,17,17510
4/10/2016,21,9402,867,5121,1604,0,16,17010
4/10/2016,22,9412,880,4746,1548,0,16,16602
4/10/2016,23,9407,878,4109,1582,0,16,15992
4/10/2016,24,9409,872,3725,1592,0,16,15614
4/11/2016,1,9399,872,3574,1286,0,16,15147
4/11/2016,2,9392,878,3570,956,0,15,14811
4/11/2016,3,9395,876,3565,716,0,17,14569
4/11/2016,4,9400,875,3574,952,0,17,14818
4/11/2016,5,9403,854,3566,1544,0,24,15391
4/11/2016,6,9405,866,4160,2099,0,24,16554
4/11/2016,7,9404,871,4952,1939,0,40,17206
4/11/2016,8,9398,881,5200,1981,1,49,17510
4/11/2016,9,9401,890,5086,1923,3,47,17350
4/11/2016,10,9401,889,5002,1906,5,48,17251
4/11/2016,11,9402,927,5096,1708,4,53,17190
4/11/2016,12,9399,1027,5035,1448,4,50,16963
4/11/2016,13,9398,1215,4592,1585,7,47,16844
4/11/2016,14,9399,1297,4442,1325,7,51,16521
4/11/2016,15,9399,1433,4678,1032,6,44,16592
4/11/2016,16,9398,1504,4652,1469,3,36,17062
4/11/2016,17,9398,1419,4512,1795,1,32,17157
4/11/2016,18,9398,1344,4638,1720,0,33,17133
4/11/2016,19,9398,1328,4639,1766,0,33,17164
4/11/2016,20,9393,1317,4632,1896,0,31,17269
4/11/2016,21,9388,1269,4601,1818,0,31,17107
4/11/2016,22,9382,946,4548,1554,0,31,16461
4/11/2016,23,9392,901,4042,1177,0,20,15532
4/11/2016,24,9393,908,3532,1006,0,17,14856
4/12/2016,1,9390,909,3435,760,0,22,14516
4/12/2016,2,9384,911,3381,626,0,16,14318
4/12/2016,3,9383,913,3340,627,0,15,14278
4/12/2016,4,9378,912,3421,754,0,14,14479
4/12/2016,5,9386,914,3542,1182,0,19,15043
4/12/2016,6,9393,914,4002,1833,0,23,16165
4/12/2016,7,9389,905,4405,1532,14,31,16276
4/12/2016,8,9392,888,4480,1661,47,30,16498
4/12/2016,9,9388,888,4402,1563,81,32,16354
4/12/2016,10,9390,905,4453,1914,87,31,16780
4/12/2016,11,9392,929,4500,1916,45,30,16812
4/12/2016,12,9393,943,4298,1981,60,30,16705
4/12/2016,13,9394,1005,4293,1774,35,31,16532
4/12/2016,14,9390,1209,4376,1365,47,31,16418
4/12/2016,15,9388,1474,4396,962,14,46,16280
4/12/2016,16,9383,1736,4391,806,62,74,16452
4/12/2016,17,9386,1871,4362,838,26,86,16569
4/12/2016,18,9383,1898,4592,663,17,87,16640
4/12/2016,19,9381,1903,4927,565,1,132,16909
4/12/2016,20,9378,2134,5679,317,0,194,17702
4/12/2016,21,9362,2252,5594,227,0,194,17629
4/12/2016,22,9360,1578,5146,180,0,195,16459
4/12/2016,23,9375,1071,5011,113,0,147,15717
4/12/2016,24,9379,923,4480,89,0,37,14908
4/13/2016,1,9378,923,4015,131,0,13,14460
4/13/2016,2,9371,939,4093,148,0,12,14563
4/13/2016,3,9373,1042,3906,187,0,13,14521
4/13/2016,4,9377,1227,3786,215,0,15,14620
4/13/2016,5,9371,1481,4271,212,0,19,15354
4/13/2016,6,9383,2089,4884,234,1,24,16615
4/13/2016,7,9378,2023,4953,312,16,30,16712
4/13/2016,8,9378,1899,4701,281,47,30,16336
4/13/2016,9,9372,1900,4519,179,76,31,16077
4/13/2016,10,9379,1899,4501,108,41,33,15961
4/13/2016,11,9378,1582,4174,170,82,42,15428
4/13/2016,12,9377,1422,4058,200,91,44,15192
4/13/2016,13,9368,1401,4086,183,92,32,15162
4/13/2016,14,9367,1569,4015,74,39,28,15092
4/13/2016,15,9366,1685,4067,93,56,25,15292
4/13/2016,16,9366,1686,4186,143,19,55,15455
4/13/2016,17,9364,1713,4506,207,37,148,15975
4/13/2016,18,9360,1713,4942,224,17,176,16432
4/13/2016,19,9360,1725,4909,231,1,194,16420
4/13/2016,20,9358,1729,5032,286,0,184,16589
4/13/2016,21,9357,1753,5213,420,0,186,16929
4/13/2016,22,9356,1731,4408,546,0,160,16201
4/13/2016,23,9359,1112,4073,707,0,51,15302
4/13/2016,24,9360,931,3817,785,0,20,14913
4/14/2016,1,9359,918,3518,797,0,19,14611
4/14/2016,2,9360,922,3482,515,0,18,14297
4/14/2016,3,9190,1034,3498,598,0,18,14338
4/14/2016,4,9110,1232,3507,646,0,18,14513
4/14/2016,5,9111,1337,3597,954,1,22,15022
4/14/2016,6,9297,1380,4466,1094,2,28,16267
4/14/2016,7,9356,1521,4318,1143,22,33,16393
4/14/2016,8,9352,1520,4339,790,49,35,16085
4/14/2016,9,9352,1508,4175,522,137,37,15731
4/14/2016,10,9335,1498,4208,462,182,35,15720
4/14/2016,11,9351,1032,3999,596,190,35,15203
4/14/2016,12,9357,890,3874,640,191,35,14987
4/14/2016,13,9349,896,3782,658,187,34,14906
4/14/2016,14,9348,902,3661,590,185,34,14720
4/14/2016,15,9348,902,3601,570,184,34,14639
4/14/2016,16,9340,897,3793,569,164,34,14797
4/14/2016,17,9340,894,4239,698,107,34,15312
4/14/2016,18,9343,897,4459,719,41,36,15495
4/14/2016,19,9341,900,5091,810,4,39,16185
4/14/2016,20,9327,962,5529,1019,0,35,16872
4/14/2016,21,9325,921,5093,1361,0,35,16735
4/14/2016,22,9334,906,4307,1428,0,35,16010
4/14/2016,23,9358,905,4035,977,0,25,15300
4/14/2016,24,9253,913,3793,501,0,22,14482
4/15/2016,1,9015,921,3481,613,0,19,14049
4/15/2016,2,8813,935,3473,578,0,19,13818
4/15/2016,3,8813,936,3484,473,0,18,13724
4/15/2016,4,8815,935,3578,618,0,18,13964
4/15/2016,5,8818,936,3576,1217,0,25,14572
4/15/2016,6,9187,934,4071,1273,1,30,15496
4/15/2016,7,9372,940,4139,1356,15,34,15856
4/15/2016,8,9365,938,4601,979,76,34,15993
4/15/2016,9,9358,933,4615,714,144,40,15804
4/15/2016,10,9365,927,4447,643,183,44,15609
4/15/2016,11,9365,924,4398,476,189,54,15406
4/15/2016,12,9358,922,3919,430,189,54,14872
4/15/2016,13,9357,917,3762,384,189,56,14665
4/15/2016,14,9356,915,3847,277,187,57,14639
4/15/2016,15,9357,913,3805,289,186,45,14595
4/15/2016,16,9354,908,3841,392,161,35,14691
4/15/2016,17,9357,909,3811,626,105,35,14843
4/15/2016,18,9354,912,4315,899,41,35,15556
4/15/2016,19,9355,923,4811,1126,4,35,16254
4/15/2016,20,9346,928,4899,1683,0,35,16891
4/15/2016,21,9332,933,4800,1611,0,35,16711
4/15/2016,22,9346,908,4202,1731,0,35,16222
4/15/2016,23,9350,525,4053,1245,0,23,15196
4/15/2016,24,9344,447,3894,729,0,8,14422
4/16/2016,1,9343,446,3471,590,0,2,13852
4/16/2016,2,9153,447,3341,721,0,2,13664
4/16/2016,3,9097,444,3269,804,0,2,13616
4/16/2016,4,9089,444,3371,811,0,2,13717
4/16/2016,5,9089,444,3537,883,1,2,13956
4/16/2016,6,9225,446,3556,1152,1,2,14382
4/16/2016,7,9341,444,3567,1295,20,2,14669
4/16/2016,8,9338,446,4072,938,78,2,14874
4/16/2016,9,9330,446,4581,437,144,2,14940
4/16/2016,10,9330,444,4606,280,185,3,14848
4/16/2016,11,9330,439,4690,192,192,3,14846
4/16/2016,12,9329,436,4616,160,193,3,14737
4/16/2016,13,9326,437,4306,161,193,3,14426
4/16/2016,14,9328,437,4036,209,192,3,14205
4/16/2016,15,9286,474,3945,246,190,3,14144
4/16/2016,16,9324,524,3945,331,163,3,14290
4/16/2016,17,9320,590,4590,452,107,3,15062
4/16/2016,18,9327,646,5178,437,42,2,15632
4/16/2016,19,9327,646,5619,500,4,2,16098
4/16/2016,20,9317,651,5565,675,0,6,16214
4/16/2016,21,9312,653,5479,880,0,2,16326
4/16/2016,22,9320,650,4990,1047,0,0,16007
4/16/2016,23,9320,649,4109,1010,0,0,15088
4/16/2016,24,9324,484,3905,648,0,0,14361
4/17/2016,1,9322,451,3508,716,0,0,13997
4/17/2016,2,9320,449,3340,617,0,0,13726
4/17/2016,3,9322,442,3354,601,0,0,13719
4/17/2016,4,9317,440,3386,559,0,0,13702
4/17/2016,5,9320,440,3528,570,0,0,13858
4/17/2016,6,9321,439,3962,440,1,0,14163
4/17/2016,7,9316,439,4232,363,19,0,14369
4/17/2016,8,9316,440,4507,200,77,0,14540
4/17/2016,9,9311,441,4864,81,138,0,14835
4/17/2016,10,9311,439,5038,50,186,0,15024
4/17/2016,11,9305,442,5229,33,193,0,15202
4/17/2016,12,9306,443,5122,62,193,0,15126
4/17/2016,13,9303,442,4917,113,193,0,14968
4/17/2016,14,9308,488,4581,187,191,0,14755
4/17/2016,15,9306,581,4528,181,190,0,14786
4/17/2016,16,9303,675,4739,161,161,1,15040
4/17/2016,17,9302,638,5236,213,106,1,15496
4/17/2016,18,9299,583,5488,244,42,0,15656
4/17/2016,19,9293,709,5585,196,5,0,15788
4/17/2016,20,9293,741,5920,242,0,0,16196
4/17/2016,21,9290,791,5922,207,0,0,16210
4/17/2016,22,9292,699,5621,161,0,0,15773
4/17/2016,23,9287,485,5093,157,0,0,15022
4/17/2016,24,9298,322,4476,196,0,0,14292
4/18/2016,1,9301,336,3856,188,0,13,13694
4/18/2016,2,9305,370,3952,177,0,18,13822
4/18/2016,3,9306,431,3713,133,0,19,13602
4/18/2016,4,9303,493,3650,114,0,21,13581
4/18/2016,5,9303,592,3848,104,0,39,13886
4/18/2016,6,9301,704,4325,118,2,42,14492
4/18/2016,7,9297,900,5172,116,24,51,15560
4/18/2016,8,9298,1188,4839,133,82,57,15597
4/18/2016,9,9292,1151,4577,92,143,55,15310
4/18/2016,10,9295,1163,4544,150,182,56,15390
4/18/2016,11,9294,1204,4417,211,193,55,15374
4/18/2016,12,9296,1146,4482,305,192,57,15478
4/18/2016,13,9295,1137,4431,386,192,53,15494
4/18/2016,14,9296,1168,4347,424,191,54,15480
4/18/2016,15,9296,1148,4380,509,172,56,15561
4/18/2016,16,9295,1192,4644,757,130,57,16075
4/18/2016,17,9292,1295,4883,781,91,56,16398
4/18/2016,18,9306,1431,5147,829,30,51,16794
4/18/2016,19,9308,1461,5129,989,4,47,16938
4/18/2016,20,9297,1410,5404,953,0,35,17099
4/18/2016,21,9296,1519,5236,1046,0,34,17131
4/18/2016,22,9294,1361,4420,871,0,34,15980
4/18/2016,23,9302,1153,4098,773,0,23,15349
4/18/2016,24,9303,970,3670,390,0,20,14353
4/19/2016,1,9140,952,3505,238,0,21,13856
4/19/2016,2,8772,951,3537,446,0,21,13727
4/19/2016,3,8745,916,3482,515,0,20,13678
4/19/2016,4,8749,924,3502,629,0,21,13825
4/19/2016,5,8794,929,3456,1199,0,23,14401
4/19/2016,6,9053,924,4123,1333,1,30,15464
4/19/2016,7,9052,935,4645,1214,19,35,15900
4/19/2016,8,9242,938,4929,518,15,36,15678
4/19/2016,9,9303,938,4806,282,49,35,15413
4/19/2016,10,9310,943,4163,585,169,35,15205
4/19/2016,11,9314,954,4125,537,193,35,15158
4/19/2016,12,9313,958,4189,440,193,35,15128
4/19/2016,13,9311,968,4167,433,184,36,15099
4/19/2016,14,9305,966,4138,305,174,36,14924
4/19/2016,15,9313,964,4090,424,182,36,15009
4/19/2016,16,9307,956,4197,502,146,36,15144
4/19/2016,17,9305,963,4285,501,98,36,15188
4/19/2016,18,9306,966,4697,531,44,36,15580
4/19/2016,19,9308,875,5049,503,6,36,15777
4/19/2016,20,9299,997,5544,551,0,36,16427
4/19/2016,21,9294,1302,5244,554,0,36,16430
4/19/2016,22,9290,1289,4369,536,0,36,15520
4/19/2016,23,9296,1100,3851,565,0,24,14836
4/19/2016,24,9105,974,3718,329,0,20,14146
4/20/2016,1,8649,976,3685,324,0,20,13654
4/20/2016,2,8451,976,3653,377,0,19,13476
4/20/2016,3,8449,976,3639,316,0,19,13399
4/20/2016,4,8453,977,3671,460,0,20,13581
4/20/2016,5,8891,837,3799,1106,1,28,14662
4/20/2016,6,9068,838,3862,1355,3,33,15159
4/20/2016,7,9180,844,3885,1409,26,36,15380
4/20/2016,8,9265,844,3905,768,89,0,14871
4/20/2016,9,9302,975,4276,487,154,36,15230
4/20/2016,10,9303,979,4190,438,166,36,15112
4/20/2016,11,9302,970,4178,439,169,36,15094
4/20/2016,12,9302,979,3872,787,194,36,15170
4/20/2016,13,9149,975,3984,831,194,37,15170
4/20/2016,14,9211,986,3924,609,192,36,14958
4/20/2016,15,9301,1007,3907,658,179,36,15088
4/20/2016,16,9300,1136,4156,445,165,36,15238
4/20/2016,17,9298,1148,4382,378,97,36,15339
4/20/2016,18,9302,1148,4454,596,39,36,15575
4/20/2016,19,9302,1164,4999,1017,6,37,16525
4/20/2016,20,9293,1034,5469,1335,0,36,17167
4/20/2016,21,9282,989,4864,1766,0,37,16938
4/20/2016,22,9292,972,4042,1465,0,37,15808
4/20/2016,23,9300,967,3631,1283,0,27,15208
4/20/2016,24,9299,968,3601,562,0,24,14454
4/21/2016,1,9149,968,3643,270,0,23,14053
4/21/2016,2,8877,964,3453,641,0,22,13957
4/21/2016,3,8733,969,3514,571,0,22,13809
4/21/2016,4,8734,964,3586,647,0,23,13954
4/21/2016,5,8984,975,3805,631,0,25,14420
4/21/2016,6,9293,1149,4985,397,2,32,15858
4/21/2016,7,9299,1264,5105,363,24,35,16090
4/21/2016,8,9302,1246,5201,273,61,36,16119
4/21/2016,9,9304,1023,5399,254,110,36,16126
4/21/2016,10,9298,964,4984,400,134,35,15815
4/21/2016,11,9295,987,4578,570,131,35,15596
4/21/2016,12,9294,991,4533,642,126,35,15621
4/21/2016,13,9292,996,4554,914,125,35,15916
4/21/2016,14,9307,1012,4523,1397,100,35,16374
4/21/2016,15,9310,1014,4388,1392,77,35,16216
4/21/2016,16,9310,1036,4418,1797,43,35,16639
4/21/2016,17,9310,1215,4501,1640,37,35,16738
4/21/2016,18,9310,1232,4548,1652,8,35,16785
4/21/2016,19,9307,1212,4582,1785,1,35,16922
4/21/2016,20,9298,1223,4737,1697,0,35,16990
4/21/2016,21,9291,1222,4707,1550,0,35,16805
4/21/2016,22,9294,1055,4323,1389,0,36,16097
4/21/2016,23,9305,1009,3978,1046,0,27,15365
4/21/2016,24,9307,969,3727,579,0,22,14604
4/22/2016,1,9148,960,3615,457,0,23,14203
4/22/2016,2,9053,960,3557,249,0,24,13843
4/22/2016,3,8824,959,3626,427,0,21,13857
4/22/2016,4,8749,962,3682,538,0,21,13952
4/22/2016,5,8992,961,3772,668,1,25,14419
4/22/2016,6,9299,947,4427,469,1,28,15171
4/22/2016,7,9310,1002,5164,464,9,34,15983
4/22/2016,8,9310,1041,5346,402,33,34,16166
4/22/2016,9,9310,1210,5401,314,83,34,16352
4/22/2016,10,9307,1324,4689,385,87,34,15826
4/22/2016,11,9308,1234,4480,418,154,34,15628
4/22/2016,12,9300,1007,4563,603,142,34,15649
4/22/2016,13,9294,1041,4531,879,114,34,15893
4/22/2016,14,9303,1056,4400,776,133,35,15703
4/22/2016,15,9304,1215,4421,705,98,35,15778
4/22/2016,16,9289,1237,4160,775,31,35,15527
4/22/2016,17,9286,1221,4115,1206,18,35,15881
4/22/2016,18,9295,1211,4264,1788,12,35,16605
4/22/2016,19,9300,1202,4641,1725,3,35,16906
4/22/2016,20,9297,1207,4665,2059,0,35,17263
4/22/2016,21,9292,1057,4602,1944,0,35,16930
4/22/2016,22,9291,945,4252,1640,0,35,16163
4/22/2016,23,9299,508,4087,1722,0,26,15642
4/22/2016,24,9304,400,4074,1103,0,14,14895
4/23/2016,1,9303,399,4064,537,0,2,14305
4/23/2016,2,9294,399,3709,694,0,2,14098
4/23/2016,3,9272,400,3662,547,0,2,13883
4/23/2016,4,9265,395,3676,625,0,2,13963
4/23/2016,5,9263,398,3683,698,0,2,14044
4/23/2016,6,9272,399,3647,1040,3,2,14363
4/23/2016,7,9267,397,4016,961,23,3,14667
4/23/2016,8,9260,387,4106,1220,79,4,15056
4/23/2016,9,9259,385,4493,951,157,3,15248
4/23/2016,10,9255,384,4612,891,190,3,15335
4/23/2016,11,9266,383,4690,837,192,3,15371
4/23/2016,12,9259,383,4665,804,193,3,15307
4/23/2016,13,9257,420,4399,649,186,3,14914
4/23/2016,14,9225,430,4390,517,182,3,14747
4/23/2016,15,9287,459,4403,318,187,4,14658
4/23/2016,16,9299,509,4427,445,170,3,14853
4/23/2016,17,9301,558,4631,702,112,3,15307
4/23/2016,18,9298,588,5162,552,47,3,15650
4/23/2016,19,9284,591,5639,433,6,3,15956
4/23/2016,20,9282,593,5900,360,0,3,16138
4/23/2016,21,9276,590,5813,434,0,3,16116
4/23/2016,22,9285,588,5358,347,0,3,15581
4/23/2016,23,9289,588,4923,262,0,3,15065
4/23/2016,24,9287,433,4367,256,0,3,14346
4/24/2016,1,9293,387,3955,185,0,3,13823
4/24/2016,2,9293,387,4033,175,0,3,13891
4/24/2016,3,9289,386,3802,199,0,3,13679
4/24/2016,4,9305,387,3790,289,0,3,13774
4/24/2016,5,9328,385,4001,309,0,3,14026
4/24/2016,6,9332,385,4050,361,2,3,14133
4/24/2016,7,9333,381,4376,219,23,3,14335
4/24/2016,8,9328,387,4704,220,71,3,14713
4/24/2016,9,9322,385,5051,75,124,3,14960
4/24/2016,10,9319,434,5256,78,150,3,15240
4/24/2016,11,9320,395,4947,135,172,3,14972
4/24/2016,12,9317,393,4664,183,178,3,14738
4/24/2016,13,9316,444,4656,179,187,7,14789
4/24/2016,14,9317,531,4594,196,156,8,14802
4/24/2016,15,9316,583,5021,123,109,3,15155
4/24/2016,16,9311,584,5119,83,121,3,15221
4/24/2016,17,9312,585,5374,110,54,3,15438
4/24/2016,18,9329,604,5648,149,14,3,15747
4/24/2016,19,9331,639,5658,240,3,3,15874
4/24/2016,20,9344,622,5119,570,0,2,15657
4/24/2016,21,9344,585,5125,618,0,2,15674
4/24/2016,22,9342,435,5035,714,0,2,15528
4/24/2016,23,9341,385,4352,771,0,7,14856
4/24/2016,24,9344,386,4078,615,0,14,14437
4/25/2016,1,9338,386,3669,686,0,16,14095
4/25/2016,2,9339,388,3677,523,0,16,13943
4/25/2016,3,9351,396,3622,690,0,16,14075
4/25/2016,4,9348,439,3617,682,0,18,14104
4/25/2016,5,9355,504,3893,1071,0,23,14846
4/25/2016,6,9507,633,4142,1480,1,29,15792
4/25/2016,7,9336,815,4521,1809,9,41,16531
4/25/2016,8,9330,849,4924,1883,24,51,17061
4/25/2016,9,9331,829,5208,1998,60,51,17477
4/25/2016,10,9330,932,5254,1638,84,48,17286
4/25/2016,11,9329,929,4724,1595,155,53,16785
4/25/2016,12,9324,862,4361,1778,166,48,16539
4/25/2016,13,9320,863,4276,1825,171,47,16502
4/25/2016,14,9318,828,4350,1727,152,37,16412
4/25/2016,15,9326,848,4407,1889,96,51,16617
4/25/2016,16,9380,853,4774,1750,64,79,16900
4/25/2016,17,9578,837,5362,1543,25,87,17432
4/25/2016,18,9580,835,5152,1673,14,87,17341
4/25/2016,19,9603,854,5158,1959,4,86,17664
4/25/2016,20,9639,835,5055,2031,0,86,17646
4/25/2016,21,9680,845,4884,1982,0,43,17434
4/25/2016,22,9672,850,4412,1791,0,34,16759
4/25/2016,23,9866,852,4099,1317,0,33,16167
4/25/2016,24,9941,893,3877,440,0,27,15178
4/26/2016,1,9942,904,3761,416,0,18,15041
4/26/2016,2,9670,905,3603,302,0,18,14498
4/26/2016,3,9152,930,3606,629,0,19,14336
4/26/2016,4,9067,939,3762,782,0,21,14571
4/26/2016,5,9064,980,4070,805,0,30,14949
4/26/2016,6,9326,890,5059,890,0,52,16217
4/26/2016,7,9905,944,5248,935,2,94,17128
4/26/2016,8,9926,1208,5105,1167,9,177,17592
4/26/2016,9,9921,1313,4738,1237,33,217,17459
4/26/2016,10,9917,1318,4786,885,51,219,17176
4/26/2016,11,9915,1393,4730,887,113,219,17257
4/26/2016,12,9886,1381,4915,760,122,218,17282
4/26/2016,13,9864,1550,4804,640,122,216,17196
4/26/2016,14,9857,1626,4551,458,78,217,16787
4/26/2016,15,9870,1601,4573,280,123,217,16664
4/26/2016,16,9867,1603,4644,434,122,222,16892
4/26/2016,17,9865,1600,4951,686,81,226,17409
4/26/2016,18,9870,1606,5009,246,31,218,16980
4/26/2016,19,9870,1608,5035,539,5,217,17274
4/26/2016,20,9868,1602,5223,517,0,177,17387
4/26/2016,21,9867,1601,5624,541,0,90,17723
4/26/2016,22,9863,1118,4900,471,0,49,16401
4/26/2016,23,9871,908,4542,375,0,31,15727
4/26/2016,24,9883,909,4182,229,0,24,15227
4/27/2016,1,9619,907,3784,423,0,19,14752
4/27/2016,2,9501,907,3652,580,0,18,14658
4/27/2016,3,9528,906,3574,560,0,18,14586
4/27/2016,4,9558,906,3615,596,0,22,14697
4/27/2016,5,9576,909,4072,577,0,29,15163
4/27/2016,6,10062,909,4523,707,3,54,16258
4/27/2016,7,10105,929,4746,799,33,103,16715
4/27/2016,8,10100,937,5108,441,96,182,16864
4/27/2016,9,10069,939,4867,269,159,216,16519
4/27/2016,10,10071,938,4632,251,189,218,16299
4/27/2016,11,10069,938,4626,174,158,218,16183
4/27/2016,12,10069,928,4492,118,77,218,15902
4/27/2016,13,10067,923,4161,251,153,218,15773
4/27/2016,14,9894,927,4131,275,67,218,15512
4/27/2016,15,9838,993,3932,716,189,218,15886
4/27/2016,16,10039,1091,3892,654,166,218,16060
4/27/2016,17,10087,1130,4404,769,109,219,16718
4/27/2016,18,10089,1107,4823,801,46,221,17087
4/27/2016,19,10089,1109,5082,528,5,227,17040
4/27/2016,20,10088,1105,5312,765,0,167,17437
4/27/2016,21,10081,1100,5336,891,0,57,17465
4/27/2016,22,10086,1100,4802,950,0,38,16976
4/27/2016,23,10105,926,4341,894,0,29,16295
4/27/2016,24,10127,866,3805,522,0,20,15340
4/28/2016,1,9864,883,3656,403,0,19,14825
4/28/2016,2,9571,882,3741,374,0,19,14587
4/28/2016,3,9573,890,3735,383,0,20,14601
4/28/2016,4,9583,887,3681,535,0,23,14709
4/28/2016,5,9586,888,3752,888,0,26,15140
4/28/2016,6,9885,837,4178,1269,3,60,16232
4/28/2016,7,10137,851,4513,1105,29,91,16726
4/28/2016,8,10135,869,4732,1042,72,135,16985
4/28/2016,9,10136,883,4395,876,124,214,16628
4/28/2016,10,10140,885,4366,530,127,220,16268
4/28/2016,11,10142,872,4302,917,128,220,16581
4/28/2016,12,10137,872,4234,811,175,222,16451
4/28/2016,13,10134,866,4240,663,138,222,16263
4/28/2016,14,10135,863,4222,684,113,213,16230
4/28/2016,15,10137,862,4204,595,110,210,16118
4/28/2016,16,10139,867,4356,591,84,208,16245
4/28/2016,17,10137,865,4397,703,52,206,16360
4/28/2016,18,10135,867,4694,624,27,193,16540
4/28/2016,19,10136,860,4870,743,7,149,16765
4/28/2016,20,10137,869,5018,864,0,46,16934
4/28/2016,21,10138,870,5235,792,0,23,17058
4/28/2016,22,10134,867,4661,683,0,19,16364
4/28/2016,23,10137,856,4324,423,0,24,15764
4/28/2016,24,9920,846,3884,348,0,3,15001
4/29/2016,1,9589,847,3549,451,0,0,14436
4/29/2016,2,9557,849,3454,266,0,0,14126
4/29/2016,3,9302,849,3460,357,0,0,13968
4/29/2016,4,9295,850,3496,473,0,0,14114
4/29/2016,5,9295,853,3773,733,0,0,14654
4/29/2016,6,9448,868,4671,768,4,0,15759
4/29/2016,7,9767,871,4762,756,33,0,16189
4/29/2016,8,9916,862,4491,566,92,0,15927
4/29/2016,9,9916,855,4509,443,149,0,15872
4/29/2016,10,10024,852,4436,313,161,0,15786
4/29/2016,11,10159,851,4338,446,143,0,15937
4/29/2016,12,10157,854,4178,418,161,0,15768
4/29/2016,13,10165,883,4181,552,158,0,15939
4/29/2016,14,10177,916,4152,409,79,0,15733
4/29/2016,15,10180,916,4078,474,66,0,15714
4/29/2016,16,10175,900,4111,226,82,0,15494
4/29/2016,17,10170,898,4437,302,46,2,15855
4/29/2016,18,10163,897,4663,259,36,1,16019
4/29/2016,19,10161,894,4890,308,7,0,16260
4/29/2016,20,10156,881,5239,251,0,0,16527
4/29/2016,21,10138,892,5754,257,0,0,17041
4/29/2016,22,10121,857,5534,158,0,0,16670
4/29/2016,23,10151,496,4955,122,0,0,15724
4/29/2016,24,10069,389,4146,194,0,0,14798
4/30/2016,1,9920,388,3748,258,0,0,14314
4/30/2016,2,9721,389,3678,330,0,0,14118
4/30/2016,3,9603,389,3659,252,0,0,13903
4/30/2016,4,9601,387,4062,248,0,0,14298
4/30/2016,5,9599,385,3883,290,0,7,14164
4/30/2016,6,9595,387,3886,557,3,7,14435
4/30/2016,7,9680,387,3847,662,31,12,14619
4/30/2016,8,9898,396,4071,416,79,14,14874
4/30/2016,9,9902,390,4158,283,148,14,14895
4/30/2016,10,9915,386,4203,161,164,15,14844
4/30/2016,11,9795,384,4303,168,122,16,14788
4/30/2016,12,9615,382,4187,231,191,14,14620
4/30/2016,13,9614,389,4090,154,134,8,14389
4/30/2016,14,9602,407,4135,117,45,0,14306
4/30/2016,15,9600,396,4110,178,63,0,14347
4/30/2016,16,9592,379,4137,448,79,1,14636
4/30/2016,17,9751,381,4185,781,79,1,15178
4/30/2016,18,9898,381,4369,874,29,0,15551
4/30/2016,19,9974,380,4579,833,5,0,15771
4/30/2016,20,10151,376,4602,1173,0,0,16302
4/30/2016,21,10145,365,4706,850,0,0,16066
4/30/2016,22,10145,365,4067,715,0,0,15292
4/30/2016,23,9993,366,3674,529,0,0,14562
4/30/2016,24,9408,370,3544,332,0,0,13654
5/1/2016,1,8573,370,3625,363,0,0,12931
5/1/2016,2,8307,369,3644,501,0,0,12821
5/1/2016,3,7787,370,3578,888,0,0,12623
5/1/2016,4,7783,370,3651,830,0,0,12634
5/1/2016,5,7783,370,3562,1065,0,0,12780
5/1/2016,6,7783,366,3764,963,1,0,12877
5/1/2016,7,7868,368,3868,1202,3,0,13309
5/1/2016,8,8330,368,4144,1174,19,0,14035
5/1/2016,9,9027,369,4346,1035,18,0,14795
5/1/2016,10,9335,371,4631,871,30,0,15238
5/1/2016,11,9328,370,4764,806,40,0,15308
5/1/2016,12,9331,375,4837,784,54,0,15381
5/1/2016,13,9337,373,4613,734,69,0,15126
5/1/2016,14,9330,399,4564,718,52,0,15063
5/1/2016,15,9325,409,4741,708,49,0,15232
5/1/2016,16,9323,430,5303,708,27,0,15791
5/1/2016,17,9320,468,5226,783,24,0,15821
5/1/2016,18,9319,539,5269,845,11,0,15983
5/1/2016,19,9322,582,5116,815,3,0,15838
5/1/2016,20,9333,584,4975,708,0,0,15600
5/1/2016,21,8882,584,4909,514,0,0,14889
5/1/2016,22,8565,585,4747,616,0,3,14516
5/1/2016,23,8569,583,4380,634,0,3,14169
5/1/2016,24,8576,574,4010,544,0,1,13705
5/2/2016,1,8580,357,3707,523,0,0,13167
5/2/2016,2,8577,317,3644,533,0,0,13071
5/2/2016,3,8579,334,3690,419,0,0,13022
5/2/2016,4,8581,401,3682,597,0,0,13261
5/2/2016,5,8579,488,4295,572,0,3,13937
5/2/2016,6,8581,862,4876,404,0,10,14733
5/2/2016,7,8580,1133,5433,524,7,38,15715
5/2/2016,8,8580,1365,5534,625,16,41,16161
5/2/2016,9,8579,1397,5358,545,21,45,15945
5/2/2016,10,8575,1516,5173,498,32,53,15847
5/2/2016,11,8571,1511,5190,464,40,56,15832
5/2/2016,12,8580,1479,4994,425,55,25,15558
5/2/2016,13,8576,1628,4907,382,93,9,15595
5/2/2016,14,8578,1358,4932,443,95,15,15421
5/2/2016,15,8583,1452,4967,533,72,30,15637
5/2/2016,16,8588,1563,5001,447,52,31,15682
5/2/2016,17,8580,1735,4865,374,38,33,15625
5/2/2016,18,8572,1862,4837,171,29,34,15505
5/2/2016,19,8580,1864,5089,183,6,37,15759
5/2/2016,20,8579,1867,5384,266,0,31,16127
5/2/2016,21,8571,1880,5802,266,0,33,16552
5/2/2016,22,8580,1726,5167,248,0,31,15752
5/2/2016,23,8576,1373,4781,232,0,22,14984
5/2/2016,24,8575,990,4362,158,0,17,14102
5/3/2016,1,8583,912,3974,122,0,15,13606
5/3/2016,2,8584,912,3690,136,0,16,13338
5/3/2016,3,8585,946,3604,109,0,15,13259
5/3/2016,4,8587,940,3655,170,0,16,13368
5/3/2016,5,8588,1009,4115,198,0,24,13934
5/3/2016,6,8590,1370,4610,208,3,43,14824
5/3/2016,7,8591,1912,4951,90,12,83,15639
5/3/2016,8,8590,1909,4644,149,83,183,15558
5/3/2016,9,8586,1940,4371,89,15,210,15211
5/3/2016,10,8588,1860,4306,103,34,212,15103
5/3/2016,11,8589,1840,3956,161,138,213,14897
5/3/2016,12,8590,1809,3956,221,122,213,14911
5/3/2016,13,8587,1796,4148,227,154,213,15125
5/3/2016,14,8586,1800,4127,238,144,209,15104
5/3/2016,15,8583,1795,3959,211,72,207,14827
5/3/2016,16,8587,1628,3983,347,132,207,14884
5/3/2016,17,8590,1402,4118,420,92,207,14829
5/3/2016,18,8588,1274,4962,457,40,207,15528
5/3/2016,19,8587,1278,5115,771,10,206,15967
5/3/2016,20,8586,1279,5393,913,0,153,16324
5/3/2016,21,8579,1112,5277,1269,0,48,16285
5/3/2016,22,8578,936,4567,1376,0,30,15487
5/3/2016,23,8611,903,3980,1147,0,20,14661
5/3/2016,24,8788,895,3584,510,0,15,13792
5/4/2016,1,8609,915,3533,334,0,14,13405
5/4/2016,2,8195,946,3493,503,0,14,13151
5/4/2016,3,8180,958,3574,341,0,14,13067
5/4/2016,4,8173,960,3627,478,0,16,13254
5/4/2016,5,8248,962,3555,940,0,22,13727
5/4/2016,6,8687,965,3828,915,3,24,14422
5/4/2016,7,8785,986,4276,881,21,27,14976
5/4/2016,8,8792,1034,4733,789,63,29,15440
5/4/2016,9,8891,1168,4530,655,88,29,15361
5/4/2016,10,9035,1134,4214,663,113,31,15190
5/4/2016,11,9043,1122,4120,573,118,47,15023
5/4/2016,12,9136,1121,4173,797,126,82,15435
5/4/2016,13,9153,1120,4170,852,165,160,15620
5/4/2016,14,9242,1128,3801,855,171,209,15406
5/4/2016,15,9264,1128,3819,911,128,206,15456
5/4/2016,16,9261,1124,3861,807,112,209,15374
5/4/2016,17,9263,1162,4038,755,80,216,15514
5/4/2016,18,9258,1317,4586,546,46,217,15970
5/4/2016,19,9261,1321,4666,511,16,217,15992
5/4/2016,20,9260,1317,5100,668,0,217,16562
5/4/2016,21,9266,1319,5273,553,0,160,16571
5/4/2016,22,9316,1317,4594,496,0,43,15766
5/4/2016,23,8790,1298,4044,651,0,26,14809
5/4/2016,24,8495,954,3628,848,0,22,13947
5/5/2016,1,8507,904,3530,453,0,22,13416
5/5/2016,2,8560,874,3377,267,0,22,13100
5/5/2016,3,8334,881,3327,416,0,23,12981
5/5/2016,4,8318,894,3335,542,0,22,13111
5/5/2016,5,8315,902,3474,906,0,28,13625
5/5/2016,6,8531,903,3785,1253,3,52,14527
5/5/2016,7,8610,919,4425,1093,30,99,15176
5/5/2016,8,8620,914,4765,874,58,190,15421
5/5/2016,9,8622,981,4616,764,128,216,15327
5/5/2016,10,8647,1101,4471,640,181,216,15256
5/5/2016,11,8571,1097,4258,907,182,216,15231
5/5/2016,12,7854,1092,4275,1452,185,216,15074
5/5/2016,13,7852,1094,4322,1209,189,214,14880
5/5/2016,14,7854,1091,4204,1294,190,215,14848
5/5/2016,15,7870,1114,4232,1235,195,216,14862
5/5/2016,16,7894,957,4445,1282,188,216,14982
5/5/2016,17,7898,980,4409,1586,137,216,15226
5/5/2016,18,7901,1046,4657,1618,62,216,15500
5/5/2016,19,7906,1110,4856,1760,8,204,15844
5/5/2016,20,7909,1115,5248,1609,0,219,16100
5/5/2016,21,7906,1123,5430,1486,0,186,16131
5/5/2016,22,7909,1119,4736,1377,0,93,15234
5/5/2016,23,7912,1120,4091,1405,0,34,14562
5/5/2016,24,7914,1114,3695,1040,0,21,13784
5/6/2016,1,7911,952,3250,1040,0,21,13174
5/6/2016,2,7915,908,3172,960,0,22,12977
5/6/2016,3,7917,910,3152,891,0,23,12893
5/6/2016,4,7914,911,3180,918,0,22,12945
5/6/2016,5,7914,911,3311,1128,0,27,13291
5/6/2016,6,7920,913,3891,986,4,30,13744
5/6/2016,7,7922,920,4811,906,37,40,14636
5/6/2016,8,7930,913,5172,577,99,60,14751
5/6/2016,9,7929,909,5350,465,181,97,14931
5/6/2016,10,7929,901,4908,658,223,183,14802
5/6/2016,11,7931,902,4587,786,226,218,14650
5/6/2016,12,7933,912,4427,951,220,219,14662
5/6/2016,13,7933,1064,4234,1108,216,196,14751
5/6/2016,14,7929,1244,4043,1200,210,182,14808
5/6/2016,15,7926,1369,4097,1041,207,162,14802
5/6/2016,16,7921,1392,4252,991,139,187,14882
5/6/2016,17,7920,1519,4471,870,91,184,15055
5/6/2016,18,7924,1525,5042,607,50,211,15359
5/6/2016,19,7928,1572,5573,444,15,217,15749
5/6/2016,20,7923,1583,5553,440,1,204,15704
5/6/2016,21,7921,1580,5457,522,0,127,15607
5/6/2016,22,7932,1220,5108,456,0,48,14764
5/6/2016,23,7930,610,4871,343,0,37,13791
5/6/2016,24,7928,486,4681,218,0,20,13333
5/7/2016,1,7936,482,4296,273,0,5,12992
5/7/2016,2,7933,483,3766,473,0,5,12660
5/7/2016,3,7932,485,3356,572,0,5,12350
5/7/2016,4,7933,486,3304,644,0,6,12373
5/7/2016,5,7932,488,3388,655,0,6,12469
5/7/2016,6,7934,487,3327,910,4,6,12668
5/7/2016,7,7935,487,3761,1126,20,6,13335
5/7/2016,8,7934,487,4372,1106,83,6,13988
5/7/2016,9,7933,487,4601,994,159,6,14180
5/7/2016,10,7935,488,4633,1117,194,6,14373
5/7/2016,11,7928,486,4648,1280,206,6,14554
5/7/2016,12,7929,492,5037,916,173,6,14553
5/7/2016,13,7928,648,5325,732,153,6,14792
5/7/2016,14,7929,576,4670,628,154,6,13963
5/7/2016,15,7929,567,4869,514,151,6,14036
5/7/2016,16,7932,512,4828,1017,82,6,14377
5/7/2016,17,7928,489,4392,1545,60,6,14420
5/7/2016,18,7933,483,4443,1626,23,6,14514
5/7/2016,19,7932,482,4680,1668,6,5,14773
5/7/2016,20,7930,489,4816,2047,0,5,15287
5/7/2016,21,7925,514,4625,1863,0,5,14932
5/7/2016,22,7924,581,4206,1574,0,5,14290
5/7/2016,23,7926,605,3724,1296,0,5,13556
5/7/2016,24,7928,607,3457,966,0,5,12963
5/8/2016,1,7932,607,3317,774,0,5,12635
5/8/2016,2,7930,611,3413,439,0,5,12398
5/8/2016,3,7934,614,3333,419,0,5,12305
5/8/2016,4,7928,613,3347,400,0,5,12293
5/8/2016,5,7929,615,3414,425,1,5,12389
5/8/2016,6,7931,614,3397,513,6,16,12477
5/8/2016,7,7938,613,4030,360,39,16,12996
5/8/2016,8,7940,614,4657,239,106,21,13577
5/8/2016,9,7934,609,4341,338,150,27,13399
5/8/2016,10,7933,607,4300,339,201,28,13408
5/8/2016,11,7932,605,4088,506,208,24,13363
5/8/2016,12,7929,602,3692,809,194,22,13248
5/8/2016,13,7932,603,3621,1014,174,15,13359
5/8/2016,14,7889,602,3593,896,137,14,13131
5/8/2016,15,7928,631,3575,855,145,6,13140
5/8/2016,16,7930,636,3950,869,89,3,13477
5/8/2016,17,7934,727,4097,784,65,3,13610
5/8/2016,18,7934,799,4710,354,17,3,13817
5/8/2016,19,7936,820,4605,921,6,3,14291
5/8/2016,20,7927,849,5342,825,0,2,14945
5/8/2016,21,7924,878,5558,634,0,1,14995
5/8/2016,22,7931,870,5277,543,0,2,14623
5/8/2016,23,7931,770,4622,548,0,10,13881
5/8/2016,24,7931,649,4128,578,0,5,13291
5/9/2016,1,7937,654,3781,470,0,23,12865
5/9/2016,2,7940,710,3800,455,0,17,12922
5/9/2016,3,7932,728,3828,430,0,17,12935
5/9/2016,4,7914,804,4025,465,0,17,13225
5/9/2016,5,7922,980,4272,478,0,17,13669
5/9/2016,6,7933,1186,4706,220,6,31,14082
5/9/2016,7,7942,1241,5248,161,39,61,14692
5/9/2016,8,7940,1250,5195,158,106,102,14751
5/9/2016,9,7932,1247,4944,142,163,185,14613
5/9/2016,10,7932,1265,4575,159,208,223,14362
5/9/2016,11,7933,1293,4522,251,206,209,14414
5/9/2016,12,7934,964,4406,275,213,184,13976
5/9/2016,13,7932,894,4769,353,216,202,14366
5/9/2016,14,7932,1119,4665,457,205,203,14581
5/9/2016,15,7931,1438,4307,493,186,203,14558
5/9/2016,16,7931,1681,4274,462,169,175,14692
5/9/2016,17,7932,1683,4502,464,128,190,14899
5/9/2016,18,7938,1658,4943,393,60,205,15197
5/9/2016,19,7940,1672,5411,303,15,209,15550
5/9/2016,20,7940,1704,5568,227,0,216,15655
5/9/2016,21,7933,1709,5569,274,0,216,15701
5/9/2016,22,7937,1191,5223,385,0,187,14923
5/9/2016,23,7937,938,4856,534,0,84,14349
5/9/2016,24,7935,896,4305,762,0,29,13927
5/10/2016,1,7935,893,3828,783,0,22,13461
5/10/2016,2,7932,896,3559,815,0,23,13225
5/10/2016,3,7936,896,3528,669,0,23,13052
5/10/2016,4,7936,897,3541,840,0,24,13238
5/10/2016,5,7940,895,3525,1332,0,27,13719
5/10/2016,6,7939,900,3994,1326,10,32,14201
5/10/2016,7,7937,970,4460,1767,49,35,15218
5/10/2016,8,7938,1093,4582,1543,110,36,15302
5/10/2016,9,7939,1087,4491,1417,163,40,15137
5/10/2016,10,7934,1079,4209,1158,194,37,14611
5/10/2016,11,7934,1079,4203,1145,198,37,14596
5/10/2016,12,7932,1070,4233,1266,214,37,14752
5/10/2016,13,7925,1068,3872,1343,210,37,14455
5/10/2016,14,7926,1078,3883,1205,215,37,14344
5/10/2016,15,7925,1074,4096,1081,211,57,14444
5/10/2016,16,7918,1067,4106,1351,192,92,14726
5/10/2016,17,7920,1071,4229,1411,136,165,14932
5/10/2016,18,7922,1071,4579,1340,64,191,15167
5/10/2016,19,7925,1071,4757,1348,14,216,15331
5/10/2016,20,7920,1077,5047,1416,0,219,15679
5/10/2016,21,7907,1084,5060,1687,0,196,15934
5/10/2016,22,7893,924,4452,1813,0,103,15185
5/10/2016,23,7896,896,4023,1634,0,35,14484
5/10/2016,24,7914,886,3574,1187,0,27,13588
5/11/2016,1,7922,886,3311,999,0,24,13142
5/11/2016,2,7924,889,3297,839,0,21,12970
5/11/2016,3,7924,889,3287,742,0,24,12866
5/11/2016,4,7925,890,3300,784,0,26,12925
5/11/2016,5,7922,889,3290,1420,0,35,13556
5/11/2016,6,7930,892,3659,1661,9,35,14186
5/11/2016,7,7928,905,4174,1897,45,37,14986
5/11/2016,8,7928,901,4399,1723,94,37,15082
5/11/2016,9,7927,900,4371,1528,161,37,14924
5/11/2016,10,7927,943,4260,1449,212,37,14828
5/11/2016,11,7922,1076,4170,1362,201,37,14768
5/11/2016,12,7925,1061,4158,1301,198,38,14681
5/11/2016,13,7916,1073,4109,1154,222,37,14511
5/11/2016,14,7907,1063,4412,816,203,36,14437
5/11/2016,15,7909,1078,4844,588,189,36,14644
5/11/2016,16,7910,1103,4983,566,176,37,14775
5/11/2016,17,7907,1091,5123,534,136,36,14827
5/11/2016,18,7909,1082,4891,538,64,37,14521
5/11/2016,19,7909,900,5266,741,13,36,14865
5/11/2016,20,7908,877,5433,911,0,36,15165
5/11/2016,21,7896,898,5465,1090,0,37,15386
5/11/2016,22,7892,897,4845,1284,0,37,14955
5/11/2016,23,7898,896,3992,1241,0,28,14055
5/11/2016,24,7896,888,3480,1229,0,19,13512
5/12/2016,1,7912,887,3472,755,0,17,13043
5/12/2016,2,7915,889,3300,723,0,16,12843
5/12/2016,3,7915,892,3344,654,0,17,12822
5/12/2016,4,7918,892,3375,670,0,18,12873
5/12/2016,5,7923,895,3391,1085,0,41,13335
5/12/2016,6,7922,892,3774,971,10,60,13629
5/12/2016,7,7920,911,4613,1017,41,62,14564
5/12/2016,8,7918,937,5382,628,100,64,15029
5/12/2016,9,7909,1002,5408,535,168,63,15085
5/12/2016,10,7913,1031,5201,659,198,61,15063
5/12/2016,11,7916,1078,4910,831,219,60,15014
5/12/2016,12,7910,1095,4894,815,223,59,14996
5/12/2016,13,7913,1173,5009,819,212,53,15179
5/12/2016,14,7911,1387,5007,779,177,47,15308
5/12/2016,15,7909,1709,4714,883,137,58,15410
5/12/2016,16,7913,1918,4705,844,137,54,15571
5/12/2016,17,7911,1922,5330,665,82,51,15961
5/12/2016,18,7911,1942,5438,680,38,50,16059
5/12/2016,19,7912,1962,5590,702,12,46,16224
5/12/2016,20,7905,1953,5571,978,0,43,16450
5/12/2016,21,7907,1958,5294,1008,0,46,16213
5/12/2016,22,7909,1470,4816,761,0,38,14994
5/12/2016,23,7916,1189,4512,606,0,26,14249
5/12/2016,24,7913,989,4038,682,0,22,13644
5/13/2016,1,7911,890,3826,812,0,17,13456
5/13/2016,2,7772,892,3767,235,0,16,12682
5/13/2016,3,7496,892,3758,276,0,17,12439
5/13/2016,4,7385,893,3508,687,0,19,12492
5/13/2016,5,7388,892,3280,1701,1,27,13289
5/13/2016,6,7696,886,3412,1459,2,32,13487
5/13/2016,7,7923,873,4087,1331,6,37,14257
5/13/2016,8,7916,973,4361,1185,39,54,14528
5/13/2016,9,7919,1072,4276,1371,58,85,14781
5/13/2016,10,7919,1103,4433,1493,101,111,15160
5/13/2016,11,7914,1040,4244,1518,137,141,14994
5/13/2016,12,7909,1039,4019,1527,149,178,14821
5/13/2016,13,7907,1034,4040,1598,158,107,14844
5/13/2016,14,7909,1031,4068,1582,119,98,14807
5/13/2016,15,7907,869,4047,1399,182,127,14531
5/13/2016,16,7908,850,4225,1302,110,114,14509
5/13/2016,17,7915,875,4370,1722,81,148,15111
5/13/2016,18,7918,854,4595,1468,50,108,14993
5/13/2016,19,7920,898,4534,1758,10,184,15304
5/13/2016,20,7919,912,4888,1307,0,181,15207
5/13/2016,21,7915,920,4925,1346,0,205,15311
5/13/2016,22,7921,906,4630,1248,0,183,14888
5/13/2016,23,7928,616,4285,970,0,75,13874
5/13/2016,24,7935,560,3936,510,0,17,12958
5/14/2016,1,7937,548,3968,282,0,3,12738
5/14/2016,2,7911,522,3576,172,0,4,12185
5/14/2016,3,7936,504,3585,210,0,4,12239
5/14/2016,4,7941,528,3423,421,0,5,12318
5/14/2016,5,7935,565,3208,748,1,4,12461
5/14/2016,6,7940,560,3211,785,2,5,12503
5/14/2016,7,7945,528,3598,914,14,3,13002
5/14/2016,8,7946,527,4041,1394,47,3,13958
5/14/2016,9,7944,528,4037,2228,60,3,14800
5/14/2016,10,7940,528,3988,2831,79,3,15369
5/14/2016,11,7941,530,3742,3191,122,3,15529
5/14/2016,12,7939,550,3694,2902,129,4,15218
5/14/2016,13,7936,551,3606,2853,98,4,15048
5/14/2016,14,7929,552,3724,2681,98,4,14988
5/14/2016,15,7883,565,3952,2161,111,4,14676
5/14/2016,16,7440,630,4215,1941,157,3,14386
5/14/2016,17,7109,702,4178,2568,94,3,14654
5/14/2016,18,7112,680,4603,2111,39,4,14549
5/14/2016,19,7113,689,4558,2313,12,3,14688
5/14/2016,20,7111,693,4701,2226,1,3,14735
5/14/2016,21,7115,696,4741,2125,0,3,14680
5/14/2016,22,7116,699,4212,2051,0,3,14081
5/14/2016,23,7120,701,3680,1982,0,3,13486
5/14/2016,24,7118,698,3278,1380,0,3,12477
5/15/2016,1,7115,697,3211,1078,0,3,12104
5/15/2016,2,7114,698,3155,858,0,4,11829
5/15/2016,3,7109,698,3169,794,0,3,11773
5/15/2016,4,7124,698,3187,718,0,3,11730
5/15/2016,5,7125,700,3203,950,2,3,11983
5/15/2016,6,7130,699,3270,959,5,3,12066
5/15/2016,7,7124,699,3363,1302,14,3,12505
5/15/2016,8,7126,696,3823,1355,37,3,13040
5/15/2016,9,7129,680,3913,1870,78,3,13673
5/15/2016,10,7132,670,4100,1821,115,3,13841
5/15/2016,11,7131,670,3946,2180,124,3,14054
5/15/2016,12,7126,678,3650,2492,118,4,14068
5/15/2016,13,7113,694,3779,2236,108,4,13934
5/15/2016,14,7121,694,3806,2128,146,3,13898
5/15/2016,15,7128,691,3811,2228,119,3,13980
5/15/2016,16,7126,691,4174,2188,85,3,14267
5/15/2016,17,7125,693,4906,1981,62,3,14770
5/15/2016,18,7123,728,5041,1787,39,4,14722
5/15/2016,19,7127,788,5310,1690,11,4,14930
5/15/2016,20,7122,816,5711,1165,1,4,14819
5/15/2016,21,7116,930,5922,919,0,4,14891
5/15/2016,22,7119,1103,5183,888,0,3,14296
5/15/2016,23,7125,959,4134,921,0,3,13142
5/15/2016,24,7124,784,3672,1380,0,4,12964
5/16/2016,1,7117,732,3184,1933,0,10,12976
5/16/2016,2,7121,751,3194,1765,0,12,12843
5/16/2016,3,7120,756,3268,1466,0,19,12629
5/16/2016,4,7116,785,3298,1529,0,20,12748
5/16/2016,5,7116,822,3899,1660,0,24,13521
5/16/2016,6,7129,914,4739,1377,7,32,14198
5/16/2016,7,7131,946,5435,1276,43,35,14866
5/16/2016,8,7126,997,5636,977,111,52,14899
5/16/2016,9,7126,936,5439,952,186,82,14721
5/16/2016,10,7121,871,4775,1134,221,109,14231
5/16/2016,11,7124,952,4617,1293,228,101,14315
5/16/2016,12,7121,1004,4696,1552,229,88,14690
5/16/2016,13,7126,1064,4696,1565,228,86,14765
5/16/2016,14,7131,1159,4686,1821,193,85,15075
5/16/2016,15,7140,1381,4604,2213,175,95,15608
5/16/2016,16,7288,1637,4545,2040,139,129,15778
5/16/2016,17,7326,1652,4562,2028,99,139,15806
5/16/2016,18,7332,1678,4731,1792,50,137,15720
5/16/2016,19,7339,1684,5083,1091,16,90,15303
5/16/2016,20,7336,1695,5190,1408,1,146,15776
5/16/2016,21,7365,1704,5035,772,0,121,14997
5/16/2016,22,7520,1715,4673,535,0,92,14535
5/16/2016,23,7677,1026,4503,739,0,47,13992
5/16/2016,24,7759,876,4228,399,0,22,13284
5/17/2016,1,7813,887,4097,325,0,19,13141
5/17/2016,2,7824,887,3955,271,0,19,12956
5/17/2016,3,7825,889,4054,240,0,19,13027
5/17/2016,4,7829,905,4084,201,0,25,13044
5/17/2016,5,7827,1000,4152,265,2,25,13271
5/17/2016,6,7835,1215,4503,230,5,28,13816
5/17/2016,7,7835,1282,5225,128,28,46,14544
5/17/2016,8,7769,1333,5267,87,66,69,14591
5/17/2016,9,7762,1329,5318,93,116,86,14704
5/17/2016,10,7761,1334,5265,87,164,88,14699
5/17/2016,11,7825,1348,5093,107,196,89,14658
5/17/2016,12,7856,1429,4903,208,187,87,14670
5/17/2016,13,7916,1411,5111,365,172,87,15062
5/17/2016,14,7914,1559,5071,463,165,121,15293
5/17/2016,15,7917,1543,4854,578,165,178,15235
5/17/2016,16,7928,1518,4951,673,123,209,15402
5/17/2016,17,7923,1610,4785,718,87,210,15333
5/17/2016,18,7925,1685,4943,776,65,211,15605
5/17/2016,19,7932,1713,5233,676,17,210,15781
5/17/2016,20,7928,1729,5561,678,1,218,16115
5/17/2016,21,7926,1764,5644,749,0,218,16301
5/17/2016,22,7923,1418,5372,775,0,205,15693
5/17/2016,23,7924,1327,4894,833,0,128,15106
5/17/2016,24,7926,934,4103,905,0,33,13901
5/18/2016,1,7926,895,3719,918,0,19,13477
5/18/2016,2,7940,898,3398,884,0,19,13139
5/18/2016,3,7938,899,3277,993,0,21,13128
5/18/2016,4,7940,898,3479,900,0,22,13239
5/18/2016,5,7942,894,3963,744,2,25,13570
5/18/2016,6,7940,896,4461,610,11,43,13961
5/18/2016,7,7939,930,5089,515,44,63,14580
5/18/2016,8,7936,987,5114,253,112,85,14487
5/18/2016,9,7936,991,5073,142,159,134,14435
5/18/2016,10,7933,1015,5003,90,212,140,14393
5/18/2016,11,7930,1170,5095,117,216,138,14666
5/18/2016,12,7924,1144,5016,200,216,170,14670
5/18/2016,13,7922,1248,5045,319,221,182,14937
5/18/2016,14,7926,1437,5033,411,208,207,15222
5/18/2016,15,7923,1824,5005,468,184,193,15597
5/18/2016,16,7923,1905,4945,511,175,211,15670
5/18/2016,17,7925,2069,5067,459,131,215,15866
5/18/2016,18,7925,2068,5153,401,67,214,15828
5/18/2016,19,7926,2071,5411,285,14,195,15902
5/18/2016,20,7921,2075,5599,228,0,106,15929
5/18/2016,21,7922,2132,5689,227,0,44,16014
5/18/2016,22,7909,1443,5464,175,0,34,15025
5/18/2016,23,7911,1058,5204,133,0,25,14331
5/18/2016,24,7919,935,4414,115,0,20,13403
5/19/2016,1,7925,940,4091,112,0,17,13085
5/19/2016,2,7927,968,4223,96,0,18,13232
5/19/2016,3,7915,1069,3968,65,0,18,13035
5/19/2016,4,7925,1229,4153,65,1,19,13392
5/19/2016,5,7925,1363,4479,110,1,24,13902
5/19/2016,6,7927,1414,4737,137,9,28,14252
5/19/2016,7,7928,1517,5291,113,34,31,14914
5/19/2016,8,7927,1659,5452,60,100,35,15233
5/19/2016,9,7923,1681,5196,28,170,36,15034
5/19/2016,10,7925,1696,5018,29,189,35,14892
5/19/2016,11,7923,1456,5053,80,196,34,14742
5/19/2016,12,7916,1487,5276,179,164,37,15059
5/19/2016,13,7920,1688,5203,301,182,39,15333
5/19/2016,14,7924,1808,4860,425,204,44,15265
5/19/2016,15,7922,2141,4605,454,209,59,15390
5/19/2016,16,7926,2094,4805,405,152,93,15475
5/19/2016,17,7926,2101,5207,335,95,169,15833
5/19/2016,18,7924,2137,5358,281,53,206,15959
5/19/2016,19,7927,2180,5645,180,17,206,16155
5/19/2016,20,7924,2345,5933,142,2,209,16555
5/19/2016,21,7919,2423,5893,132,0,208,16575
5/19/2016,22,7918,1960,5550,135,0,116,15679
5/19/2016,23,7911,1238,4786,145,0,35,14115
5/19/2016,24,7921,948,4279,136,0,25,13309
5/20/2016,1,7918,895,4019,222,0,24,13078
5/20/2016,2,7924,898,3703,183,0,23,12731
5/20/2016,3,7919,1001,3726,148,0,22,12816
5/20/2016,4,7927,1261,3817,140,0,21,13166
5/20/2016,5,7930,1477,4259,108,4,28,13806
5/20/2016,6,7927,1487,4550,84,15,35,14098
5/20/2016,7,7925,1533,4823,127,41,37,14486
5/20/2016,8,7928,1543,5050,74,96,36,14727
5/20/2016,9,7944,1645,5215,32,168,37,15041
5/20/2016,10,7942,1888,4998,54,214,37,15133
5/20/2016,11,7935,1601,5013,104,216,43,14912
5/20/2016,12,7926,1508,4895,174,228,63,14794
5/20/2016,13,7930,1613,4869,153,142,90,14797
5/20/2016,14,7941,1817,4753,137,79,93,14820
5/20/2016,15,7945,1782,4672,179,179,116,14873
5/20/2016,16,7946,1753,4769,269,166,127,15030
5/20/2016,17,7946,1879,5101,430,126,154,15636
5/20/2016,18,7945,1855,4999,394,56,148,15397
5/20/2016,19,7945,1648,5122,451,17,153,15336
5/20/2016,20,7946,1648,5346,611,1,155,15707
5/20/2016,21,7927,1770,5037,663,0,141,15538
5/20/2016,22,7938,1267,5044,783,0,123,15155
5/20/2016,23,7946,551,4807,662,0,94,14060
5/20/2016,24,7954,376,4212,636,0,83,13261
5/21/2016,1,7955,369,3808,649,0,63,12844
5/21/2016,2,7953,370,3937,539,0,11,12810
5/21/2016,3,7947,444,3538,490,0,4,12423
5/21/2016,4,7958,461,3528,394,0,4,12345
5/21/2016,5,7963,630,3566,268,1,5,12433
5/21/2016,6,7964,911,3474,248,7,4,12608
5/21/2016,7,7964,1013,3759,179,17,3,12935
5/21/2016,8,7962,986,4202,159,39,3,13351
5/21/2016,9,7958,986,4614,173,96,3,13830
5/21/2016,10,7963,987,5090,193,103,3,14339
5/21/2016,11,7969,985,4715,285,152,3,14109
5/21/2016,12,7975,983,4651,450,141,3,14203
5/21/2016,13,7952,982,4449,508,165,6,14062
5/21/2016,14,7915,1000,4392,528,210,16,14061
5/21/2016,15,7971,597,4500,938,219,20,14245
5/21/2016,16,7964,680,4578,1089,163,15,14489
5/21/2016,17,7963,845,4591,1065,114,16,14594
5/21/2016,18,7972,1011,4781,879,73,17,14733
5/21/2016,19,7981,1028,5164,793,22,12,15000
5/21/2016,20,7978,1181,5050,593,2,7,14811
5/21/2016,21,7975,1190,5047,618,0,0,14830
5/21/2016,22,7974,1187,4921,685,0,0,14767
5/21/2016,23,7971,997,4388,790,0,0,14146
5/21/2016,24,7978,522,3393,787,0,0,12680
5/22/2016,1,7980,364,3471,802,0,0,12617
5/22/2016,2,7981,362,3330,661,0,0,12334
5/22/2016,3,7985,364,3469,568,0,0,12386
5/22/2016,4,7988,365,3425,698,1,0,12477
5/22/2016,5,7987,364,3455,929,1,0,12736
5/22/2016,6,7989,364,3435,796,10,0,12594
5/22/2016,7,7987,365,3601,750,40,0,12743
5/22/2016,8,7984,368,4416,554,104,0,13426
5/22/2016,9,7982,366,4432,501,178,0,13459
5/22/2016,10,7981,365,4170,408,218,0,13142
5/22/2016,11,7981,361,4419,602,228,0,13591
5/22/2016,12,7981,368,4391,895,221,0,13856
5/22/2016,13,8111,374,4228,973,219,0,13905
5/22/2016,14,8176,481,3983,974,205,1,13820
5/22/2016,15,8176,628,3931,1206,208,2,14151
5/22/2016,16,8126,784,4132,1211,178,0,14431
5/22/2016,17,8121,799,4476,1225,120,0,14741
5/22/2016,18,8124,848,4703,1367,62,0,15104
5/22/2016,19,8128,879,4897,1254,17,0,15175
5/22/2016,20,8126,1003,4987,1100,2,0,15218
5/22/2016,21,8122,998,4812,917,0,1,14850
5/22/2016,22,8123,677,4427,1072,0,1,14300
5/22/2016,23,8126,552,4264,1109,0,0,14051
5/22/2016,24,8122,550,3493,1083,0,0,13248
5/23/2016,1,8119,550,3419,937,0,0,13025
5/23/2016,2,8115,390,3448,608,0,0,12561
5/23/2016,3,8118,367,3365,361,0,0,12211
5/23/2016,4,8253,369,3353,269,0,0,12244
5/23/2016,5,8359,371,3293,365,1,0,12389
5/23/2016,6,8369,370,3709,437,10,0,12895
5/23/2016,7,8506,371,3603,274,44,0,12798
5/23/2016,8,8543,374,3776,149,109,0,12951
5/23/2016,9,8541,375,4190,98,178,0,13382
5/23/2016,10,8541,430,4479,104,221,0,13775
5/23/2016,11,8541,471,4377,128,232,0,13749
5/23/2016,12,8548,569,4450,146,232,0,13945
5/23/2016,13,8548,726,4316,184,200,0,13974
5/23/2016,14,8545,844,4254,112,159,0,13914
5/23/2016,15,8558,898,4249,148,174,0,14027
5/23/2016,16,8661,1002,4406,241,157,0,14467
5/23/2016,17,8680,1014,4847,371,132,0,15044
5/23/2016,18,8686,1013,5240,375,66,3,15383
5/23/2016,19,8686,1012,5396,358,17,9,15478
5/23/2016,20,8677,1018,5256,409,1,27,15388
5/23/2016,21,8680,1164,5436,456,0,20,15756
5/23/2016,22,8682,529,4784,588,0,17,14600
5/23/2016,23,8688,371,4337,531,0,16,13943
5/23/2016,24,8692,370,3744,871,0,14,13691
5/24/2016,1,8717,363,3279,858,0,0,13217
5/24/2016,2,8721,380,3240,864,0,0,13205
5/24/2016,3,8721,389,3344,523,0,0,12977
5/24/2016,4,8719,437,3360,718,0,0,13234
5/24/2016,5,8717,478,3506,834,1,1,13537
5/24/2016,6,8711,645,3839,651,9,2,13857
5/24/2016,7,8720,870,4444,582,41,34,14691
5/24/2016,8,8718,1058,4916,396,109,39,15236
5/24/2016,9,8729,1241,5323,203,172,40,15708
5/24/2016,10,8728,1514,5282,178,210,40,15952
5/24/2016,11,8727,1841,5164,209,212,28,16181
5/24/2016,12,8726,2054,4879,357,210,26,16252
5/24/2016,13,8726,2069,4886,599,151,26,16457
5/24/2016,14,8737,2217,4958,181,63,32,16188
5/24/2016,15,8739,2343,4973,287,125,27,16494
5/24/2016,16,8743,2338,4976,1032,141,26,17256
5/24/2016,17,8749,2413,5476,1098,105,26,17867
5/24/2016,18,8748,2292,5581,928,51,26,17626
5/24/2016,19,8750,2091,5818,902,15,36,17612
5/24/2016,20,8739,1894,5908,1129,1,35,17706
5/24/2016,21,8738,1729,5571,1598,0,30,17666
5/24/2016,22,8730,1330,4749,1866,0,27,16702
5/24/2016,23,8733,925,4364,1612,0,18,15652
5/24/2016,24,8741,850,3843,1251,0,12,14697
5/25/2016,1,8742,863,3335,1090,0,11,14041
5/25/2016,2,8744,866,3309,1304,0,11,14234
5/25/2016,3,8618,970,3418,747,0,9,13762
5/25/2016,4,7932,1280,3733,823,0,9,13777
5/25/2016,5,7931,1703,3784,466,2,13,13899
5/25/2016,6,7935,2045,4279,581,11,20,14871
5/25/2016,7,7937,2364,4545,618,38,26,15528
5/25/2016,8,7933,2466,4976,391,85,25,15876
5/25/2016,9,7934,2568,5071,386,135,26,16120
5/25/2016,10,7937,2922,4784,301,202,26,16172
5/25/2016,11,7939,2937,4950,676,191,26,16719
5/25/2016,12,7887,2965,4762,787,186,26,16613
5/25/2016,13,7626,3143,5067,840,183,26,16885
5/25/2016,14,7872,3240,4949,905,197,26,17189
5/25/2016,15,7941,3234,5226,892,196,26,17515
5/25/2016,16,7940,3402,5420,953,161,26,17902
5/25/2016,17,7939,3516,5712,972,114,26,18279
5/25/2016,18,7943,4057,5659,849,56,26,18590
5/25/2016,19,7944,3956,5828,703,17,26,18474
5/25/2016,20,7938,4057,5877,592,1,26,18491
5/25/2016,21,7929,3937,5632,892,0,26,18416
5/25/2016,22,7929,3042,5210,1234,0,26,17441
5/25/2016,23,7941,2181,4421,1194,0,17,15754
5/25/2016,24,7938,1464,3809,1520,0,13,14744
5/26/2016,1,7942,933,3317,1501,0,12,13705
5/26/2016,2,7941,873,3300,1545,0,13,13672
5/26/2016,3,7938,1002,3681,1145,0,14,13780
5/26/2016,4,7935,1252,3795,1185,0,13,14180
5/26/2016,5,7933,1628,3784,1231,2,16,14594
5/26/2016,6,7941,2096,4192,693,6,21,14949
5/26/2016,7,7946,2399,4680,918,33,28,16004
5/26/2016,8,7944,2585,4608,862,82,28,16109
5/26/2016,9,7941,2731,4562,1035,117,26,16412
5/26/2016,10,7926,2687,4521,898,155,25,16212
5/26/2016,11,7925,2779,4482,858,206,26,16276
5/26/2016,12,7926,3130,4470,1063,202,27,16818
5/26/2016,13,7927,3178,4459,1356,141,26,17087
5/26/2016,14,7926,3192,4185,1451,158,26,16938
5/26/2016,15,7923,3251,4432,1398,160,26,17190
5/26/2016,16,7939,3372,4800,1326,95,26,17558
5/26/2016,17,7952,3533,5386,1159,66,26,18122
5/26/2016,18,7973,3733,5343,1026,34,26,18135
5/26/2016,19,8008,3519,5557,968,10,26,18088
5/26/2016,20,8011,3537,5626,861,1,26,18062
5/26/2016,21,8000,3373,5555,1017,0,26,17971
5/26/2016,22,8009,2968,5152,1215,0,29,17373
5/26/2016,23,8008,2349,4609,1385,0,28,16379
5/26/2016,24,8014,1916,3740,1148,0,26,14844
5/27/2016,1,8015,1360,3662,1182,0,23,14242
5/27/2016,2,8010,1321,3260,1317,0,22,13930
5/27/2016,3,8105,1001,3530,1464,0,22,14122
5/27/2016,4,8201,1015,3729,1500,0,23,14468
5/27/2016,5,8202,1454,3803,1259,0,26,14744
5/27/2016,6,8202,2161,4064,610,7,29,15073
5/27/2016,7,8203,2535,4603,362,34,36,15773
5/27/2016,8,8193,2715,5129,337,92,35,16501
5/27/2016,9,8421,3040,5194,365,127,34,17181
5/27/2016,10,8735,3136,5016,366,161,35,17449
5/27/2016,11,8927,3489,5218,364,178,35,18211
5/27/2016,12,8934,4043,5198,393,204,35,18807
5/27/2016,13,8931,4170,5275,520,204,35,19135
5/27/2016,14,8937,3868,5449,564,204,35,19057
5/27/2016,15,8948,4212,5637,550,201,35,19583
5/27/2016,16,8948,4416,5632,507,170,36,19709
5/27/2016,17,8992,4711,5614,364,108,40,19829
5/27/2016,18,9092,4626,5399,269,61,36,19483
5/27/2016,19,9133,4440,5466,234,23,35,19331
5/27/2016,20,9132,4095,5562,211,3,36,19039
5/27/2016,21,9134,4173,5516,320,0,35,19178
5/27/2016,22,9159,3483,4909,466,0,35,18052
5/27/2016,23,9164,2491,4509,594,0,24,16782
5/27/2016,24,9166,1688,3529,839,0,16,15238
5/28/2016,1,9162,1370,3341,946,0,3,14822
5/28/2016,2,9170,943,3163,1011,0,3,14290
5/28/2016,3,9174,860,3207,1008,0,3,14252
5/28/2016,4,9176,863,3200,976,0,3,14218
5/28/2016,5,9111,958,3258,872,0,3,14202
5/28/2016,6,9093,1406,3345,513,3,3,14363
5/28/2016,7,9077,2097,3870,458,29,4,15535
5/28/2016,8,9061,2378,4389,473,69,5,16375
5/28/2016,9,9059,2618,5081,538,128,3,17427
5/28/2016,10,9058,2996,5148,596,170,3,17971
5/28/2016,11,9054,3155,5264,620,194,3,18290
5/28/2016,12,9068,3169,5147,738,198,3,18323
5/28/2016,13,9079,3129,4741,967,196,3,18115
5/28/2016,14,9085,3159,5238,1007,191,3,18683
5/28/2016,15,9115,3165,5468,1053,180,3,18984
5/28/2016,16,9165,3516,5377,1331,120,3,19512
5/28/2016,17,9167,3803,5512,1177,82,3,19744
5/28/2016,18,9142,3757,5490,1269,37,3,19698
5/28/2016,19,9127,3311,5476,1436,12,3,19365
5/28/2016,20,9124,2826,5680,1328,3,3,18964
5/28/2016,21,9113,3121,5466,1300,2,3,19005
5/28/2016,22,9110,2801,4802,1240,2,3,17958
5/28/2016,23,9085,2254,4007,1159,2,3,16510
5/28/2016,24,9117,2032,3455,1116,2,3,15725
5/29/2016,1,9119,1388,3414,1025,2,3,14951
5/29/2016,2,9118,934,3289,921,2,3,14267
5/29/2016,3,9119,940,3209,828,2,3,14101
5/29/2016,4,9125,1133,3248,860,2,3,14371
5/29/2016,5,9127,1352,3212,715,2,4,14412
5/29/2016,6,9125,1598,3121,551,3,3,14401
5/29/2016,7,9121,1918,3385,667,25,4,15120
5/29/2016,8,9107,2380,3791,549,85,3,15915
5/29/2016,9,9102,2608,4287,655,133,5,16790
5/29/2016,10,9101,2923,4427,967,137,5,17560
5/29/2016,11,9104,3066,4162,1359,169,4,17864
5/29/2016,12,9101,3071,4135,1571,191,5,18074
5/29/2016,13,9097,2998,4482,1696,161,4,18438
5/29/2016,14,9084,3026,5041,1867,137,4,19159
5/29/2016,15,9086,3052,4914,1982,136,4,19174
5/29/2016,16,9028,3023,5096,2060,126,4,19337
5/29/2016,17,9072,3032,5361,2024,84,4,19577
5/29/2016,18,9058,2742,5601,1723,45,4,19173
5/29/2016,19,9058,2570,5765,1535,14,4,18946
5/29/2016,20,9051,2577,5194,1741,1,4,18568
5/29/2016,21,9056,2584,5355,1787,0,4,18786
5/29/2016,22,8780,2520,5100,1205,0,4,17609
5/29/2016,23,8709,1785,3883,1189,0,4,15570
5/29/2016,24,8689,908,3727,1416,0,5,14745
5/30/2016,1,8687,799,4157,1128,0,4,14775
5/30/2016,2,8697,801,3764,1047,0,3,14312
5/30/2016,3,8598,885,3841,1177,0,3,14504
5/30/2016,4,8697,1103,3766,1308,0,3,14877
5/30/2016,5,8709,1356,3827,1285,0,3,15180
5/30/2016,6,8712,1647,4209,1099,5,3,15675
5/30/2016,7,8711,2089,5040,832,42,3,16717
5/30/2016,8,8717,2592,5434,728,96,4,17571
5/30/2016,9,8714,3062,5226,749,152,4,17907
5/30/2016,10,8715,3149,5278,641,181,3,17967
5/30/2016,11,8715,3729,5362,671,193,4,18674
5/30/2016,12,8721,3769,5310,749,170,4,18723
5/30/2016,13,8717,3667,5673,913,182,4,19156
5/30/2016,14,8236,4023,5832,1066,171,14,19342
5/30/2016,15,7846,4931,5956,918,165,14,19830
5/30/2016,16,7847,5012,5874,832,153,6,19724
5/30/2016,17,7714,4549,6101,730,107,10,19211
5/30/2016,18,7412,4744,5950,565,61,10,18742
5/30/2016,19,7419,5269,5881,370,21,9,18969
5/30/2016,20,7411,4843,5921,350,2,3,18530
5/30/2016,21,7411,4616,5850,310,1,3,18191
5/30/2016,22,7392,4465,5335,259,0,3,17454
5/30/2016,23,7387,2816,4997,254,0,7,15461
5/30/2016,24,7407,1680,4624,339,0,12,14062
5/31/2016,1,7477,835,5067,378,0,16,13773
5/31/2016,2,7696,756,4843,377,0,15,13687
5/31/2016,3,7938,834,4497,318,0,13,13600
5/31/2016,4,8086,1130,4359,287,0,13,13875
5/31/2016,5,8184,1672,4210,320,0,13,14399
5/31/2016,6,8201,2209,4270,301,5,13,14999
5/31/2016,7,8207,2492,4909,387,38,13,16046
5/31/2016,8,8208,2889,4933,349,91,13,16483
5/31/2016,9,8199,3033,4963,519,145,14,16873
5/31/2016,10,8198,3400,4928,607,183,9,17325
5/31/2016,11,8209,3459,4925,621,192,2,17408
5/31/2016,12,8207,3627,4841,688,191,7,17561
5/31/2016,13,8206,3790,5002,703,191,32,17924
5/31/2016,14,8170,3589,5080,787,185,37,17848
5/31/2016,15,8211,3407,5398,860,168,27,18071
5/31/2016,16,8290,3735,5649,851,130,26,18681
5/31/2016,17,8316,3806,5832,763,79,27,18823
5/31/2016,18,8319,3654,5808,565,57,31,18434
5/31/2016,19,8323,3459,5647,602,21,22,18074
5/31/2016,20,8326,3372,5648,645,4,21,18016
5/31/2016,21,8332,3313,5560,778,0,21,18004
5/31/2016,22,8364,3078,4763,849,0,21,17075
5/31/2016,23,8360,1575,4435,901,0,22,15293
5/31/2016,24,8685,846,4172,983,0,21,14707
6/1/2016,1,8770,797,3686,1082,0,21,14356
6/1/2016,2,8764,795,3676,1248,0,21,14504
6/1/2016,3,8770,799,3609,1335,0,21,14534
6/1/2016,4,8770,800,3597,1443,1,20,14631
6/1/2016,5,8769,799,3636,1600,1,26,14831
6/1/2016,6,8775,865,3852,1699,10,31,15232
6/1/2016,7,8782,954,4232,1700,46,36,15750
6/1/2016,8,8779,979,4242,1315,118,37,15470
6/1/2016,9,8789,1088,4206,1444,169,37,15733
6/1/2016,10,8786,1390,4436,1259,204,37,16112
6/1/2016,11,8788,1680,4527,1253,222,37,16507
6/1/2016,12,8778,1974,4833,1152,213,36,16986
6/1/2016,13,8782,2519,4697,948,201,35,17182
6/1/2016,14,8806,2723,4584,794,208,39,17154
6/1/2016,15,8805,2764,4882,821,185,39,17496
6/1/2016,16,8794,2856,4743,821,139,34,17387
6/1/2016,17,8876,3001,4952,843,117,35,17824
6/1/2016,18,8996,3017,4772,828,57,35,17705
6/1/2016,19,8989,2815,5205,921,15,35,17980
6/1/2016,20,8985,2485,5432,995,2,35,17934
6/1/2016,21,9011,2334,5604,958,0,36,17943
6/1/2016,22,9130,1567,5177,861,0,35,16770
6/1/2016,23,9138,1016,4450,946,0,35,15585
6/1/2016,24,9136,794,4152,841,0,20,14943
6/2/2016,1,9146,698,4029,844,0,17,14734
6/2/2016,2,9146,807,3858,539,0,17,14367
6/2/2016,3,9148,1080,3769,419,0,19,14435
6/2/2016,4,9150,1409,3511,430,0,23,14523
6/2/2016,5,9154,1663,3357,442,0,24,14640
6/2/2016,6,9149,1802,3734,397,3,30,15115
6/2/2016,7,9156,1911,4090,399,58,35,15649
6/2/2016,8,9155,1933,4507,390,88,35,16108
6/2/2016,9,9157,1960,4663,503,116,35,16434
6/2/2016,10,9147,2020,4859,550,122,36,16734
6/2/2016,11,9146,2254,5242,501,121,36,17300
6/2/2016,12,9164,2941,5380,560,127,36,18208
6/2/2016,13,9169,2821,5244,849,129,36,18248
6/2/2016,14,9172,2832,4989,1142,140,36,18311
6/2/2016,15,9168,2859,5062,1349,126,37,18601
6/2/2016,16,9178,3005,5346,1382,113,37,19061
6/2/2016,17,9177,3025,5601,1183,93,36,19115
6/2/2016,18,9183,3026,5856,949,59,36,19109
6/2/2016,19,9187,3159,6007,681,20,35,19089
6/2/2016,20,9185,3316,5905,510,4,35,18955
6/2/2016,21,9192,3170,5885,449,0,36,18732
6/2/2016,22,9191,3070,5327,396,0,34,18018
6/2/2016,23,9193,2179,5043,454,0,34,16903
6/2/2016,24,9197,1023,4728,475,0,21,15444
6/3/2016,1,9270,750,4369,499,0,17,14905
6/3/2016,2,9415,765,4149,444,0,17,14790
6/3/2016,3,9476,778,4056,299,0,20,14629
6/3/2016,4,9565,866,3928,247,0,22,14628
6/3/2016,5,9560,1183,3961,175,0,23,14902
6/3/2016,6,9561,1605,4362,214,5,30,15777
6/3/2016,7,9719,1828,4832,83,40,35,16537
6/3/2016,8,9721,1864,5265,21,102,37,17010
6/3/2016,9,9719,1940,5096,38,157,36,16986
6/3/2016,10,9728,2157,4967,98,199,36,17185
6/3/2016,11,9737,2392,5332,110,204,36,17811
6/3/2016,12,9741,2342,5309,182,194,35,17803
6/3/2016,13,9730,2486,5372,422,188,36,18234
6/3/2016,14,9731,2497,5270,623,204,35,18360
6/3/2016,15,9755,2629,5286,747,189,35,18641
6/3/2016,16,9753,2859,5447,792,158,36,19045
6/3/2016,17,9761,2880,5562,629,117,36,18985
6/3/2016,18,9765,2982,5742,451,56,36,19032
6/3/2016,19,9801,3036,5806,278,14,36,18971
6/3/2016,20,9853,2870,5742,190,1,36,18692
6/3/2016,21,9840,2589,5738,187,0,36,18390
6/3/2016,22,9851,2063,5459,248,0,36,17657
6/3/2016,23,9859,839,5144,252,0,12,16106
6/3/2016,24,9868,448,4515,349,0,3,15183
6/4/2016,1,9878,340,4323,544,0,3,15088
6/4/2016,2,9873,340,3964,723,0,3,14903
6/4/2016,3,9878,341,3672,834,0,3,14728
6/4/2016,4,9892,340,3331,950,0,3,14516
6/4/2016,5,9900,344,3177,849,1,3,14274
6/4/2016,6,9954,348,3251,607,12,3,14175
6/4/2016,7,9955,347,3899,558,43,3,14805
6/4/2016,8,9949,422,4491,505,88,3,15458
6/4/2016,9,9940,447,5170,397,130,5,16089
6/4/2016,10,9936,740,5246,349,180,4,16455
6/4/2016,11,9933,1050,5171,328,201,4,16687
6/4/2016,12,9927,1234,5108,396,205,4,16874
6/4/2016,13,9918,1203,5344,451,184,4,17104
6/4/2016,14,9903,1218,5425,480,194,4,17224
6/4/2016,15,9909,1305,5478,525,189,4,17410
6/4/2016,16,9929,1580,5484,635,165,4,17797
6/4/2016,17,9933,1576,5427,811,115,4,17866
6/4/2016,18,9958,1537,5303,1013,62,4,17877
6/4/2016,19,9973,1543,5730,902,18,4,18170
6/4/2016,20,9971,1212,5526,894,2,8,17613
6/4/2016,21,9968,1007,5726,951,0,5,17657
6/4/2016,22,9978,641,5103,1282,0,4,17008
6/4/2016,23,9972,364,4258,1427,0,4,16025
6/4/2016,24,9977,343,3450,1738,0,4,15512
6/5/2016,1,9974,343,3156,1548,0,3,15024
6/5/2016,2,9960,341,3061,1345,0,3,14710
6/5/2016,3,9945,328,3013,995,0,3,14284
6/5/2016,4,9947,257,3124,665,0,4,13997
6/5/2016,5,9946,280,3120,985,1,4,14336
6/5/2016,6,9957,287,3169,699,1,3,14116
6/5/2016,7,9958,292,3473,1159,6,4,14892
6/5/2016,8,9934,288,3629,1485,24,4,15364
6/5/2016,9,9925,289,3662,2094,39,4,16013
6/5/2016,10,9904,288,3899,2440,34,4,16569
6/5/2016,11,9882,294,4393,2438,68,4,17079
6/5/2016,12,9882,291,4781,2144,100,4,17202
6/5/2016,13,9883,317,5188,1763,106,4,17261
6/5/2016,14,9843,311,4951,2018,129,4,17256
6/5/2016,15,9894,321,4329,1677,112,4,16337
6/5/2016,16,9916,338,4658,1998,45,4,16959
6/5/2016,17,9929,337,4896,2181,59,4,17406
6/5/2016,18,9934,339,4809,2167,48,4,17301
6/5/2016,19,9941,341,4949,2037,15,4,17287
6/5/2016,20,9936,343,4998,1801,1,4,17083
6/5/2016,21,9933,341,4975,1806,0,3,17058
6/5/2016,22,9938,342,4390,2193,0,4,16867
6/5/2016,23,9948,345,4000,1608,0,4,15905
6/5/2016,24,9957,345,3549,1427,0,11,15289
6/6/2016,1,9945,347,3335,1022,0,12,14661
6/6/2016,2,9944,347,3303,347,0,21,13962
6/6/2016,3,9824,349,3129,649,0,22,13973
6/6/2016,4,9733,409,3029,515,0,21,13707
6/6/2016,5,9748,426,3103,1017,1,23,14318
6/6/2016,6,9832,577,3420,1396,4,32,15261
6/6/2016,7,10013,702,3931,1796,38,35,16515
6/6/2016,8,10017,755,4403,1952,76,35,17238
6/6/2016,9,10014,764,4272,1854,104,36,17044
6/6/2016,10,9999,764,4362,1688,126,36,16975
6/6/2016,11,9984,811,4757,1301,173,32,17058
6/6/2016,12,9986,904,4762,1503,164,25,17344
6/6/2016,13,9996,918,4839,1807,148,29,17737
6/6/2016,14,10007,974,4598,2132,176,36,17923
6/6/2016,15,10006,1172,4617,1742,158,35,17730
6/6/2016,16,10004,1173,4627,2119,138,35,18096
6/6/2016,17,9999,1174,5036,1637,96,35,17977
6/6/2016,18,10000,1211,5100,764,46,35,17156
6/6/2016,19,9998,1215,4934,816,9,35,17007
6/6/2016,20,9994,1214,4937,692,1,35,16873
6/6/2016,21,10006,1213,4969,812,0,34,17034
6/6/2016,22,10005,914,4803,644,0,35,16401
6/6/2016,23,10009,805,4036,855,0,23,15728
6/6/2016,24,10016,771,3596,603,0,20,15006
6/7/2016,1,10014,768,3416,397,0,18,14613
6/7/2016,2,9902,766,3199,293,0,18,14178
6/7/2016,3,9767,766,2991,619,0,19,14162
6/7/2016,4,9768,766,2953,418,0,20,13925
6/7/2016,5,9769,767,3225,600,1,37,14399
6/7/2016,6,9840,771,3474,906,4,59,15054
6/7/2016,7,10019,787,3975,920,27,64,15792
6/7/2016,8,10019,785,4365,1331,72,63,16635
6/7/2016,9,10013,780,4209,1127,109,64,16302
6/7/2016,10,10013,775,4188,836,130,63,16005
6/7/2016,11,10017,788,4071,1189,145,63,16273
6/7/2016,12,9963,799,4077,1478,155,64,16536
6/7/2016,13,9881,801,4049,1596,156,62,16545
6/7/2016,14,10010,802,3952,1345,147,62,16318
6/7/2016,15,10008,808,3926,1343,149,64,16298
6/7/2016,16,10010,814,4252,1582,128,64,16850
6/7/2016,17,10016,829,4377,1421,67,61,16771
6/7/2016,18,10017,840,4582,1091,47,60,16637
6/7/2016,19,10012,857,4724,839,16,58,16506
6/7/2016,20,10011,858,4704,1137,3,55,16768
6/7/2016,21,9997,860,4728,1036,0,52,16673
6/7/2016,22,9999,832,4038,1493,0,37,16399
6/7/2016,23,10009,816,3643,625,0,22,15115
6/7/2016,24,10019,791,3446,538,0,19,14813
6/8/2016,1,9844,788,3281,580,0,18,14511
6/8/2016,2,9772,788,3120,352,0,19,14051
6/8/2016,3,9707,789,3020,349,0,20,13885
6/8/2016,4,9483,786,3035,681,0,20,14005
6/8/2016,5,9516,789,3187,810,4,25,14331
6/8/2016,6,9851,788,3678,642,6,27,14992
6/8/2016,7,10036,796,3944,630,20,30,15456
6/8/2016,8,10038,798,4027,514,29,29,15435
6/8/2016,9,10038,829,4034,383,81,32,15397
6/8/2016,10,10029,830,4007,890,132,16,15904
6/8/2016,11,10026,831,4116,889,128,4,15994
6/8/2016,12,10025,830,4111,1165,133,1,16265
6/8/2016,13,10014,819,4180,1509,118,3,16643
6/8/2016,14,10016,826,3915,1655,130,10,16552
6/8/2016,15,10017,826,3830,1693,125,32,16523
6/8/2016,16,10026,823,3968,1717,93,34,16661
6/8/2016,17,10023,829,4216,1498,77,35,16678
6/8/2016,18,10045,805,4525,1118,63,34,16590
6/8/2016,19,10051,799,4805,910,19,35,16619
6/8/2016,20,10046,799,5157,738,2,34,16776
6/8/2016,21,10049,802,4945,744,0,34,16574
6/8/2016,22,10046,801,4136,655,0,34,15672
6/8/2016,23,10025,790,3633,501,0,23,14972
6/8/2016,24,9802,789,3397,274,0,18,14280
6/9/2016,1,9803,789,3278,392,0,18,14280
6/9/2016,2,9553,791,3002,364,0,18,13728
6/9/2016,3,9496,790,2954,490,0,19,13749
6/9/2016,4,9493,792,2970,669,0,19,13943
6/9/2016,5,9562,788,3308,742,3,22,14425
6/9/2016,6,9776,788,3723,369,12,29,14697
6/9/2016,7,9793,790,4087,494,39,33,15236
6/9/2016,8,10021,793,4239,400,97,34,15584
6/9/2016,9,10025,791,4201,437,159,34,15647
6/9/2016,10,10030,785,4094,334,209,34,15486
6/9/2016,11,10034,781,4075,510,228,34,15662
6/9/2016,12,10031,778,3947,662,223,38,15679
6/9/2016,13,10032,775,4026,390,178,38,15439
6/9/2016,14,10034,769,3992,576,215,33,15619
6/9/2016,15,10030,761,4017,579,208,33,15628
6/9/2016,16,10028,763,4222,404,155,35,15607
6/9/2016,17,10026,764,4522,352,67,35,15766
6/9/2016,18,10026,766,4577,589,77,35,16070
6/9/2016,19,10032,780,4859,449,19,36,16175
6/9/2016,20,10038,896,5284,273,2,38,16531
6/9/2016,21,10033,1055,5188,244,0,38,16558
6/9/2016,22,10028,1002,4654,221,0,35,15940
6/9/2016,23,9912,777,3846,118,0,24,14677
6/9/2016,24,9506,779,3660,212,0,22,14179
6/10/2016,1,9487,780,3490,223,0,20,14000
6/10/2016,2,9483,783,3319,265,0,21,13871
6/10/2016,3,9299,785,3263,335,0,21,13703
6/10/2016,4,9194,784,3290,460,1,20,13749
6/10/2016,5,9492,783,3726,580,1,26,14608
6/10/2016,6,9790,783,3721,395,11,29,14729
6/10/2016,7,9862,788,4020,632,45,42,15389
6/10/2016,8,10042,781,4180,433,118,41,15595
6/10/2016,9,10045,779,4341,354,181,35,15735
6/10/2016,10,10037,786,4670,276,217,38,16024
6/10/2016,11,10034,782,4561,271,224,40,15912
6/10/2016,12,10035,809,4524,298,228,36,15930
6/10/2016,13,10037,815,4513,345,226,36,15972
6/10/2016,14,10038,837,4487,309,207,41,15919
6/10/2016,15,10038,853,4574,306,178,42,15991
6/10/2016,16,10039,913,4537,510,160,38,16197
6/10/2016,17,10043,965,4625,539,128,38,16338
6/10/2016,18,10042,962,4838,609,69,39,16559
6/10/2016,19,10044,919,4989,683,19,36,16690
6/10/2016,20,10040,919,4890,548,2,36,16435
6/10/2016,21,10035,920,4726,840,0,36,16557
6/10/2016,22,10041,934,4421,880,0,36,16312
6/10/2016,23,10049,516,4003,646,0,34,15248
6/10/2016,24,9977,413,3394,1193,0,7,14984
6/11/2016,1,9738,414,3302,937,0,4,14395
6/11/2016,2,9460,413,3429,941,0,4,14247
6/11/2016,3,9156,418,3383,1112,0,4,14073
6/11/2016,4,9131,418,3361,950,0,4,13864
6/11/2016,5,9155,410,3297,1050,0,4,13916
6/11/2016,6,9150,410,3402,742,1,4,13709
6/11/2016,7,9148,410,3723,831,10,4,14126
6/11/2016,8,9170,410,3938,1333,24,4,14879
6/11/2016,9,9619,405,4028,1573,72,4,15701
6/11/2016,10,10012,405,4205,1601,109,4,16336
6/11/2016,11,10014,405,4434,1708,136,4,16701
6/11/2016,12,10013,405,4419,2052,139,4,17032
6/11/2016,13,10019,408,4451,2033,132,4,17047
6/11/2016,14,10020,474,4487,2082,165,4,17232
6/11/2016,15,9983,656,4812,1883,156,4,17494
6/11/2016,16,10017,799,5021,2069,154,9,18069
6/11/2016,17,10016,802,5131,2225,111,8,18293
6/11/2016,18,10014,802,5571,2247,67,4,18705
6/11/2016,19,10006,803,5777,2169,18,4,18777
6/11/2016,20,10003,809,5432,2273,3,4,18524
6/11/2016,21,9987,808,5224,2492,0,3,18514
6/11/2016,22,9997,487,5052,2880,0,3,18419
6/11/2016,23,10010,403,4438,2395,0,3,17249
6/11/2016,24,10015,407,4102,1501,0,3,16028
6/12/2016,1,10003,406,3804,541,0,3,14757
6/12/2016,2,9715,406,3541,313,0,4,13979
6/12/2016,3,9199,415,3305,544,0,4,13467
6/12/2016,4,8918,396,3278,562,0,3,13157
6/12/2016,5,8870,403,3242,369,1,3,12888
6/12/2016,6,8848,408,3295,222,3,5,12781
6/12/2016,7,8583,412,3733,458,38,30,13254
6/12/2016,8,8623,410,3845,1021,82,36,14017
6/12/2016,9,9129,414,3865,1046,93,37,14584
6/12/2016,10,9696,414,3829,852,113,41,14945
6/12/2016,11,9998,413,3847,777,122,44,15201
6/12/2016,12,10004,414,3790,951,142,44,15345
6/12/2016,13,10000,411,3754,908,169,42,15284
6/12/2016,14,9987,413,3929,799,147,40,15315
6/12/2016,15,9979,408,4004,995,159,33,15578
6/12/2016,16,9982,410,3979,1284,128,26,15809
6/12/2016,17,9985,410,3897,2056,89,25,16462
6/12/2016,18,10004,411,3908,2154,54,25,16556
6/12/2016,19,10011,414,4198,1429,15,29,16096
6/12/2016,20,10008,419,4139,1366,1,30,15963
6/12/2016,21,10006,412,4451,1063,0,25,15957
6/12/2016,22,10017,414,3946,1061,0,20,15458
6/12/2016,23,10014,417,3700,737,0,8,14876
6/12/2016,24,9962,416,3510,267,0,7,14162
6/13/2016,1,9442,418,3462,291,0,25,13638
6/13/2016,2,9090,419,3485,333,0,39,13366
6/13/2016,3,8906,423,3372,562,0,36,13299
6/13/2016,4,8908,458,3371,561,0,35,13333
6/13/2016,5,8912,471,3640,677,2,43,13745
6/13/2016,6,8999,626,4309,498,8,55,14495
6/13/2016,7,9484,711,5025,292,31,59,15602
6/13/2016,8,9975,771,5084,183,72,58,16143
6/13/2016,9,10027,769,5328,117,117,60,16418
6/13/2016,10,10026,765,5023,34,172,60,16080
6/13/2016,11,10024,775,5248,83,197,61,16388
6/13/2016,12,10002,842,5158,206,190,60,16458
6/13/2016,13,10001,905,4945,469,120,60,16500
6/13/2016,14,10005,1034,4711,636,116,62,16564
6/13/2016,15,10009,1186,4480,607,130,59,16471
6/13/2016,16,10011,1185,4512,552,131,47,16438
6/13/2016,17,10017,1181,4562,612,101,27,16500
6/13/2016,18,10014,1189,4728,297,51,26,16305
6/13/2016,19,10021,1192,4807,339,16,27,16402
6/13/2016,20,10021,1193,4883,348,4,27,16476
6/13/2016,21,10020,1197,4972,417,0,26,16632
6/13/2016,22,10019,888,4784,290,0,26,16007
6/13/2016,23,10020,777,4234,275,0,15,15321
6/13/2016,24,10026,778,3575,325,0,22,14726
6/14/2016,1,9872,785,3573,229,0,11,14470
6/14/2016,2,9428,816,3558,246,0,14,14062
6/14/2016,3,9189,841,3579,310,0,14,13933
6/14/2016,4,9200,808,3585,385,0,12,13990
6/14/2016,5,9263,818,3799,388,2,16,14286
6/14/2016,6,9743,828,3703,306,6,17,14603
6/14/2016,7,10034,840,4049,332,38,26,15319
6/14/2016,8,10036,836,4476,311,110,26,15795
6/14/2016,9,10031,833,4762,209,140,26,16001
6/14/2016,10,10034,851,4567,197,217,25,15891
6/14/2016,11,10033,861,4601,139,202,26,15862
6/14/2016,12,10035,932,4686,149,213,25,16040
6/14/2016,13,10001,1091,4664,158,220,25,16159
6/14/2016,14,9999,1189,4682,258,231,26,16385
6/14/2016,15,10014,1195,4687,202,226,26,16350
6/14/2016,16,10014,1195,4787,251,198,26,16471
6/14/2016,17,10011,1205,4884,311,144,28,16583
6/14/2016,18,10012,1187,5016,332,76,33,16656
6/14/2016,19,10010,1144,5353,292,18,34,16851
6/14/2016,20,10004,1153,5265,260,1,36,16719
6/14/2016,21,9994,1163,5262,302,0,35,16756
6/14/2016,22,9988,848,4985,363,0,35,16219
6/14/2016,23,10004,756,4142,446,0,25,15373
6/14/2016,24,10006,766,3518,558,0,19,14867
6/15/2016,1,9949,769,3520,650,0,18,14906
6/15/2016,2,9523,758,3492,679,0,19,14471
6/15/2016,3,9468,781,3366,555,0,20,14190
6/15/2016,4,9467,782,3424,581,1,21,14276
6/15/2016,5,9538,766,3338,890,1,24,14557
6/15/2016,6,9940,784,3626,724,11,29,15114
6/15/2016,7,10021,786,3942,776,44,34,15603
6/15/2016,8,10022,796,4123,431,104,34,15510
6/15/2016,9,10015,806,4161,759,175,34,15950
6/15/2016,10,10018,931,4195,876,208,34,16262
6/15/2016,11,10017,866,4605,948,211,35,16682
6/15/2016,12,10014,1072,4961,689,196,35,16967
6/15/2016,13,9969,1266,4935,438,214,34,16856
6/15/2016,14,9817,1438,4974,426,177,35,16867
6/15/2016,15,9838,1457,4939,596,148,35,17013
6/15/2016,16,10020,1480,4528,812,117,36,16993
6/15/2016,17,10036,1593,4513,966,68,35,17211
6/15/2016,18,10038,1602,4507,1080,39,35,17301
6/15/2016,19,10039,1381,4757,1067,13,35,17292
6/15/2016,20,10032,1356,4789,1177,1,35,17390
6/15/2016,21,10027,1213,4634,1374,0,35,17283
6/15/2016,22,10023,845,4279,1349,0,35,16531
6/15/2016,23,10016,750,3983,1057,0,27,15833
6/15/2016,24,10020,753,3549,798,0,20,15140
6/16/2016,1,10024,754,3347,363,0,16,14504
6/16/2016,2,9891,752,3323,584,0,16,14566
6/16/2016,3,9750,755,3308,674,0,16,14503
6/16/2016,4,9747,752,3285,655,0,16,14455
6/16/2016,5,9749,755,3361,624,0,22,14511
6/16/2016,6,9971,753,3777,649,6,31,15187
6/16/2016,7,10049,757,3909,995,31,34,15775
6/16/2016,8,10046,750,4467,856,101,34,16254
6/16/2016,9,10040,741,4930,797,163,34,16705
6/16/2016,10,10033,744,4830,990,166,34,16797
6/16/2016,11,10033,773,4577,928,165,34,16510
6/16/2016,12,10031,895,4769,963,179,35,16872
6/16/2016,13,10035,1089,4781,1008,184,36,17133
6/16/2016,14,10030,1364,4919,1006,142,36,17497
6/16/2016,15,10024,1541,4906,1098,155,40,17764
6/16/2016,16,10024,1545,4916,1074,155,35,17749
6/16/2016,17,10027,1559,4853,1169,117,35,17760
6/16/2016,18,10021,1583,5327,1113,68,38,18150
6/16/2016,19,10022,1513,5729,1120,22,40,18446
6/16/2016,20,10011,1356,5601,1241,4,42,18255
6/16/2016,21,10012,1205,5327,1373,0,37,17954
6/16/2016,22,10012,860,5041,1463,0,42,17418
6/16/2016,23,10021,762,4414,1151,0,33,16381
6/16/2016,24,10025,765,4006,928,0,21,15745
6/17/2016,1,10022,778,3364,695,0,16,14875
6/17/2016,2,9953,827,3351,498,0,16,14645
6/17/2016,3,9733,876,3271,508,0,16,14404
6/17/2016,4,9731,948,3257,389,0,16,14341
6/17/2016,5,9731,1048,3344,584,0,23,14730
6/17/2016,6,9977,1055,3525,563,7,27,15154
6/17/2016,7,10019,1064,3774,400,27,32,15316
6/17/2016,8,10014,1092,4704,354,60,37,16261
6/17/2016,9,10011,1110,4887,206,186,36,16436
6/17/2016,10,10014,1210,5105,225,220,35,16809
6/17/2016,11,10010,1294,5220,331,233,35,17123
6/17/2016,12,10015,1449,5229,358,232,35,17318
6/17/2016,13,10009,1764,5107,364,226,36,17506
6/17/2016,14,10008,1967,5155,429,229,36,17824
6/17/2016,15,10003,2136,5360,508,223,36,18266
6/17/2016,16,10003,2365,5505,481,193,39,18586
6/17/2016,17,10002,2616,5612,454,141,39,18864
6/17/2016,18,10003,2804,5691,532,74,38,19142
6/17/2016,19,10003,2710,5899,460,20,36,19128
6/17/2016,20,9995,2818,5519,462,4,41,18839
6/17/2016,21,9989,2480,5011,444,0,42,17966
6/17/2016,22,9985,2037,4789,349,0,34,17194
6/17/2016,23,9992,1749,4220,206,0,23,16190
6/17/2016,24,9986,1746,3742,104,0,5,15583
6/18/2016,1,9991,945,3956,193,0,3,15088
6/18/2016,2,9994,700,3749,179,0,19,14641
6/18/2016,3,9995,704,3539,141,0,23,14402
6/18/2016,4,9996,712,3312,196,0,6,14222
6/18/2016,5,9997,810,3427,184,1,3,14422
6/18/2016,6,9998,1036,3286,77,7,3,14407
6/18/2016,7,9996,1361,3825,65,41,3,15291
6/18/2016,8,9996,1740,3931,46,85,3,15801
6/18/2016,9,9987,2022,4054,23,166,3,16255
6/18/2016,10,9987,2044,4729,21,194,3,16978
6/18/2016,11,9981,2205,5095,32,225,4,17542
6/18/2016,12,9980,2562,5202,54,230,5,18033
6/18/2016,13,9979,2773,5188,95,226,4,18265
6/18/2016,14,9930,2937,5124,157,223,4,18375
6/18/2016,15,9976,2943,5320,213,211,6,18669
6/18/2016,16,9982,3206,5474,263,178,6,19109
6/18/2016,17,9986,3361,5566,256,137,5,19311
6/18/2016,18,9986,3407,5769,209,67,4,19442
6/18/2016,19,9987,3285,5700,196,22,3,19193
6/18/2016,20,10000,3093,5565,214,4,3,18879
6/18/2016,21,10001,2717,5384,226,0,10,18338
6/18/2016,22,9997,2302,5080,296,0,11,17686
6/18/2016,23,10002,1650,4477,466,0,3,16598
6/18/2016,24,10006,1240,3949,544,0,3,15742
6/19/2016,1,10006,802,4033,637,0,3,15481
6/19/2016,2,10016,701,3880,778,0,3,15378
6/19/2016,3,10014,702,3459,849,0,3,15027
6/19/2016,4,10072,705,3370,494,0,3,14644
6/19/2016,5,10111,713,3118,181,1,3,14127
6/19/2016,6,9826,727,3084,170,7,3,13817
6/19/2016,7,9582,893,3446,195,33,3,14152
6/19/2016,8,9576,1328,4043,230,81,3,15261
6/19/2016,9,9747,1732,4706,217,161,12,16575
6/19/2016,10,10099,1859,4662,239,186,19,17064
6/19/2016,11,10223,2044,5112,327,211,12,17929
6/19/2016,12,10201,2396,4744,595,223,3,18162
6/19/2016,13,10207,2688,4712,793,215,3,18618
6/19/2016,14,10203,2938,4641,1103,218,3,19106
6/19/2016,15,10198,2939,4929,1221,213,21,19521
6/19/2016,16,10195,3037,5376,1206,182,26,20022
6/19/2016,17,10197,3221,5529,1173,125,28,20273
6/19/2016,18,10197,3245,5459,1014,61,28,20004
6/19/2016,19,10191,3211,5620,920,20,25,19987
6/19/2016,20,10170,2930,5483,1176,3,20,19782
6/19/2016,21,10166,2559,5227,1673,0,7,19632
6/19/2016,22,10159,2059,4621,1979,0,2,18820
6/19/2016,23,10174,1042,4070,2393,0,2,17681
6/19/2016,24,10176,698,3677,2399,0,2,16952
6/20/2016,1,10171,699,3507,2452,0,2,16831
6/20/2016,2,10169,704,3162,2370,0,18,16423
6/20/2016,3,10167,701,2930,2318,0,29,16145
6/20/2016,4,10169,698,2889,2159,0,31,15946
6/20/2016,5,10174,709,2999,2226,1,32,16141
6/20/2016,6,10172,742,3587,2048,7,31,16587
6/20/2016,7,10174,1012,3991,2250,41,36,17504
6/20/2016,8,10173,1359,4470,2152,93,36,18283
6/20/2016,9,10177,1714,4787,2309,154,36,19177
6/20/2016,10,10172,2011,4504,2469,196,49,19401
6/20/2016,11,10169,2275,4477,2938,194,44,20097
6/20/2016,12,10333,2617,4105,3201,222,50,20528
6/20/2016,13,10381,3032,4072,3297,211,59,21052
6/20/2016,14,10371,3222,4186,3316,217,54,21366
6/20/2016,15,10356,3185,4223,3296,192,52,21304
6/20/2016,16,10346,3209,4777,3306,128,52,21818
6/20/2016,17,10345,3290,5163,3250,95,52,22195
6/20/2016,18,10392,3728,4994,2904,43,57,22118
6/20/2016,19,10403,3334,5038,2902,14,59,21750
6/20/2016,20,10405,3219,4930,2625,2,55,21236
6/20/2016,21,10395,3326,4932,2241,0,41,20935
6/20/2016,22,10408,3072,4441,1944,0,33,19898
6/20/2016,23,10419,2304,3646,1947,0,36,18352
6/20/2016,24,10426,1203,3284,1906,0,29,16848
6/21/2016,1,10522,896,3510,815,0,18,15761
6/21/2016,2,10543,802,3307,1029,0,17,15698
6/21/2016,3,10546,829,3657,542,0,17,15591
6/21/2016,4,10553,908,3515,279,0,20,15275
6/21/2016,5,10571,1218,3491,234,0,24,15538
6/21/2016,6,10582,1584,3608,256,7,30,16067
6/21/2016,7,10584,1864,3861,233,33,36,16611
6/21/2016,8,10580,1859,3720,135,109,35,16438
6/21/2016,9,10579,2033,3903,135,174,36,16860
6/21/2016,10,10578,2263,3929,191,201,37,17199
6/21/2016,11,10581,2396,4262,293,207,36,17775
6/21/2016,12,10579,2527,4434,430,219,36,18225
6/21/2016,13,10678,2431,4190,640,217,37,18193
6/21/2016,14,10698,2454,4008,828,217,36,18241
6/21/2016,15,10695,2429,4147,961,204,36,18472
6/21/2016,16,10694,2452,4486,889,170,36,18727
6/21/2016,17,10694,2669,4676,826,138,36,19039
6/21/2016,18,10701,2459,4695,784,57,35,18731
6/21/2016,19,10702,2255,4504,760,14,33,18268
6/21/2016,20,10695,2308,4495,827,2,32,18359
6/21/2016,21,10700,2255,4250,795,0,33,18033
6/21/2016,22,10699,1336,4310,757,0,33,17135
6/21/2016,23,10570,846,3807,948,2,34,16207
6/21/2016,24,10676,778,3305,1054,2,25,15840
6/22/2016,1,10699,812,3249,1074,2,24,15860
6/22/2016,2,10712,831,3186,669,3,23,15424
6/22/2016,3,10651,833,3066,671,3,23,15247
6/22/2016,4,10657,832,3181,511,3,22,15206
6/22/2016,5,10658,1014,3252,514,4,24,15466
6/22/2016,6,10661,1291,3407,354,5,30,15748
6/22/2016,7,10656,1646,4022,250,37,35,16646
6/22/2016,8,10654,1862,4083,178,109,35,16921
6/22/2016,9,10649,1878,4104,199,171,35,17036
6/22/2016,10,10653,1891,4191,296,184,35,17250
6/22/2016,11,10658,1936,3611,351,195,35,16786
6/22/2016,12,10659,2113,3681,403,200,35,17091
6/22/2016,13,10508,2304,4152,592,168,35,17759
6/22/2016,14,10564,2490,4073,688,190,44,18049
6/22/2016,15,10662,2790,4133,638,182,44,18449
6/22/2016,16,10721,2912,4363,519,181,38,18734
6/22/2016,17,10766,2957,4536,491,115,36,18901
6/22/2016,18,10764,2893,4601,451,62,36,18807
6/22/2016,19,10769,2972,4819,301,24,37,18922
6/22/2016,20,10767,2716,4827,182,6,37,18535
6/22/2016,21,10755,2636,4562,292,0,37,18282
6/22/2016,22,10750,1886,4204,481,0,37,17358
6/22/2016,23,10755,1009,4010,536,0,28,16338
6/22/2016,24,10758,830,3534,560,0,22,15704
6/23/2016,1,10761,830,3375,464,0,20,15450
6/23/2016,2,10755,833,3533,406,0,20,15547
6/23/2016,3,10782,840,3202,356,0,19,15199
6/23/2016,4,10785,921,3214,414,0,20,15354
6/23/2016,5,10778,1128,3221,418,3,25,15573
6/23/2016,6,10774,1427,3327,231,10,34,15803
6/23/2016,7,10779,1659,3571,262,40,36,16347
6/23/2016,8,10779,1714,3828,349,99,36,16805
6/23/2016,9,10785,1846,4120,241,156,40,17188
6/23/2016,10,10786,2148,4334,208,181,41,17698
6/23/2016,11,10782,2311,4353,255,180,41,17922
6/23/2016,12,10782,2445,4223,418,161,51,18080
6/23/2016,13,10786,2469,4044,498,169,83,18049
6/23/2016,14,10798,2474,4177,443,137,111,18140
6/23/2016,15,10794,2497,3910,362,126,86,17775
6/23/2016,16,10793,2585,3821,375,152,69,17795
6/23/2016,17,10798,2776,4086,396,141,37,18234
6/23/2016,18,10801,2830,4063,424,79,36,18233
6/23/2016,19,10804,2622,4483,495,21,35,18460
6/23/2016,20,10806,2487,4561,423,1,35,18313
6/23/2016,21,10801,2374,4444,354,0,37,18010
6/23/2016,22,10801,2101,3796,466,0,39,17203
6/23/2016,23,10794,1041,3506,439,0,32,15812
6/23/2016,24,10799,816,3323,438,0,20,15396
6/24/2016,1,10851,818,3190,425,0,19,15303
6/24/2016,2,10860,823,3074,195,0,18,14970
6/24/2016,3,10721,830,3059,409,0,18,15037
6/24/2016,4,10570,904,3192,384,0,18,15068
6/24/2016,5,10573,1157,3253,347,0,23,15353
6/24/2016,6,10623,1437,3350,163,6,29,15608
6/24/2016,7,10863,1673,3651,266,36,34,16523
6/24/2016,8,10824,1657,4115,107,102,34,16839
6/24/2016,9,10806,1822,4212,54,168,34,17096
6/24/2016,10,10810,2215,4191,82,215,35,17548
6/24/2016,11,10803,2582,4021,84,230,35,17755
6/24/2016,12,10793,2793,4207,162,206,35,18196
6/24/2016,13,10784,3020,3950,306,229,35,18324
6/24/2016,14,10780,3045,3713,383,228,35,18184
6/24/2016,15,10787,2863,3868,364,221,35,18138
6/24/2016,16,10783,3115,4323,350,193,35,18799
6/24/2016,17,10787,3596,4719,245,136,35,19518
6/24/2016,18,10793,3629,4747,161,69,34,19433
6/24/2016,19,10797,3530,4933,136,20,34,19450
6/24/2016,20,10800,3023,4900,89,2,35,18849
6/24/2016,21,10794,2901,4710,88,0,35,18528
6/24/2016,22,10793,2531,4030,145,0,34,17533
6/24/2016,23,10793,1591,3678,210,0,30,16302
6/24/2016,24,10771,848,3834,291,0,15,15759
6/25/2016,1,10807,618,3694,262,0,3,15384
6/25/2016,2,10809,629,3621,228,0,3,15290
6/25/2016,3,10811,617,3300,204,0,3,14935
6/25/2016,4,10816,634,3200,186,0,2,14838
6/25/2016,5,10809,636,3177,112,0,2,14736
6/25/2016,6,10585,832,3345,114,6,2,14884
6/25/2016,7,10512,1312,3672,125,41,3,15665
6/25/2016,8,10576,1722,3638,47,104,5,16092
6/25/2016,9,10800,1836,3870,33,167,5,16711
6/25/2016,10,10794,1870,4169,60,211,5,17109
6/25/2016,11,10776,2151,4273,155,230,4,17589
6/25/2016,12,10773,2789,4286,160,230,10,18248
6/25/2016,13,10777,2969,4308,140,230,3,18427
6/25/2016,14,10790,2993,4327,251,228,3,18592
6/25/2016,15,10794,3218,4424,269,218,3,18926
6/25/2016,16,10795,3608,4378,306,183,3,19273
6/25/2016,17,10797,3445,4712,351,130,3,19438
6/25/2016,18,10795,3715,4762,477,68,3,19820
6/25/2016,19,10796,3889,4682,371,17,3,19758
6/25/2016,20,10780,3410,4530,396,3,3,19122
6/25/2016,21,10782,2908,4448,568,0,3,18709
6/25/2016,22,10779,2276,3788,945,0,3,17791
6/25/2016,23,10782,1396,3209,1382,0,5,16774
6/25/2016,24,10777,747,3364,1201,0,5,16094
6/26/2016,1,10776,612,3207,1377,0,3,15975
6/26/2016,2,10774,605,3004,1361,0,3,15747
6/26/2016,3,10773,605,2925,1117,0,2,15422
6/26/2016,4,10768,605,2950,715,0,2,15040
6/26/2016,5,10696,605,3013,703,1,3,15021
6/26/2016,6,10677,605,3149,507,13,3,14954
6/26/2016,7,10684,729,3426,634,37,3,15513
6/26/2016,8,10678,953,3567,1166,90,3,16457
6/26/2016,9,10676,1345,3847,1659,146,3,17676
6/26/2016,10,10673,1561,4089,1906,181,9,18419
6/26/2016,11,10667,1761,4131,2073,214,5,18851
6/26/2016,12,10643,2128,4568,2103,225,4,19671
6/26/2016,13,10617,2486,4579,2139,207,4,20032
6/26/2016,14,10609,2664,4653,2302,179,4,20411
6/26/2016,15,10563,2758,4637,2484,183,5,20630
6/26/2016,16,10678,2950,4844,2334,136,5,20947
6/26/2016,17,10678,3214,4867,2102,112,4,20977
6/26/2016,18,10686,3214,4980,1848,52,5,20785
6/26/2016,19,10678,2865,5273,1584,23,4,20427
6/26/2016,20,10674,2811,5270,1448,3,4,20210
6/26/2016,21,10682,3051,5153,1193,0,4,20083
6/26/2016,22,10681,3080,4510,1086,0,4,19361
6/26/2016,23,10705,1875,4244,1247,0,4,18075
6/26/2016,24,10708,952,3851,1387,0,4,16902
6/27/2016,1,10702,720,3751,1576,0,18,16767
6/27/2016,2,10694,688,3752,1538,0,16,16688
6/27/2016,3,10683,646,3528,1331,0,15,16203
6/27/2016,4,10685,624,3410,1486,0,16,16221
6/27/2016,5,10681,929,3337,1534,0,20,16501
6/27/2016,6,10688,1700,3304,1154,4,30,16880
6/27/2016,7,10686,2188,3908,1080,15,35,17912
6/27/2016,8,10680,2732,4223,848,44,35,18562
6/27/2016,9,10656,3805,4422,700,91,35,19709
6/27/2016,10,10654,4340,4372,644,127,35,20172
6/27/2016,11,10656,4728,4212,732,160,34,20522
6/27/2016,12,10646,4720,4077,1040,203,34,20720
6/27/2016,13,10646,4396,4138,1600,214,34,21028
6/27/2016,14,10635,3746,4134,2043,222,42,20822
6/27/2016,15,10645,3760,4240,2046,214,43,20948
6/27/2016,16,10652,3731,4633,1990,174,57,21237
6/27/2016,17,10672,4072,4818,1829,118,54,21563
6/27/2016,18,10691,4350,4758,1748,59,52,21658
6/27/2016,19,10700,3973,4839,1895,18,46,21471
6/27/2016,20,10701,3648,4701,1834,1,48,20933
6/27/2016,21,10698,3500,4760,1452,0,38,20448
6/27/2016,22,10700,3346,4147,1195,0,38,19426
6/27/2016,23,10705,1790,4087,1189,0,26,17797
6/27/2016,24,10710,1194,3701,1111,0,22,16738
6/28/2016,1,10712,1036,3130,1162,0,24,16064
6/28/2016,2,10717,854,2968,1092,0,20,15651
6/28/2016,3,10717,839,2863,926,0,21,15366
6/28/2016,4,10712,1025,3136,764,0,22,15659
6/28/2016,5,10704,1489,3368,628,1,25,16215
6/28/2016,6,10711,2067,3409,508,6,30,16731
6/28/2016,7,10713,2249,3858,389,36,32,17277
6/28/2016,8,10703,2279,3968,413,88,50,17501
6/28/2016,9,10691,2272,3853,462,140,82,17500
6/28/2016,10,10701,2237,3655,645,147,78,17463
6/28/2016,11,10703,2232,3550,974,159,77,17695
6/28/2016,12,10700,2274,4063,1131,160,79,18407
6/28/2016,13,10523,2241,4252,1442,142,80,18680
6/28/2016,14,10521,1880,3959,1543,183,80,18166
6/28/2016,15,10615,1876,4521,1616,130,80,18838
6/28/2016,16,10716,1772,4021,1646,132,80,18367
6/28/2016,17,10723,1898,3890,1495,118,81,18205
6/28/2016,18,10721,2012,4152,1308,58,79,18330
6/28/2016,19,10701,1959,4419,1132,21,80,18312
6/28/2016,20,10689,1879,4719,895,2,80,18264
6/28/2016,21,10700,1641,4424,789,0,30,17584
6/28/2016,22,10704,1512,3677,761,0,4,16658
6/28/2016,23,10714,1225,3169,734,0,4,15846
6/28/2016,24,10720,875,2912,775,0,4,15286
6/29/2016,1,10710,782,2816,663,0,4,14975
6/29/2016,2,10703,783,2731,638,0,4,14859
6/29/2016,3,10714,784,2672,632,0,5,14807
6/29/2016,4,10724,793,2706,725,0,6,14954
6/29/2016,5,10724,852,2830,721,0,19,15146
6/29/2016,6,10748,1000,3050,522,1,21,15342
6/29/2016,7,10742,1271,3360,570,18,22,15983
6/29/2016,8,10736,1584,3442,434,78,8,16282
6/29/2016,9,10724,1880,3507,362,135,5,16613
6/29/2016,10,10714,1939,3551,375,176,6,16761
6/29/2016,11,10717,2049,3799,389,157,11,17122
6/29/2016,12,10719,2305,3577,371,142,14,17128
6/29/2016,13,10571,2542,4120,426,159,9,17827
6/29/2016,14,10532,2580,4311,515,148,6,18092
6/29/2016,15,10706,2612,4059,475,188,7,18047
6/29/2016,16,10719,2731,3888,535,192,8,18073
6/29/2016,17,10718,2610,4520,580,137,0,18565
6/29/2016,18,10699,2783,4754,506,69,0,18811
6/29/2016,19,10700,3076,4615,433,20,7,18851
6/29/2016,20,10701,2741,4528,400,1,2,18373
6/29/2016,21,10719,2565,4294,395,0,0,17973
6/29/2016,22,10719,1796,4145,340,0,10,17010
6/29/2016,23,10725,1045,3770,294,0,12,15846
6/29/2016,24,10738,716,3453,245,0,7,15159
6/30/2016,1,10744,716,3163,258,0,15,14896
6/30/2016,2,10744,730,2728,364,0,19,14585
6/30/2016,3,10747,805,2571,351,0,22,14496
6/30/2016,4,10743,1035,2688,277,0,12,14755
6/30/2016,5,10735,1302,2765,477,2,0,15281
6/30/2016,6,10741,1540,2981,520,9,1,15792
6/30/2016,7,10734,1538,3391,438,40,0,16141
6/30/2016,8,10741,1540,3734,180,95,1,16291
6/30/2016,9,10741,1694,3995,86,151,2,16669
6/30/2016,10,10748,1996,4050,83,195,1,17073
6/30/2016,11,10748,2034,3897,140,219,2,17040
6/30/2016,12,10744,2335,3888,313,221,23,17524
6/30/2016,13,10748,2362,3727,495,212,49,17593
6/30/2016,14,10748,2438,3755,619,185,55,17800
6/30/2016,15,10748,2645,3922,767,202,54,18338
6/30/2016,16,10737,2715,3994,662,193,50,18351
6/30/2016,17,10712,2729,4572,609,125,50,18797
6/30/2016,18,10737,3065,4672,574,66,50,19164
6/30/2016,19,10749,2931,4497,532,16,70,18795
6/30/2016,20,10745,2451,4248,392,2,79,17917
6/30/2016,21,10746,2330,4230,490,0,54,17850
6/30/2016,22,10748,2045,3799,749,0,14,17355
6/30/2016,23,10726,975,3400,1069,0,0,16170
6/30/2016,24,10739,432,2949,1295,0,0,15415
7/1/2016,1,10762,342,2806,1262,0,0,15172
7/1/2016,2,10766,344,2644,1182,0,0,14936
7/1/2016,3,10767,346,2642,792,0,4,14551
7/1/2016,4,10765,347,2665,457,0,18,14252
7/1/2016,5,10763,346,2752,379,1,25,14266
7/1/2016,6,10740,343,2748,415,7,24,14277
7/1/2016,7,10720,345,2916,298,21,20,14320
7/1/2016,8,10688,346,3003,416,57,23,14533
7/1/2016,9,10669,345,3327,418,100,21,14880
7/1/2016,10,10668,347,3540,620,126,19,15320
7/1/2016,11,10689,346,3425,1253,80,20,15813
7/1/2016,12,10689,344,3263,1679,90,18,16083
7/1/2016,13,10678,345,3413,1816,88,6,16346
7/1/2016,14,10678,344,3525,1809,91,0,16447
7/1/2016,15,10681,344,3507,1678,128,0,16338
7/1/2016,16,10677,344,3612,1520,127,1,16281
7/1/2016,17,10665,344,3584,1833,102,0,16528
7/1/2016,18,10663,345,3774,1502,57,0,16341
7/1/2016,19,10681,345,3785,1762,18,0,16591
7/1/2016,20,10701,328,3775,1425,2,0,16231
7/1/2016,21,10707,228,3833,1181,0,0,15949
7/1/2016,22,10715,229,3696,918,0,0,15558
7/1/2016,23,10732,231,3361,873,0,0,15197
7/1/2016,24,10752,233,3041,696,0,0,14722
7/2/2016,1,10761,229,2895,561,0,1,14447
7/2/2016,2,10767,232,2708,579,0,0,14286
7/2/2016,3,10768,236,2669,334,0,0,14007
7/2/2016,4,10790,248,2699,377,0,0,14114
7/2/2016,5,10799,262,2626,373,1,0,14061
7/2/2016,6,10797,279,2656,251,6,0,13989
7/2/2016,7,10792,277,2674,342,36,0,14121
7/2/2016,8,10775,278,2852,535,101,0,14541
7/2/2016,9,10734,309,3142,510,174,0,14869
7/2/2016,10,10741,341,3291,573,205,0,15151
7/2/2016,11,10760,343,3485,652,215,1,15456
7/2/2016,12,10759,345,3516,744,192,0,15556
7/2/2016,13,10756,329,3589,867,166,3,15710
7/2/2016,14,10749,339,3639,912,163,4,15806
7/2/2016,15,10745,341,3708,1077,139,3,16013
7/2/2016,16,10740,340,3680,1302,114,3,16179
7/2/2016,17,10747,345,4137,1147,97,3,16476
7/2/2016,18,10761,346,4574,927,59,3,16670
7/2/2016,19,10769,422,4756,626,21,3,16597
7/2/2016,20,10768,473,4712,514,3,3,16473
7/2/2016,21,10770,426,4422,626,0,3,16247
7/2/2016,22,10765,366,4227,799,0,3,16160
7/2/2016,23,10772,348,3823,887,0,1,15831
7/2/2016,24,10777,350,2983,813,0,3,14926
7/3/2016,1,10780,350,2666,583,0,3,14382
7/3/2016,2,10762,350,2624,218,0,3,13957
7/3/2016,3,10495,349,2656,250,0,3,13753
7/3/2016,4,10468,351,2771,320,0,3,13913
7/3/2016,5,10473,350,2691,240,3,3,13760
7/3/2016,6,10250,354,2748,169,6,3,13530
7/3/2016,7,10165,360,2897,140,38,3,13603
7/3/2016,8,10386,412,3011,105,105,3,14022
7/3/2016,9,10649,500,3010,102,167,3,14431
7/3/2016,10,10746,653,3461,161,206,3,15230
7/3/2016,11,10750,1012,3583,248,218,3,15814
7/3/2016,12,10752,1319,3439,289,189,4,15992
7/3/2016,13,10764,1393,3449,295,195,4,16100
7/3/2016,14,10727,1407,3553,440,200,4,16331
7/3/2016,15,10765,1412,3843,438,196,4,16658
7/3/2016,16,10765,1427,4382,547,171,4,17296
7/3/2016,17,10766,1472,4442,566,131,4,17381
7/3/2016,18,10765,1565,4789,499,74,4,17696
7/3/2016,19,10765,1600,4999,388,24,4,17780
7/3/2016,20,10765,1133,4780,316,5,3,17002
7/3/2016,21,10758,989,4743,285,0,8,16783
7/3/2016,22,10754,1054,4246,313,0,6,16373
7/3/2016,23,10751,680,3969,383,0,3,15786
7/3/2016,24,10749,369,3301,373,0,3,14795
7/4/2016,1,10741,351,2741,381,0,3,14217
7/4/2016,2,10743,351,2870,368,0,4,14336
7/4/2016,3,10749,441,2885,331,0,9,14415
7/4/2016,4,10753,620,3031,291,1,15,14711
7/4/2016,5,10754,869,2785,259,1,35,14703
7/4/2016,6,10753,1141,2747,150,5,67,14863
7/4/2016,7,10756,1384,3058,158,36,92,15484
7/4/2016,8,10750,1634,3453,155,101,112,16205
7/4/2016,9,10744,2207,3659,262,169,147,17188
7/4/2016,10,10748,2131,4151,445,212,93,17780
7/4/2016,11,10747,1996,4266,524,227,95,17855
7/4/2016,12,10744,2068,3986,446,228,92,17564
7/4/2016,13,10741,2241,4397,370,228,81,18058
7/4/2016,14,10731,2544,4401,276,219,81,18252
7/4/2016,15,10722,2570,4808,229,206,81,18616
7/4/2016,16,10941,2989,4908,207,167,82,19294
7/4/2016,17,10954,3141,5129,209,105,45,19583
7/4/2016,18,10864,3106,5087,195,66,34,19352
7/4/2016,19,10928,3080,5156,172,20,35,19391
7/4/2016,20,10935,2933,4965,162,3,34,19032
7/4/2016,21,10933,2749,4417,181,0,35,18315
7/4/2016,22,10897,2136,3603,232,0,35,16903
7/4/2016,23,10937,1411,3294,211,0,26,15879
7/4/2016,24,11195,856,3083,246,0,19,15399
7/5/2016,1,11224,788,3094,336,0,16,15458
7/5/2016,2,11048,789,3028,301,0,16,15182
7/5/2016,3,11040,790,3176,325,0,16,15347
7/5/2016,4,11044,799,3202,325,0,37,15407
7/5/2016,5,11039,873,3239,339,0,76,15566
7/5/2016,6,11039,1138,3081,352,14,94,15718
7/5/2016,7,11111,1727,3188,256,36,111,16429
7/5/2016,8,11326,2197,3463,183,84,153,17406
7/5/2016,9,11322,2686,3695,134,137,128,18102
7/5/2016,10,11329,3177,3792,125,185,144,18752
7/5/2016,11,11442,3192,3753,223,208,151,18969
7/5/2016,12,11480,3505,4019,365,204,125,19698
7/5/2016,13,11482,3675,4068,571,224,124,20144
7/5/2016,14,11489,3603,4137,800,219,121,20369
7/5/2016,15,11469,3782,4134,970,205,122,20682
7/5/2016,16,11458,3835,4447,943,167,134,20984
7/5/2016,17,11456,4273,4679,781,127,133,21449
7/5/2016,18,11474,4498,4700,611,66,102,21451
7/5/2016,19,11477,4693,4725,397,18,49,21359
7/5/2016,20,11482,5047,4609,341,3,46,21528
7/5/2016,21,11484,4779,4481,392,0,42,21178
7/5/2016,22,11483,4529,3851,424,0,35,20322
7/5/2016,23,11493,3414,3420,356,1,28,18712
7/5/2016,24,11500,2002,3307,236,0,19,17064
7/6/2016,1,11522,1271,3320,272,0,16,16401
7/6/2016,2,11522,1024,3055,344,0,16,15961
7/6/2016,3,11514,947,3109,383,0,20,15973
7/6/2016,4,11514,960,3113,308,0,45,15940
7/6/2016,5,11511,1142,3155,222,1,113,16144
7/6/2016,6,11511,1455,3055,276,5,124,16426
7/6/2016,7,11493,1739,3319,365,37,129,17082
7/6/2016,8,11489,2477,3666,288,86,130,18136
7/6/2016,9,11485,3545,3755,347,127,132,19391
7/6/2016,10,11488,3313,4157,668,173,131,19930
7/6/2016,11,11502,3065,3808,901,182,108,19566
7/6/2016,12,11507,3877,3906,1025,184,127,20626
7/6/2016,13,11521,3934,4104,1175,209,128,21071
7/6/2016,14,11511,4259,4298,1209,207,128,21612
7/6/2016,15,11376,4964,4481,916,198,128,22063
7/6/2016,16,11442,5232,4606,826,161,133,22400
7/6/2016,17,11488,4674,4661,905,99,70,21897
7/6/2016,18,11479,4014,4463,898,50,43,20947
7/6/2016,19,11456,3779,4624,716,16,42,20633
7/6/2016,20,11454,4185,4704,527,3,42,20915
7/6/2016,21,11446,4926,4560,475,0,39,21446
7/6/2016,22,11449,4360,4186,569,0,38,20602
7/6/2016,23,11457,3228,3631,542,0,27,18885
7/6/2016,24,11473,1909,3297,502,0,22,17203
7/7/2016,1,11489,1379,3314,507,0,18,16707
7/7/2016,2,11502,1143,3035,529,0,18,16227
7/7/2016,3,11505,1011,3193,463,0,17,16189
7/7/2016,4,11492,1172,2959,459,0,18,16100
7/7/2016,5,11491,1399,3145,278,0,33,16346
7/7/2016,6,11495,1700,3212,173,2,63,16645
7/7/2016,7,11492,2567,3432,109,31,134,17765
7/7/2016,8,11483,3523,3519,97,68,162,18852
7/7/2016,9,11462,4097,3653,59,123,197,19591
7/7/2016,10,11456,4561,3785,86,171,149,20208
7/7/2016,11,11463,4900,4179,158,183,135,21018
7/7/2016,12,11475,5257,4079,261,191,139,21402
7/7/2016,13,11486,5127,4287,348,187,139,21574
7/7/2016,14,11500,4782,4373,469,204,146,21474
7/7/2016,15,11507,4502,4515,505,192,143,21364
7/7/2016,16,11512,4988,4797,387,140,137,21961
7/7/2016,17,11512,5232,4921,345,104,134,22248
7/7/2016,18,11516,5142,4806,196,49,114,21823
7/7/2016,19,11521,5082,4574,111,26,64,21378
7/7/2016,20,11528,5029,4512,97,2,49,21217
7/7/2016,21,11518,4761,4495,191,0,46,21011
7/7/2016,22,11527,4535,4095,256,0,45,20458
7/7/2016,23,11531,3382,3479,403,0,39,18834
7/7/2016,24,11542,1683,3231,507,0,32,16995
7/8/2016,1,11545,883,3123,580,0,26,16157
7/8/2016,2,11542,813,2905,931,0,28,16219
7/8/2016,3,11545,881,2811,835,0,32,16104
7/8/2016,4,11544,1135,2731,659,0,34,16103
7/8/2016,5,11534,1373,3110,531,0,41,16589
7/8/2016,6,11526,1652,3342,367,3,67,16957
7/8/2016,7,11520,1938,3506,225,19,115,17323
7/8/2016,8,11507,2203,3677,249,43,125,17804
7/8/2016,9,11504,2807,3864,256,79,127,18637
7/8/2016,10,11524,2976,3904,255,124,129,18912
7/8/2016,11,11534,3157,4158,245,142,123,19359
7/8/2016,12,11543,3231,4180,269,133,129,19485
7/8/2016,13,11544,3521,4109,283,139,129,19725
7/8/2016,14,11550,3768,3992,364,154,131,19959
7/8/2016,15,11539,3709,4111,498,134,132,20123
7/8/2016,16,11542,3694,4266,762,125,132,20521
7/8/2016,17,11534,3836,4511,711,91,132,20815
7/8/2016,18,11522,3656,4491,705,53,56,20483
7/8/2016,19,11495,3196,4505,757,16,36,20005
7/8/2016,20,11475,2993,4289,654,0,36,19447
7/8/2016,21,11489,3096,3863,652,0,36,19136
7/8/2016,22,11500,2397,3682,547,0,35,18161
7/8/2016,23,11522,1212,3313,602,0,6,16655
7/8/2016,24,11539,864,2854,806,0,3,16066
7/9/2016,1,11544,701,2834,733,0,3,15815
7/9/2016,2,11541,699,2834,658,0,3,15735
7/9/2016,3,11546,696,2623,714,0,3,15582
7/9/2016,4,11535,702,2658,409,0,3,15307
7/9/2016,5,11498,704,2711,292,1,3,15209
7/9/2016,6,11478,706,2693,269,2,3,15151
7/9/2016,7,11447,704,2745,611,9,3,15519
7/9/2016,8,11434,700,2954,1048,45,2,16183
7/9/2016,9,11416,704,3452,1207,125,6,16910
7/9/2016,10,11405,722,3557,1437,170,10,17301
7/9/2016,11,11401,695,3685,1484,198,16,17479
7/9/2016,12,11397,692,3768,1710,150,16,17733
7/9/2016,13,11405,673,3615,1802,134,20,17649
7/9/2016,14,11416,671,3721,1757,146,26,17737
7/9/2016,15,11399,662,3632,1862,121,26,17702
7/9/2016,16,11446,661,3805,1881,134,24,17951
7/9/2016,17,11471,664,3863,1918,93,23,18032
7/9/2016,18,11489,666,3882,1755,50,4,17846
7/9/2016,19,11501,668,4218,1287,23,0,17697
7/9/2016,20,11506,671,4103,1045,1,0,17326
7/9/2016,21,11515,674,3790,1024,0,0,17003
7/9/2016,22,11523,675,3217,936,0,0,16351
7/9/2016,23,11519,678,3013,607,0,0,15817
7/9/2016,24,11439,678,2738,274,0,0,15129
7/10/2016,1,11005,678,2794,317,0,0,14794
7/10/2016,2,10548,681,2711,408,0,0,14348
7/10/2016,3,10390,679,2701,480,0,0,14250
7/10/2016,4,10380,682,2752,394,0,0,14208
7/10/2016,5,10374,682,2723,238,1,1,14019
7/10/2016,6,10374,736,2761,220,6,0,14097
7/10/2016,7,10660,767,2954,244,28,0,14653
7/10/2016,8,11201,964,3108,168,76,0,15517
7/10/2016,9,11496,1173,2911,119,113,0,15812
7/10/2016,10,11492,1374,3067,185,148,0,16266
7/10/2016,11,11499,1509,3375,149,171,0,16703
7/10/2016,12,11515,1541,3929,169,158,0,17312
7/10/2016,13,11523,1638,4096,324,149,0,17730
7/10/2016,14,11525,1698,4193,399,178,0,17993
7/10/2016,15,11518,1748,4068,424,206,0,17964
7/10/2016,16,11514,1837,4218,425,153,0,18147
7/10/2016,17,11508,2229,4306,396,117,1,18557
7/10/2016,18,11504,2094,4455,309,70,1,18433
7/10/2016,19,11481,2030,4177,221,19,0,17928
7/10/2016,20,11471,1848,4393,142,3,0,17857
7/10/2016,21,11479,1856,4384,167,1,0,17887
7/10/2016,22,11495,2049,3543,155,1,0,17243
7/10/2016,23,11508,1044,3288,143,1,0,15984
7/10/2016,24,11524,704,2924,109,1,0,15262
7/11/2016,1,11535,668,2794,111,1,0,15109
7/11/2016,2,11468,668,2689,134,1,0,14960
7/11/2016,3,11258,677,2724,178,1,0,14838
7/11/2016,4,11259,684,2793,256,1,0,14993
7/11/2016,5,11323,813,2849,324,1,0,15310
7/11/2016,6,11548,897,2823,286,5,0,15559
7/11/2016,7,11550,988,3050,504,32,0,16124
7/11/2016,8,11541,1215,3029,481,82,0,16348
7/11/2016,9,11515,1458,3464,330,137,1,16905
7/11/2016,10,11481,2124,3581,325,178,1,17690
7/11/2016,11,11446,2543,3657,329,218,0,18193
7/11/2016,12,11431,2756,4256,300,216,0,18959
7/11/2016,13,11422,3273,4421,267,163,0,19546
7/11/2016,14,11423,3156,4399,269,159,0,19406
7/11/2016,15,11420,2871,4240,312,173,0,19016
7/11/2016,16,11423,2903,4232,460,144,0,19162
7/11/2016,17,11422,2922,4607,490,117,0,19558
7/11/2016,18,11425,2924,4440,563,61,2,19415
7/11/2016,19,11427,2926,4171,626,20,0,19170
7/11/2016,20,11411,2926,4128,779,2,0,19246
7/11/2016,21,11422,2926,4105,865,1,1,19320
7/11/2016,22,11445,2452,3336,745,0,0,17978
7/11/2016,23,11444,1584,3196,583,0,0,16807
7/11/2016,24,11445,1060,3056,294,0,0,15855
7/12/2016,1,11298,798,2846,224,0,0,15166
7/12/2016,2,10741,759,2834,259,0,0,14593
7/12/2016,3,10519,757,2824,313,0,0,14413
7/12/2016,4,10496,779,2918,607,0,1,14801
7/12/2016,5,10562,880,3022,665,0,1,15130
7/12/2016,6,10753,1188,3092,882,9,0,15924
7/12/2016,7,10900,1607,3316,929,24,0,16776
7/12/2016,8,11311,2050,3360,613,56,0,17390
7/12/2016,9,11338,2429,3623,578,140,0,18108
7/12/2016,10,11334,2780,3753,769,164,0,18800
7/12/2016,11,11329,2789,3713,927,185,2,18945
7/12/2016,12,11334,2871,3782,1299,218,14,19518
7/12/2016,13,11342,2976,3940,1689,227,38,20212
7/12/2016,14,11328,3072,4228,1712,208,67,20615
7/12/2016,15,11299,3097,4427,1804,202,73,20902
7/12/2016,16,11281,3182,4349,1898,164,80,20954
7/12/2016,17,11282,3069,4321,1935,113,80,20800
7/12/2016,18,11271,3065,4669,1748,61,36,20850
7/12/2016,19,11260,3216,5056,1237,18,33,20820
7/12/2016,20,11241,3558,4736,877,3,33,20448
7/12/2016,21,11225,3598,4415,1139,0,30,20407
7/12/2016,22,11218,3241,3850,1441,0,23,19773
7/12/2016,23,11109,2437,3801,1250,0,5,18602
7/12/2016,24,11053,1933,3548,865,0,4,17403
7/13/2016,1,11052,1116,3319,1037,0,4,16528
7/13/2016,2,10920,979,3014,1460,0,15,16388
7/13/2016,3,10754,887,2755,1527,0,22,15945
7/13/2016,4,10768,874,2870,1320,0,22,15854
7/13/2016,5,10774,1062,3241,1241,0,23,16341
7/13/2016,6,10768,1567,3288,1024,1,31,16679
7/13/2016,7,10759,2209,3472,807,31,39,17317
7/13/2016,8,10753,2950,3711,702,88,68,18272
7/13/2016,9,10741,3587,3900,587,94,127,19036
7/13/2016,10,10734,4187,3927,692,179,197,19916
7/13/2016,11,10730,4391,4187,949,203,199,20659
7/13/2016,12,10723,4791,4369,1220,199,150,21452
7/13/2016,13,10720,4938,4536,1379,219,104,21896
7/13/2016,14,10712,4663,4441,1412,216,111,21555
7/13/2016,15,10714,4645,4492,1324,218,107,21500
7/13/2016,16,10727,4814,4582,1409,185,73,21790
7/13/2016,17,10727,4693,4963,1263,132,54,21832
7/13/2016,18,10736,4585,4730,1076,71,56,21254
7/13/2016,19,10733,4680,4758,952,21,55,21199
7/13/2016,20,10734,4769,4459,1300,1,55,21318
7/13/2016,21,10732,4359,4231,1974,0,52,21348
7/13/2016,22,10736,3773,4044,2088,0,32,20673
7/13/2016,23,10741,3078,3508,2300,0,28,19655
7/13/2016,24,10752,1583,3381,2634,0,15,18365
7/14/2016,1,10760,944,3036,2293,0,11,17044
7/14/2016,2,10739,867,2789,2202,0,11,16608
7/14/2016,3,10746,878,2722,2125,0,14,16485
7/14/2016,4,10756,1057,2911,1726,0,17,16467
7/14/2016,5,10767,1504,2995,1544,0,18,16828
7/14/2016,6,10791,1979,3178,1750,1,44,17743
7/14/2016,7,10800,2550,3207,1635,2,93,18287
7/14/2016,8,10806,2991,3192,1723,18,134,18864
7/14/2016,9,10820,3013,3216,1416,48,144,18657
7/14/2016,10,10833,3009,3317,1695,77,148,19079
7/14/2016,11,10835,3018,3608,1817,65,176,19519
7/14/2016,12,10818,3018,4102,1929,86,147,20100
7/14/2016,13,10826,3015,4106,2102,103,115,20267
7/14/2016,14,10829,3072,3758,2376,145,76,20256
7/14/2016,15,10842,3183,3690,2562,169,56,20502
7/14/2016,16,10835,3269,3715,2813,167,52,20851
7/14/2016,17,10814,3270,4179,2727,130,27,21147
7/14/2016,18,10804,3279,4524,2781,71,37,21496
7/14/2016,19,10798,3297,4321,2595,20,47,21078
7/14/2016,20,10793,3330,4630,2216,2,49,21020
7/14/2016,21,10801,3292,4604,2133,0,46,20876
7/14/2016,22,10808,2923,3960,1773,0,38,19502
7/14/2016,23,10817,2511,3733,1277,0,17,18355
7/14/2016,24,10824,1426,3832,804,0,15,16901
7/15/2016,1,10813,896,3804,783,0,16,16312
7/15/2016,2,10829,794,2989,970,0,15,15597
7/15/2016,3,10845,778,2746,982,0,16,15367
7/15/2016,4,10853,779,2687,890,0,16,15225
7/15/2016,5,10863,857,2822,850,0,19,15411
7/15/2016,6,10864,1071,2943,991,4,47,15920
7/15/2016,7,10862,1509,3425,796,33,94,16719
7/15/2016,8,10855,1930,3699,894,89,180,17647
7/15/2016,9,10838,2302,3764,1105,135,205,18349
7/15/2016,10,10825,2436,4001,1428,151,204,19045
7/15/2016,11,10800,2528,4275,1611,128,209,19551
7/15/2016,12,10765,2460,4023,1717,161,209,19335
7/15/2016,13,10751,2416,3956,1515,183,212,19033
7/15/2016,14,10760,2443,3841,1453,147,213,18857
7/15/2016,15,10777,2614,4079,1474,172,211,19327
7/15/2016,16,10779,2569,4139,1364,153,211,19215
7/15/2016,17,10790,2581,4449,1201,134,197,19352
7/15/2016,18,10803,2576,4634,975,74,205,19267
7/15/2016,19,10808,2446,4391,819,24,194,18682
7/15/2016,20,10810,2229,4490,570,3,206,18308
7/15/2016,21,10830,1918,4189,469,0,170,17576
7/15/2016,22,10832,1784,3568,485,0,198,16867
7/15/2016,23,10856,910,3547,414,0,183,15910
7/15/2016,24,10866,742,2947,318,0,155,15028
7/16/2016,1,10882,744,2841,341,0,59,14867
7/16/2016,2,10833,743,2706,194,0,11,14487
7/16/2016,3,10373,750,2840,165,0,0,14128
7/16/2016,4,10297,750,2815,179,0,0,14041
7/16/2016,5,10296,746,2974,130,1,2,14149
7/16/2016,6,10300,765,2999,116,4,0,14184
7/16/2016,7,10296,839,3243,84,35,0,14497
7/16/2016,8,10360,921,3801,79,64,0,15225
7/16/2016,9,10795,924,3517,86,103,1,15426
7/16/2016,10,10875,1073,3790,68,125,0,15931
7/16/2016,11,10876,1093,3962,80,153,0,16164
7/16/2016,12,10875,1079,3848,114,151,0,16067
7/16/2016,13,10883,1123,4090,135,140,0,16371
7/16/2016,14,10842,1137,4001,163,111,0,16254
7/16/2016,15,10887,1134,4181,104,103,0,16409
7/16/2016,16,10892,1135,4383,100,94,0,16604
7/16/2016,17,10887,1135,4361,96,117,0,16596
7/16/2016,18,10911,1030,4936,99,72,0,17048
7/16/2016,19,10967,1092,5029,80,15,0,17183
7/16/2016,20,10977,1007,4578,72,3,0,16637
7/16/2016,21,10982,932,4368,85,0,0,16367
7/16/2016,22,10984,776,4091,135,0,0,15986
7/16/2016,23,11027,743,3269,135,0,0,15174
7/16/2016,24,11041,746,2728,119,0,0,14634
7/17/2016,1,10492,751,2753,214,0,0,14210
7/17/2016,2,10245,726,2698,256,0,0,13925
7/17/2016,3,10015,733,2729,232,0,0,13709
7/17/2016,4,9797,750,2650,327,0,0,13524
7/17/2016,5,9643,746,2692,262,1,0,13344
7/17/2016,6,9426,757,2694,263,4,0,13144
7/17/2016,7,9421,749,2875,497,35,0,13577
7/17/2016,8,9793,742,3255,367,101,4,14262
7/17/2016,9,10448,741,3439,316,168,3,15115
7/17/2016,10,10976,770,3330,472,210,0,15758
7/17/2016,11,11152,814,3454,705,217,2,16344
7/17/2016,12,11156,881,3539,1084,212,1,16873
7/17/2016,13,11151,1000,3486,1148,188,1,16974
7/17/2016,14,11142,1148,3306,1267,204,0,17067
7/17/2016,15,11127,1194,3428,1649,193,0,17591
7/17/2016,16,11153,1303,3880,1631,151,1,18119
7/17/2016,17,11206,1308,3891,2082,79,0,18566
7/17/2016,18,11224,1308,4076,2026,50,2,18686
7/17/2016,19,11220,1314,4124,1618,14,1,18291
7/17/2016,20,11218,1317,4040,1625,3,2,18205
7/17/2016,21,11211,1315,3550,2306,0,0,18382
7/17/2016,22,11204,988,3254,2526,0,0,17972
7/17/2016,23,11195,756,2871,2146,0,1,16969
7/17/2016,24,11177,726,2953,1164,0,17,16037
7/18/2016,1,11175,726,2820,765,0,19,15505
7/18/2016,2,11179,727,2810,594,0,20,15330
7/18/2016,3,11191,728,2774,538,0,20,15251
7/18/2016,4,11213,728,2751,710,0,20,15422
7/18/2016,5,11228,729,2813,1065,3,20,15858
7/18/2016,6,11232,810,2814,1893,4,26,16779
7/18/2016,7,11230,895,3380,2182,20,35,17742
7/18/2016,8,11220,1036,4124,1998,48,34,18460
7/18/2016,9,11208,1453,4632,1784,73,34,19184
7/18/2016,10,11181,1794,4592,1551,123,34,19275
7/18/2016,11,11181,2111,4325,1608,156,33,19414
7/18/2016,12,11174,2350,4611,1688,177,33,20033
7/18/2016,13,11168,2688,4526,1962,170,33,20547
7/18/2016,14,11187,2628,4335,1986,213,37,20386
7/18/2016,15,11212,2775,4427,1776,192,44,20426
7/18/2016,16,11226,3110,4786,1495,171,47,20835
7/18/2016,17,11223,3037,4859,1426,136,48,20729
7/18/2016,18,11232,2971,5231,1316,69,41,20860
7/18/2016,19,11246,3047,5012,1115,18,42,20480
7/18/2016,20,11255,3290,4838,770,2,36,20191
7/18/2016,21,11258,2996,4774,614,0,33,19675
7/18/2016,22,11257,2456,3743,803,0,32,18291
7/18/2016,23,11264,1312,3231,786,0,32,16625
7/18/2016,24,11277,824,3076,506,0,24,15707
7/19/2016,1,11286,735,2908,295,0,17,15241
7/19/2016,2,11241,736,2768,100,0,12,14857
7/19/2016,3,10812,738,2806,72,0,11,14439
7/19/2016,4,10691,740,2790,60,0,16,14297
7/19/2016,5,10694,743,2860,119,0,22,14438
7/19/2016,6,10968,746,3134,209,5,30,15092
7/19/2016,7,11236,829,3276,169,32,34,15576
7/19/2016,8,11237,1112,3508,135,83,33,16108
7/19/2016,9,11222,1364,3601,195,126,33,16541
7/19/2016,10,11228,1738,3724,241,158,34,17123
7/19/2016,11,11252,2071,3847,277,137,34,17618
7/19/2016,12,11256,2071,4020,306,165,35,17853
7/19/2016,13,11270,2041,4083,402,163,35,17994
7/19/2016,14,11281,2061,3855,476,168,35,17876
7/19/2016,15,11286,2101,4002,550,164,35,18138
7/19/2016,16,11292,2119,4247,627,168,36,18489
7/19/2016,17,11295,2178,4655,593,120,37,18878
7/19/2016,18,11298,2178,4877,548,74,35,19010
7/19/2016,19,11291,1896,4978,483,22,36,18706
7/19/2016,20,11290,1596,4786,305,2,36,18015
7/19/2016,21,11274,1634,4837,206,0,36,17987
7/19/2016,22,11269,1725,4187,168,0,36,17385
7/19/2016,23,11261,1046,3705,216,0,36,16264
7/19/2016,24,11257,780,3218,336,0,27,15618
7/20/2016,1,11249,784,2814,213,0,19,15079
7/20/2016,2,10978,787,2794,111,0,18,14688
7/20/2016,3,10665,788,2848,145,0,18,14464
7/20/2016,4,10629,789,2916,133,0,18,14485
7/20/2016,5,10661,790,3125,166,1,36,14779
7/20/2016,6,10950,792,3010,141,5,50,14948
7/20/2016,7,11225,864,2972,103,32,74,15270
7/20/2016,8,11246,982,3205,74,95,74,15676
7/20/2016,9,11229,1216,3251,62,136,67,15961
7/20/2016,10,11183,1709,3316,41,160,61,16470
7/20/2016,11,11159,1983,3376,36,200,70,16824
7/20/2016,12,11154,2192,3313,60,50,65,16834
7/20/2016,13,11024,2476,4045,153,211,47,17956
7/20/2016,14,11046,2531,4408,154,126,43,18308
7/20/2016,15,11147,2473,4355,190,162,41,18368
7/20/2016,16,11175,2553,4819,237,195,40,19019
7/20/2016,17,11170,2856,4999,262,141,39,19467
7/20/2016,18,11173,2799,5127,237,73,38,19447
7/20/2016,19,11172,2924,5043,214,20,37,19410
7/20/2016,20,11165,2836,4846,254,4,36,19141
7/20/2016,21,11171,2646,4550,412,2,36,18817
7/20/2016,22,11180,2041,4236,649,1,36,18143
7/20/2016,23,11212,1509,3298,844,0,41,16904
7/20/2016,24,11204,882,2775,653,0,61,15575
7/21/2016,1,10712,746,2709,598,0,63,14828
7/21/2016,2,10321,751,2731,746,0,62,14611
7/21/2016,3,10309,769,2693,595,0,62,14428
7/21/2016,4,10307,767,2776,513,0,61,14424
7/21/2016,5,10337,836,2777,471,1,66,14488
7/21/2016,6,10331,1007,2803,976,8,72,15197
7/21/2016,7,10413,1118,3101,1241,32,76,15981
7/21/2016,8,11068,1379,3495,942,83,77,17044
7/21/2016,9,11164,1700,4070,777,132,73,17916
7/21/2016,10,11176,2228,4262,766,167,70,18669
7/21/2016,11,11187,2553,4283,996,196,70,19285
7/21/2016,12,11189,2716,4570,1466,209,71,20221
7/21/2016,13,11193,2747,4657,1728,197,67,20589
7/21/2016,14,11191,2998,4859,1870,188,72,21178
7/21/2016,15,11195,3193,4794,1849,169,86,21286
7/21/2016,16,11198,3487,4811,1751,152,89,21488
7/21/2016,17,11200,3231,4963,1785,99,88,21366
7/21/2016,18,11193,3075,4641,1880,54,90,20933
7/21/2016,19,11168,3024,4787,1674,17,92,20762
7/21/2016,20,11124,3356,4617,2199,3,89,21388
7/21/2016,21,11105,3595,4547,2254,1,72,21574
7/21/2016,22,11108,3756,4152,1887,0,69,20972
7/21/2016,23,11119,2884,3708,1733,0,58,19502
7/21/2016,24,11137,2044,3574,1718,0,54,18527
7/22/2016,1,11149,1336,3144,1549,0,57,17235
7/22/2016,2,11146,1186,2982,1552,0,55,16921
7/22/2016,3,11152,1085,2893,1698,0,55,16883
7/22/2016,4,10788,1037,3039,1624,0,55,16543
7/22/2016,5,10790,1553,3306,1451,0,59,17159
7/22/2016,6,10797,2356,3031,1236,1,65,17486
7/22/2016,7,10803,3519,3309,754,17,69,18471
7/22/2016,8,10811,4425,3578,516,84,70,19484
7/22/2016,9,10815,4900,3760,555,109,70,20209
7/22/2016,10,10818,5082,4086,628,127,74,20815
7/22/2016,11,10814,5008,4112,610,133,75,20752
7/22/2016,12,10807,4811,4309,571,161,69,20728
7/22/2016,13,10808,4403,4377,713,162,69,20532
7/22/2016,14,10798,4193,4450,1071,184,69,20765
7/22/2016,15,10784,4077,4569,1359,173,71,21033
7/22/2016,16,10783,4383,4763,1366,176,68,21539
7/22/2016,17,10774,4556,4754,1330,130,73,21617
7/22/2016,18,10781,4417,4670,1137,69,71,21145
7/22/2016,19,10772,4543,4806,923,18,73,21135
7/22/2016,20,10763,4956,4761,755,3,67,21305
7/22/2016,21,10772,4968,4619,759,0,64,21182
7/22/2016,22,10776,4913,4150,839,0,60,20738
7/22/2016,23,10782,3527,3991,703,0,44,19047
7/22/2016,24,10707,2524,3699,618,0,40,17588
7/23/2016,1,9933,2137,3891,648,0,40,16649
7/23/2016,2,9923,1206,3730,684,0,39,15582
7/23/2016,3,9931,1043,3268,604,0,40,14886
7/23/2016,4,9939,1075,3292,412,0,40,14758
7/23/2016,5,9936,1368,3478,336,1,40,15159
7/23/2016,6,9933,1909,3406,312,2,40,15602
7/23/2016,7,9926,2365,3667,193,32,40,16223
7/23/2016,8,9915,2989,3712,79,81,40,16816
7/23/2016,9,9902,4012,3928,120,144,40,18146
7/23/2016,10,9901,5052,3919,201,183,40,19296
7/23/2016,11,9898,4959,3982,308,189,40,19376
7/23/2016,12,9902,5080,4120,368,170,40,19680
7/23/2016,13,10994,2430,4006,155,232,0,17817
7/23/2016,14,9905,5006,4626,440,175,40,20192
7/23/2016,15,9919,5145,4632,491,154,40,20381
7/23/2016,16,9932,5010,4872,400,147,40,20401
7/23/2016,17,9925,5110,4894,397,120,40,20486
7/23/2016,18,9933,5255,5055,324,73,40,20680
7/23/2016,19,9928,5291,4886,246,17,39,20407
7/23/2016,20,9933,5255,4508,225,2,40,19963
7/23/2016,21,9929,5031,4254,219,0,40,19473
7/23/2016,22,9938,4483,3877,226,0,40,18564
7/23/2016,23,9954,3827,3583,195,0,40,17599
7/23/2016,24,10208,2683,3169,272,0,40,16372
7/24/2016,1,10399,1415,3053,519,0,40,15426
7/24/2016,2,10387,980,3043,696,0,41,15147
7/24/2016,3,10348,939,2918,866,0,40,15111
7/24/2016,4,10389,842,3011,1054,0,41,15337
7/24/2016,5,10424,709,2772,1114,2,39,15060
7/24/2016,6,10429,705,2736,858,8,42,14778
7/24/2016,7,10436,814,2815,1094,30,44,15233
7/24/2016,8,10454,996,3166,1150,75,42,15883
7/24/2016,9,10452,1180,3324,1043,106,38,16143
7/24/2016,10,10471,1517,3541,958,128,44,16659
7/24/2016,11,10476,2214,3443,1011,179,47,17370
7/24/2016,12,10480,2593,4061,980,193,39,18346
7/24/2016,13,10479,2936,4169,868,189,38,18679
7/24/2016,14,10523,3337,4202,930,136,38,19166
7/24/2016,15,10633,2997,4336,980,108,37,19091
7/24/2016,16,10658,2926,4238,732,100,37,18691
7/24/2016,17,10704,2946,4521,666,59,37,18933
7/24/2016,18,10685,2986,4746,650,37,37,19141
7/24/2016,19,10658,2941,4713,605,17,37,18971
7/24/2016,20,10636,3276,4686,729,2,37,19366
7/24/2016,21,10636,3752,4331,796,1,37,19553
7/24/2016,22,10640,2911,4134,1077,1,36,18799
7/24/2016,23,10872,1587,3545,1435,1,41,17481
7/24/2016,24,10995,868,3379,1590,1,40,16873
7/25/2016,1,10987,700,2937,1646,1,55,16326
7/25/2016,2,10968,703,2697,1733,1,73,16175
7/25/2016,3,10964,697,2783,1403,1,72,15920
7/25/2016,4,10969,774,2771,1525,1,76,16116
7/25/2016,5,10970,1128,2798,1467,1,80,16444
7/25/2016,6,10988,1817,2894,1436,1,90,17226
7/25/2016,7,10990,2968,2974,1069,4,97,18102
7/25/2016,8,10989,3651,3525,769,9,98,19041
7/25/2016,9,11018,4219,3468,788,35,92,19620
7/25/2016,10,10991,4373,3770,797,97,97,20125
7/25/2016,11,10990,4397,3851,792,90,91,20211
7/25/2016,12,10992,4499,4232,781,69,89,20662
7/25/2016,13,10996,4543,4406,895,101,90,21031
7/25/2016,14,11018,4738,4573,968,132,86,21515
7/25/2016,15,11053,4513,4603,1187,161,79,21596
7/25/2016,16,10964,4160,4835,1210,156,73,21398
7/25/2016,17,10933,4261,4791,1197,116,79,21377
7/25/2016,18,10938,4591,4864,1125,67,78,21663
7/25/2016,19,10959,4545,4832,867,16,84,21303
7/25/2016,20,10989,4584,4699,685,3,85,21045
7/25/2016,21,10996,4611,4603,722,0,78,21010
7/25/2016,22,10992,4300,4160,807,0,67,20326
7/25/2016,23,10983,2831,3634,938,0,56,18442
7/25/2016,24,10968,1803,3017,1093,0,53,16934
7/26/2016,1,10972,1064,2770,1104,0,48,15958
7/26/2016,2,10974,889,2800,1217,0,49,15929
7/26/2016,3,10977,888,2744,1038,0,51,15698
7/26/2016,4,10972,898,2731,818,0,53,15472
7/26/2016,5,10961,1106,2949,722,0,55,15793
7/26/2016,6,10984,1620,2810,424,3,60,15901
7/26/2016,7,11008,2305,3352,295,29,67,17056
7/26/2016,8,11041,3444,3693,141,95,68,18482
7/26/2016,9,11080,3984,4004,87,165,69,19389
7/26/2016,10,11077,4200,4131,104,211,69,19792
7/26/2016,11,11066,4448,4204,137,208,69,20132
7/26/2016,12,11037,4611,4440,188,204,69,20549
7/26/2016,13,10994,2430,4006,155,232,0,17817
7/26/2016,14,10994,4906,4645,381,165,70,21161
7/26/2016,15,10994,5223,4626,491,176,88,21598
7/26/2016,16,10979,4956,4771,504,170,93,21473
7/26/2016,17,10980,5223,4879,470,136,93,21781
7/26/2016,18,10978,4940,4986,425,70,93,21492
7/26/2016,19,10966,4902,4910,349,18,93,21238
7/26/2016,20,10965,4887,4585,351,2,92,20882
7/26/2016,21,10954,5009,4229,388,0,89,20669
7/26/2016,22,10911,4432,3965,407,0,71,19786
7/26/2016,23,10878,3223,3524,504,0,57,18186
7/26/2016,24,10915,1988,3113,654,0,55,16725
7/27/2016,1,10929,1135,2931,820,0,56,15871
7/27/2016,2,10941,979,2922,846,0,55,15743
7/27/2016,3,10942,976,2964,775,0,55,15712
7/27/2016,4,10952,989,2960,694,0,55,15650
7/27/2016,5,10946,1148,3131,576,0,58,15859
7/27/2016,6,10959,1578,2909,537,3,63,16049
7/27/2016,7,10961,2290,3163,473,28,71,16986
7/27/2016,8,10961,3203,3702,288,89,71,18314
7/27/2016,9,10941,4143,3897,339,153,71,19544
7/27/2016,10,10914,4431,3827,441,199,71,19883
7/27/2016,11,10904,4940,3982,490,218,71,20605
7/27/2016,12,10886,5156,4179,536,224,71,21052
7/27/2016,13,10883,5177,4534,719,227,71,21611
7/27/2016,14,10917,4968,4809,782,226,74,21776
7/27/2016,15,10943,5111,4787,791,214,82,21928
7/27/2016,16,10967,4851,4795,659,175,90,21537
7/27/2016,17,10991,4930,4841,556,113,85,21516
7/27/2016,18,11008,4741,4978,412,41,88,21268
7/27/2016,19,11019,4435,4927,357,16,91,20845
7/27/2016,20,11008,4143,4950,593,1,87,20782
7/27/2016,21,10989,4848,4824,257,0,72,20990
7/27/2016,22,10990,5051,3928,196,0,70,20235
7/27/2016,23,10999,3918,3592,165,0,60,18734
7/27/2016,24,10979,2867,3362,122,0,57,17387
7/28/2016,1,10963,2348,3254,121,0,55,16741
7/28/2016,2,10967,1825,3232,109,0,54,16187
7/28/2016,3,10986,1636,2970,100,0,53,15745
7/28/2016,4,11001,1638,3167,114,0,54,15974
7/28/2016,5,11018,1788,3202,174,2,59,16243
7/28/2016,6,11043,2136,3075,264,3,62,16583
7/28/2016,7,11053,2557,3335,258,16,69,17288
7/28/2016,8,11054,3376,3708,123,64,70,18395
7/28/2016,9,11041,4407,3977,60,106,71,19662
7/28/2016,10,11037,5057,4142,41,142,72,20491
7/28/2016,11,11010,5390,4227,67,163,72,20929
7/28/2016,12,10995,5428,4394,114,147,72,21150
7/28/2016,13,10996,5409,4654,154,143,72,21428
7/28/2016,14,11003,5437,4831,180,87,79,21617
7/28/2016,15,11041,5513,4926,262,79,81,21902
7/28/2016,16,10993,5493,4971,313,83,79,21932
7/28/2016,17,10994,5065,5011,417,64,83,21634
7/28/2016,18,11024,4765,4960,514,39,47,21349
7/28/2016,19,11036,4622,4702,388,14,67,20829
7/28/2016,20,11030,4806,4662,427,4,79,21008
7/28/2016,21,11040,5181,4503,764,1,72,21561
7/28/2016,22,11046,4243,3951,833,1,72,20146
7/28/2016,23,11058,3257,3384,842,0,61,18602
7/28/2016,24,11071,2040,3275,894,0,57,17337
7/29/2016,1,11072,1468,2759,920,0,55,16274
7/29/2016,2,11086,1092,2701,779,0,55,15713
7/29/2016,3,11105,1184,2632,790,0,55,15766
7/29/2016,4,11103,1440,2697,401,0,56,15697
7/29/2016,5,11107,1635,2663,807,2,59,16273
7/29/2016,6,11227,1907,2900,776,6,63,16879
7/29/2016,7,11356,2253,2907,613,28,71,17228
7/29/2016,8,11369,2773,3108,396,89,71,17806
7/29/2016,9,11218,3319,3638,283,109,71,18638
7/29/2016,10,11300,3334,3742,222,131,71,18800
7/29/2016,11,11347,3514,3932,206,120,71,19190
7/29/2016,12,11314,3616,3956,308,125,72,19391
7/29/2016,13,11261,3693,4137,309,127,70,19597
7/29/2016,14,11212,3745,4301,297,127,69,19751
7/29/2016,15,11195,3616,4572,304,129,68,19884
7/29/2016,16,11174,3427,4668,467,119,67,19922
7/29/2016,17,11152,3327,4840,537,114,64,20034
7/29/2016,18,11151,3739,4849,449,68,63,20319
7/29/2016,19,11150,3724,4729,460,18,67,20148
7/29/2016,20,11155,3482,4690,480,2,63,19872
7/29/2016,21,11166,3385,4226,638,0,63,19478
7/29/2016,22,11173,2312,3802,778,0,61,18126
7/29/2016,23,11225,1495,3506,903,0,47,17176
7/29/2016,24,11394,829,3125,941,0,40,16329
7/30/2016,1,11440,533,3071,933,0,40,16017
7/30/2016,2,11587,475,2908,886,0,40,15896
7/30/2016,3,11676,479,2602,794,0,40,15591
7/30/2016,4,11679,479,2556,729,0,40,15483
7/30/2016,5,11663,479,2601,751,0,40,15534
7/30/2016,6,11652,477,2644,942,3,39,15757
7/30/2016,7,11636,474,2716,969,24,39,15858
7/30/2016,8,11621,487,2817,851,64,39,15879
7/30/2016,9,11610,531,2940,897,120,39,16137
7/30/2016,10,11605,750,3150,619,157,39,16320
7/30/2016,11,11605,918,3216,954,171,39,16903
7/30/2016,12,11619,1063,3731,896,196,40,17545
7/30/2016,13,11607,1282,3937,740,200,39,17805
7/30/2016,14,11602,1427,4102,608,199,40,17978
7/30/2016,15,11631,1240,4307,594,185,40,17997
7/30/2016,16,11534,1428,4018,659,103,39,17781
7/30/2016,17,11582,1446,4370,617,61,39,18115
7/30/2016,18,11708,1438,4323,585,35,39,18128
7/30/2016,19,11722,1442,3924,563,12,39,17702
7/30/2016,20,11714,1448,4065,527,2,39,17795
7/30/2016,21,11713,1455,3982,614,1,39,17804
7/30/2016,22,11733,1065,3739,738,1,39,17315
7/30/2016,23,11739,556,3498,690,0,39,16522
7/30/2016,24,11753,471,3108,694,0,39,16065
7/31/2016,1,11751,475,2792,642,0,38,15698
7/31/2016,2,11753,475,2619,430,0,38,15315
7/31/2016,3,11610,474,2600,257,0,38,14979
7/31/2016,4,11433,474,2521,258,0,38,14724
7/31/2016,5,11163,475,2579,457,1,38,14713
7/31/2016,6,11162,472,2607,486,2,38,14767
7/31/2016,7,11236,469,2657,427,8,38,14835
7/31/2016,8,11601,473,2718,416,27,38,15273
7/31/2016,9,11768,474,3040,290,67,38,15677
7/31/2016,10,11772,573,3142,161,70,38,15756
7/31/2016,11,11768,978,3307,175,107,39,16374
7/31/2016,12,11764,1314,3233,144,77,39,16571
7/31/2016,13,11755,1514,3323,271,96,39,16998
7/31/2016,14,11710,1585,3594,304,128,39,17360
7/31/2016,15,11750,1875,3837,281,123,39,17905
7/31/2016,16,11752,2065,3847,317,66,40,18087
7/31/2016,17,11758,1941,4149,334,37,39,18258
7/31/2016,18,11758,1830,3877,392,39,39,17935
7/31/2016,19,11757,1291,4033,366,14,39,17500
7/31/2016,20,11750,1201,4321,354,2,40,17668
7/31/2016,21,11836,1042,4157,291,0,39,17365
7/31/2016,22,11863,966,3878,248,0,39,16994
7/31/2016,23,11856,570,3566,202,0,39,16233
7/31/2016,24,11863,469,3472,219,0,39,16062
8/1/2016,1,11866,470,3109,225,0,39,15709
8/1/2016,2,11750,472,2719,167,0,40,15148
8/1/2016,3,11578,470,2563,182,0,39,14832
8/1/2016,4,11579,471,2560,152,0,35,14797
8/1/2016,5,11570,478,2584,197,1,35,14865
8/1/2016,6,11569,487,2618,188,3,35,14900
8/1/2016,7,11565,579,2699,190,12,35,15080
8/1/2016,8,11700,732,2829,183,47,35,15526
8/1/2016,9,11820,885,3168,172,86,35,16166
8/1/2016,10,11823,1062,3681,124,142,35,16867
8/1/2016,11,11828,1293,3569,151,134,35,17010
8/1/2016,12,11830,1474,3726,154,142,35,17361
8/1/2016,13,11859,1659,3635,162,121,35,17471
8/1/2016,14,11852,1896,3973,150,107,35,18013
8/1/2016,15,11842,2284,3972,188,130,35,18451
8/1/2016,16,11830,2555,4081,250,144,35,18895
8/1/2016,17,11824,2585,4406,248,111,35,19209
8/1/2016,18,11819,2563,4556,285,67,35,19325
8/1/2016,19,11824,2593,4870,233,17,35,19572
8/1/2016,20,11824,2517,4731,186,1,35,19294
8/1/2016,21,11823,2685,4348,226,0,35,19117
8/1/2016,22,11826,2527,3760,191,0,35,18339
8/1/2016,23,11848,1495,3557,112,0,35,17047
8/1/2016,24,11889,677,3229,119,0,35,15949
8/2/2016,1,11891,517,2703,106,0,37,15254
8/2/2016,2,11896,530,2640,77,0,38,15181
8/2/2016,3,11900,514,2742,90,0,38,15284
8/2/2016,4,11901,553,2593,83,0,51,15181
8/2/2016,5,11676,573,2881,115,1,59,15305
8/2/2016,6,11604,773,2896,231,4,67,15575
8/2/2016,7,11760,1310,2834,346,21,71,16342
8/2/2016,8,11901,1543,3027,285,79,70,16905
8/2/2016,9,11874,2023,3865,110,133,70,18075
8/2/2016,10,11887,2690,4118,97,163,70,19025
8/2/2016,11,11890,3113,4117,156,174,70,19520
8/2/2016,12,11903,3452,3891,206,177,71,19700
8/2/2016,13,10994,2430,4006,155,232,0,17817
8/2/2016,14,11873,4107,3984,385,149,71,20569
8/2/2016,15,11865,4116,4209,368,153,78,20789
8/2/2016,16,11855,3809,4489,371,126,82,20732
8/2/2016,17,11851,3721,4697,265,113,84,20731
8/2/2016,18,11849,3940,4758,190,61,75,20873
8/2/2016,19,11852,3910,4805,149,17,76,20809
8/2/2016,20,11849,4054,4342,186,0,75,20506
8/2/2016,21,11859,3258,3844,231,0,77,19269
8/2/2016,22,11865,2734,3347,301,0,71,18318
8/2/2016,23,11876,1690,3194,297,0,61,17118
8/2/2016,24,11889,1113,3001,233,0,58,16294
8/3/2016,1,11900,968,2994,212,0,55,16129
8/3/2016,2,11927,735,2817,209,0,55,15743
8/3/2016,3,11915,739,2581,196,0,55,15486
8/3/2016,4,11933,735,2500,156,0,53,15377
8/3/2016,5,11928,847,2555,112,0,61,15503
8/3/2016,6,11934,1132,2549,169,5,67,15856
8/3/2016,7,11933,1576,2908,225,23,70,16735
8/3/2016,8,11931,2238,3178,145,69,71,17632
8/3/2016,9,11915,3197,3486,81,133,71,18883
8/3/2016,10,11905,3775,3763,109,166,69,19787
8/3/2016,11,11897,4231,4023,142,180,67,20540
8/3/2016,12,11895,4454,4142,148,163,67,20869
8/3/2016,13,10994,2430,4006,155,232,0,17817
8/3/2016,14,11772,4624,4034,187,178,77,20872
8/3/2016,15,11854,4295,4114,213,173,88,20737
8/3/2016,16,11845,3950,4557,230,156,93,20831
8/3/2016,17,11854,3921,4492,212,128,93,20700
8/3/2016,18,11915,4032,4555,186,68,92,20848
8/3/2016,19,11920,4246,4460,112,16,96,20850
8/3/2016,20,11920,3982,4438,96,1,92,20529
8/3/2016,21,11931,3464,4143,149,0,82,19769
8/3/2016,22,11936,3255,3623,197,0,68,19079
8/3/2016,23,11456,3146,3333,237,0,59,18231
8/3/2016,24,11119,2435,2993,260,0,54,16861
8/4/2016,1,11144,1591,3036,347,0,50,16168
8/4/2016,2,11156,1123,3003,381,0,51,15714
8/4/2016,3,11158,1150,2967,396,0,52,15723
8/4/2016,4,11169,1123,2867,368,0,52,15579
8/4/2016,5,11168,1463,2839,437,0,57,15964
8/4/2016,6,11168,2131,2611,576,4,65,16555
8/4/2016,7,11161,2653,2869,498,25,69,17275
8/4/2016,8,11156,2905,3053,390,88,69,17661
8/4/2016,9,11137,3728,3313,285,153,70,18686
8/4/2016,10,11089,4538,3683,232,206,70,19818
8/4/2016,11,11118,4296,3942,240,228,78,19902
8/4/2016,12,11103,4312,3898,243,229,78,19863
8/4/2016,13,11048,4462,3945,323,228,69,20075
8/4/2016,14,11051,4431,4027,410,208,89,20216
8/4/2016,15,11053,4233,4229,520,188,96,20319
8/4/2016,16,11073,4492,4510,577,170,93,20915
8/4/2016,17,11095,4376,4758,581,113,93,21016
8/4/2016,18,11088,4130,4696,564,54,92,20624
8/4/2016,19,11087,3912,4525,546,14,93,20177
8/4/2016,20,11076,3865,4202,637,2,85,19867
8/4/2016,21,11048,3891,3901,965,2,81,19888
8/4/2016,22,11051,3509,3531,1385,0,73,19549
8/4/2016,23,11067,2518,3188,1675,0,60,18508
8/4/2016,24,11061,1486,2661,1884,0,54,17146
8/5/2016,1,11062,891,2622,2084,0,54,16713
8/5/2016,2,11047,810,2761,1976,0,55,16649
8/5/2016,3,11040,820,3063,1835,0,54,16812
8/5/2016,4,11052,1027,3028,1685,0,54,16846
8/5/2016,5,11016,1334,2797,1629,1,59,16836
8/5/2016,6,10996,1956,2482,1367,2,65,16868
8/5/2016,7,10992,2704,2712,1234,21,71,17734
8/5/2016,8,10978,3079,3213,1215,68,71,18624
8/5/2016,9,10969,4124,3595,1162,141,66,20057
8/5/2016,10,10950,4457,3848,1341,174,77,20847
8/5/2016,11,10956,4293,3910,1714,175,83,21131
8/5/2016,12,10966,3980,4061,2076,180,97,21360
8/5/2016,13,10994,2430,4006,155,232,0,17817
8/5/2016,14,10935,3428,3945,2023,202,100,20633
8/5/2016,15,10917,3502,3987,1706,182,99,20393
8/5/2016,16,10914,3720,4341,1888,134,98,21095
8/5/2016,17,10926,3713,4675,1585,86,97,21082
8/5/2016,18,10988,4075,4646,1400,29,100,21238
8/5/2016,19,10979,4395,4428,1342,19,96,21259
8/5/2016,20,10981,4614,4026,1202,3,75,20901
8/5/2016,21,10998,4695,3930,1095,1,74,20793
8/5/2016,22,10532,4306,3633,1078,0,72,19621
8/5/2016,23,10211,2803,3382,1260,0,59,17715
8/5/2016,24,10217,1751,2972,1258,0,48,16246
8/6/2016,1,10222,1230,3032,1235,0,35,15754
8/6/2016,2,10223,1016,2885,1136,0,35,15295
8/6/2016,3,10230,796,2900,929,0,35,14890
8/6/2016,4,10235,776,2859,895,0,35,14800
8/6/2016,5,10242,878,2953,970,1,35,15079
8/6/2016,6,10259,934,2657,908,5,35,14798
8/6/2016,7,10267,1049,2638,635,21,35,14645
8/6/2016,8,10278,1375,2809,643,77,35,15217
8/6/2016,9,10285,2267,3092,620,135,35,16434
8/6/2016,10,10299,2875,3480,609,179,35,17477
8/6/2016,11,10334,2963,3598,688,186,35,17804
8/6/2016,12,10417,3108,3678,716,173,35,18127
8/6/2016,13,10484,3122,3773,796,176,35,18386
8/6/2016,14,10473,3137,3878,840,187,35,18550
8/6/2016,15,10436,2991,4076,826,170,35,18534
8/6/2016,16,10462,3062,4473,737,153,35,18922
8/6/2016,17,10456,3560,4582,736,109,35,19478
8/6/2016,18,10433,4105,4386,688,63,35,19710
8/6/2016,19,10426,3821,4268,612,15,35,19177
8/6/2016,20,10541,3152,4167,464,1,35,18360
8/6/2016,21,10796,2360,3972,520,0,35,17683
8/6/2016,22,10878,1892,3605,576,0,35,16986
8/6/2016,23,10884,1417,3305,666,0,35,16307
8/6/2016,24,10897,944,2867,649,0,35,15392
8/7/2016,1,10916,798,2773,674,0,35,15196
8/7/2016,2,10940,812,2750,792,0,35,15329
8/7/2016,3,10932,807,2546,700,0,35,15020
8/7/2016,4,10947,793,2471,713,0,35,14959
8/7/2016,5,10756,768,2511,565,1,36,14637
8/7/2016,6,10825,779,2597,410,1,35,14647
8/7/2016,7,10870,772,2745,533,27,35,14982
8/7/2016,8,11119,767,2873,514,90,35,15398
8/7/2016,9,11201,804,3319,485,161,35,16005
8/7/2016,10,11204,857,3426,452,209,35,16183
8/7/2016,11,11197,997,3642,482,202,35,16555
8/7/2016,12,11194,1258,3688,591,193,35,16959
8/7/2016,13,10994,2430,4006,155,232,0,17817
8/7/2016,14,11189,1605,3785,885,196,35,17695
8/7/2016,15,11202,1766,3779,1008,199,35,17989
8/7/2016,16,11207,2227,3964,999,181,35,18613
8/7/2016,17,11205,2420,4317,866,124,35,18967
8/7/2016,18,11204,2542,4305,686,53,35,18825
8/7/2016,19,11203,2234,4472,505,16,35,18465
8/7/2016,20,11182,2224,4168,380,1,35,17990
8/7/2016,21,11170,2110,4044,340,0,35,17699
8/7/2016,22,11191,1756,3593,348,0,35,16923
8/7/2016,23,11203,1102,3399,401,0,44,16149
8/7/2016,24,11241,903,3067,428,0,48,15687
8/8/2016,1,11286,870,2813,385,0,47,15401
8/8/2016,2,11311,869,2628,397,0,47,15252
8/8/2016,3,11330,870,2460,377,0,48,15085
8/8/2016,4,11352,877,2468,347,0,51,15095
8/8/2016,5,11332,889,2552,460,1,56,15290
8/8/2016,6,11312,930,2619,559,3,57,15480
8/8/2016,7,11304,1241,3092,546,27,65,16275
8/8/2016,8,11284,1803,3210,230,93,65,16685
8/8/2016,9,11258,2320,3360,75,162,65,17240
8/8/2016,10,11243,2902,3632,52,212,65,18106
8/8/2016,11,11212,3292,3716,58,200,68,18546
8/8/2016,12,11200,3175,3867,117,180,66,18605
8/8/2016,13,11182,3126,3859,226,186,66,18645
8/8/2016,14,11170,3377,3942,328,196,66,19079
8/8/2016,15,11190,3804,3922,450,206,66,19638
8/8/2016,16,11245,3731,4276,475,175,66,19968
8/8/2016,17,11290,4037,4494,417,136,70,20444
8/8/2016,18,11321,4200,4276,408,66,78,20349
8/8/2016,19,11327,4234,4276,349,15,71,20272
8/8/2016,20,11321,3771,4159,343,2,66,19662
8/8/2016,21,11314,3406,4082,432,1,66,19301
8/8/2016,22,11308,2651,3211,543,1,66,17780
8/8/2016,23,11292,1924,3044,466,1,57,16784
8/8/2016,24,11284,1346,2678,685,1,52,16046
8/9/2016,1,11300,976,2623,792,1,48,15740
8/9/2016,2,11294,945,2451,1128,1,47,15866
8/9/2016,3,11288,944,2407,1070,1,48,15758
8/9/2016,4,11286,944,2539,807,1,49,15626
8/9/2016,5,11263,964,2733,1040,2,56,16058
8/9/2016,6,11238,1056,2824,1150,7,62,16337
8/9/2016,7,11242,1228,3067,1101,27,65,16730
8/9/2016,8,11228,1668,3271,688,85,67,17007
8/9/2016,9,11261,2439,3751,380,149,66,18046
8/9/2016,10,11275,3112,3631,293,211,67,18589
8/9/2016,11,11318,3391,3876,301,224,67,19177
8/9/2016,12,11322,3679,3954,353,228,67,19603
8/9/2016,13,11331,4167,4157,442,221,67,20385
8/9/2016,14,11337,4665,3985,454,218,72,20731
8/9/2016,15,11327,4630,4150,390,204,74,20775
8/9/2016,16,11299,4704,4123,282,148,71,20627
8/9/2016,17,11236,4437,4001,240,90,69,20073
8/9/2016,18,11222,4025,3941,255,48,69,19560
8/9/2016,19,11204,4010,4042,190,17,70,19533
8/9/2016,20,11180,4412,4027,248,1,76,19944
8/9/2016,21,11175,4309,4010,322,1,87,19904
8/9/2016,22,11151,4008,3760,426,0,81,19426
8/9/2016,23,11160,3190,3411,503,0,62,18326
8/9/2016,24,11163,2254,3360,567,0,67,17411
8/10/2016,1,11163,1916,3160,625,0,54,16918
8/10/2016,2,11167,1860,3147,616,0,47,16837
8/10/2016,3,11174,1944,3140,483,0,51,16792
8/10/2016,4,11172,1914,3150,315,0,50,16601
8/10/2016,5,11161,1853,3006,246,1,54,16321
8/10/2016,6,11151,2123,3025,209,3,64,16575
8/10/2016,7,11139,2541,3128,202,10,68,17088
8/10/2016,8,11137,3505,3412,96,47,67,18264
8/10/2016,9,11147,4210,3645,51,89,67,19209
8/10/2016,10,11153,4698,3719,74,113,68,19825
8/10/2016,11,11153,5159,3734,95,141,69,20351
8/10/2016,12,11156,5110,3676,175,176,73,20366
8/10/2016,13,11148,5115,3692,291,195,73,20514
8/10/2016,14,11135,5094,3987,331,203,87,20837
8/10/2016,15,11124,5069,4366,347,212,98,21216
8/10/2016,16,11114,5602,4405,276,164,98,21659
8/10/2016,17,11113,5754,4372,201,108,98,21646
8/10/2016,18,11141,5761,4334,222,46,97,21601
8/10/2016,19,11124,5861,4258,218,14,98,21573
8/10/2016,20,11099,5590,4395,318,2,97,21501
8/10/2016,21,11082,6083,4131,248,0,94,21638
8/10/2016,22,11092,5568,3754,127,0,85,20626
8/10/2016,23,10648,4910,3473,145,0,75,19251
8/10/2016,24,10297,4589,3043,164,1,77,18171
8/11/2016,1,10310,3921,2881,176,0,78,17366
8/11/2016,2,10301,3404,2891,180,0,83,16859
8/11/2016,3,10283,2932,2878,155,0,90,16338
8/11/2016,4,10267,2800,2812,171,0,89,16139
8/11/2016,5,10263,2974,2793,190,3,69,16292
8/11/2016,6,10263,3385,2887,229,5,69,16838
8/11/2016,7,10251,4230,2902,236,20,78,17717
8/11/2016,8,10206,5016,3015,192,74,78,18581
8/11/2016,9,9861,5765,3582,205,142,83,19638
8/11/2016,10,9857,6462,3547,296,187,85,20434
8/11/2016,11,9878,6319,3740,488,205,87,20717
8/11/2016,12,9871,6342,3905,544,214,80,20956
8/11/2016,13,9848,6530,4192,589,223,87,21469
8/11/2016,14,9831,6243,4266,756,189,84,21369
8/11/2016,15,9836,6396,4103,838,180,83,21436
8/11/2016,16,9822,5977,4465,749,144,83,21240
8/11/2016,17,9841,6376,4589,957,93,82,21938
8/11/2016,18,9840,6775,4733,829,35,81,22293
8/11/2016,19,9851,6692,4561,887,11,80,22082
8/11/2016,20,9851,6556,4321,934,2,78,21742
8/11/2016,21,9847,6509,3781,1119,1,75,21332
8/11/2016,22,9839,5563,3527,1541,0,76,20546
8/11/2016,23,9835,5024,3449,1600,0,57,19965
8/11/2016,24,9816,4377,3008,1931,0,55,19187
8/12/2016,1,9806,3837,2896,1880,0,64,18483
8/12/2016,2,9786,3780,2813,2022,2,69,18472
8/12/2016,3,9765,3512,2702,1977,3,69,18028
8/12/2016,4,9770,3618,2659,2009,3,72,18131
8/12/2016,5,9775,3911,2647,1906,4,72,18315
8/12/2016,6,9782,4141,2709,1725,6,75,18438
8/12/2016,7,9795,4757,3023,1593,18,84,19270
8/12/2016,8,9801,5243,3199,1479,61,84,19867
8/12/2016,9,9802,5711,3381,1497,132,84,20607
8/12/2016,10,9799,5883,3652,1596,159,89,21178
8/12/2016,11,9824,6184,3674,1754,195,104,21735
8/12/2016,12,9827,6075,3826,1804,187,106,21825
8/12/2016,13,9844,6561,4204,1676,205,106,22596
8/12/2016,14,9850,6672,4277,1608,147,105,22659
8/12/2016,15,9844,6603,4239,1623,158,105,22572
8/12/2016,16,9830,6505,4469,1460,171,97,22532
8/12/2016,17,9826,6705,4271,1440,114,95,22451
8/12/2016,18,9831,6323,4331,997,41,96,21619
8/12/2016,19,9848,6197,4154,591,8,93,20891
8/12/2016,20,9857,6405,4111,398,1,85,20857
8/12/2016,21,9823,6400,3648,336,2,84,20293
8/12/2016,22,9134,6267,3486,375,0,84,19346
8/12/2016,23,9145,5277,3376,347,0,64,18209
8/12/2016,24,9170,4696,3275,271,0,49,17461
8/13/2016,1,9185,4422,2894,330,0,47,16878
8/13/2016,2,9196,4088,2818,406,0,47,16555
8/13/2016,3,9201,3684,2630,505,0,47,16067
8/13/2016,4,9216,3406,2722,568,0,47,15959
8/13/2016,5,9512,3718,2857,561,0,47,16695
8/13/2016,6,9560,3470,2684,670,2,47,16433
8/13/2016,7,9528,3493,2701,725,8,47,16502
8/13/2016,8,9511,3633,2804,1138,31,46,17163
8/13/2016,9,9491,4039,3302,1492,56,46,18426
8/13/2016,10,9626,4328,3559,1966,100,46,19625
8/13/2016,11,9653,4023,3733,2047,132,46,19634
8/13/2016,12,9662,4510,3983,1912,158,46,20271
8/13/2016,13,9664,4653,3676,2028,178,46,20245
8/13/2016,14,9662,3786,3702,2185,164,46,19545
8/13/2016,15,10086,3333,3742,2231,134,46,19572
8/13/2016,16,10264,3240,3686,2467,99,46,19802
8/13/2016,17,10383,3404,4299,2160,41,46,20333
8/13/2016,18,10406,3274,3999,1855,22,47,19603
8/13/2016,19,10443,3097,4128,1685,5,48,19406
8/13/2016,20,10443,3108,4078,1409,1,47,19086
8/13/2016,21,10561,3145,3690,1161,0,47,18604
8/13/2016,22,10626,2692,3482,1246,0,47,18093
8/13/2016,23,10738,1955,3129,1302,0,47,17171
8/13/2016,24,10863,1375,2812,1041,0,47,16138
8/14/2016,1,10968,1007,3101,732,0,47,15855
8/14/2016,2,10982,925,3001,694,0,49,15651
8/14/2016,3,11017,918,2764,539,0,47,15285
8/14/2016,4,11033,921,2834,374,0,47,15209
8/14/2016,5,11070,928,2746,321,2,47,15114
8/14/2016,6,11094,963,2619,255,2,47,14980
8/14/2016,7,11099,1214,2626,164,20,47,15170
8/14/2016,8,11105,1429,2928,266,51,47,15826
8/14/2016,9,11125,1911,3446,431,116,47,17076
8/14/2016,10,11132,2461,3655,423,136,47,17854
8/14/2016,11,11136,3019,3775,365,152,47,18494
8/14/2016,12,11143,3160,3802,346,158,48,18657
8/14/2016,13,11153,3333,3579,398,156,48,18667
8/14/2016,14,11103,3370,3803,475,142,47,18940
8/14/2016,15,11129,3380,3821,436,121,47,18934
8/14/2016,16,11152,3327,4031,390,101,48,19049
8/14/2016,17,11152,3282,4293,309,70,48,19154
8/14/2016,18,11146,3347,4254,217,43,47,19054
8/14/2016,19,11164,3139,4185,136,14,47,18685
8/14/2016,20,11175,3121,4066,70,1,47,18480
8/14/2016,21,11177,3381,3586,35,0,47,18226
8/14/2016,22,11206,3084,3363,44,0,47,17744
8/14/2016,23,11268,1920,3070,99,0,61,16418
8/14/2016,24,11281,1143,2633,98,0,67,15222
8/15/2016,1,11295,895,2762,59,0,68,15079
8/15/2016,2,11297,853,2803,48,0,88,15089
8/15/2016,3,11306,883,2751,57,0,114,15111
8/15/2016,4,11319,958,2811,34,0,109,15231
8/15/2016,5,11304,1321,2808,47,1,111,15592
8/15/2016,6,11288,1837,2460,45,2,118,15750
8/15/2016,7,11254,2615,2597,95,23,139,16723
8/15/2016,8,11235,3036,2837,104,61,145,17418
8/15/2016,9,11255,3400,3231,59,101,147,18193
8/15/2016,10,11253,3967,3480,94,123,133,19050
8/15/2016,11,11240,4499,3435,122,136,125,19557
8/15/2016,12,11234,4414,3525,192,155,125,19645
8/15/2016,13,10994,2430,4006,155,232,0,17817
8/15/2016,14,11233,4182,4046,438,157,126,20182
8/15/2016,15,11288,4510,3962,483,144,124,20511
8/15/2016,16,11310,4179,4440,368,122,123,20542
8/15/2016,17,11283,4060,4428,226,60,124,20181
8/15/2016,18,11253,4044,4317,192,36,126,19968
8/15/2016,19,11237,4033,4171,166,9,126,19742
8/15/2016,20,11279,4016,3904,208,0,126,19533
8/15/2016,21,11341,3800,3487,280,0,125,19033
8/15/2016,22,11371,3524,3116,398,0,124,18533
8/15/2016,23,11409,2527,2796,357,0,114,17203
8/15/2016,24,11413,1794,2774,363,0,106,16450
8/16/2016,1,11343,1138,3008,372,0,105,15966
8/16/2016,2,11276,1004,2986,474,0,106,15846
8/16/2016,3,11232,1004,2865,707,0,107,15915
8/16/2016,4,11206,1007,2729,689,0,109,15740
8/16/2016,5,11207,1076,2852,908,0,112,16155
8/16/2016,6,11204,1216,2594,1481,1,120,16616
8/16/2016,7,11221,1399,2725,1904,4,124,17377
8/16/2016,8,11232,1613,2740,2082,20,124,17811
8/16/2016,9,11261,1844,3102,2572,39,125,18943
8/16/2016,10,11296,2136,3256,2658,67,124,19537
8/16/2016,11,11282,2477,3151,2681,117,125,19833
8/16/2016,12,11249,2749,3344,2789,111,124,20366
8/16/2016,13,11220,3002,3731,2614,126,123,20816
8/16/2016,14,11236,2801,3846,2555,101,122,20661
8/16/2016,15,11237,2733,3695,2104,86,119,19974
8/16/2016,16,11229,2823,4306,2208,80,108,20754
8/16/2016,17,11252,2999,4279,1851,69,126,20576
8/16/2016,18,11261,3052,4217,1525,37,123,20215
8/16/2016,19,11229,3272,3974,990,10,124,19599
8/16/2016,20,11170,3494,3801,614,0,124,19203
8/16/2016,21,11184,3490,3636,395,0,131,18836
8/16/2016,22,11209,3128,3507,268,0,120,18232
8/16/2016,23,11239,2061,2925,220,0,121,16566
8/16/2016,24,11284,1338,2721,176,0,116,15635
8/17/2016,1,11348,1203,2616,218,0,115,15500
8/17/2016,2,11356,1165,2387,112,0,114,15134
8/17/2016,3,11338,1167,2426,156,0,115,15202
8/17/2016,4,11300,1330,2441,105,0,116,15292
8/17/2016,5,11290,1642,2484,148,0,115,15679
8/17/2016,6,11271,1941,2658,342,0,122,16334
8/17/2016,7,11251,2340,2631,348,22,115,16707
8/17/2016,8,11218,2548,3061,344,76,106,17353
8/17/2016,9,11184,2727,3180,270,123,127,17611
8/17/2016,10,11192,3167,3252,311,149,122,18193
8/17/2016,11,11210,3431,3246,306,157,123,18473
8/17/2016,12,11205,3453,3393,349,203,130,18733
8/17/2016,13,11178,3470,3642,770,191,105,19356
8/17/2016,14,11158,3497,3849,895,181,102,19682
8/17/2016,15,11143,3484,3989,904,177,129,19826
8/17/2016,16,11143,3828,4298,757,141,125,20292
8/17/2016,17,11199,4089,4439,504,112,126,20469
8/17/2016,18,11265,4338,4202,235,49,125,20214
8/17/2016,19,11282,3893,4218,173,11,132,19709
8/17/2016,20,11286,3917,4232,174,1,132,19742
8/17/2016,21,11272,4306,3912,170,0,132,19792
8/17/2016,22,11238,3881,3543,330,0,136,19128
8/17/2016,23,11177,2681,3257,498,0,118,17731
8/17/2016,24,11155,1524,2913,441,0,117,16150
8/18/2016,1,11162,1224,2796,340,0,116,15638
8/18/2016,2,11158,1186,2742,307,0,121,15514
8/18/2016,3,11152,1148,2719,302,0,92,15413
8/18/2016,4,11142,1224,2766,272,0,68,15472
8/18/2016,5,11139,1491,2834,198,1,74,15737
8/18/2016,6,11136,1909,2984,164,1,79,16273
8/18/2016,7,11141,2414,3186,139,24,82,16986
8/18/2016,8,11149,3093,3439,76,82,82,17921
8/18/2016,9,11158,3549,3622,50,146,83,18608
8/18/2016,10,11187,3978,3654,22,178,83,19102
8/18/2016,11,11216,4127,3807,23,181,83,19437
8/18/2016,12,11207,4305,3913,37,192,81,19735
8/18/2016,13,11235,4254,4106,64,193,80,19932
8/18/2016,14,11276,4344,4208,137,183,81,20229
8/18/2016,15,11266,4277,4442,235,162,81,20463
8/18/2016,16,11250,4176,4586,345,125,81,20563
8/18/2016,17,11216,4241,4831,273,102,81,20744
8/18/2016,18,11144,4446,4737,203,51,82,20663
8/18/2016,19,11104,4764,4594,158,9,82,20711
8/18/2016,20,11092,4733,4411,146,2,82,20466
8/18/2016,21,11083,4501,3962,138,1,83,19768
8/18/2016,22,11082,3638,3696,131,1,83,18631
8/18/2016,23,11098,3189,3112,134,1,73,17607
8/18/2016,24,11130,2297,2815,191,1,67,16501
8/19/2016,1,11145,1307,2927,287,0,67,15733
8/19/2016,2,11198,900,2861,373,0,67,15399
8/19/2016,3,11238,890,2926,427,0,68,15549
8/19/2016,4,11255,923,2702,490,0,65,15435
8/19/2016,5,11314,1182,2792,468,1,70,15827
8/19/2016,6,11340,1548,2670,426,4,76,16064
8/19/2016,7,11358,2004,2987,451,21,82,16903
8/19/2016,8,11343,2630,3693,320,66,83,18135
8/19/2016,9,11287,3263,3990,242,125,83,18990
8/19/2016,10,11246,3378,4183,356,183,83,19429
8/19/2016,11,11227,3666,4288,429,213,84,19907
8/19/2016,12,11199,3888,4296,513,221,83,20200
8/19/2016,13,11171,3978,4313,601,217,83,20363
8/19/2016,14,11157,4215,4477,710,206,83,20848
8/19/2016,15,11141,4323,4590,890,199,83,21226
8/19/2016,16,11138,4497,4726,718,152,83,21314
8/19/2016,17,11137,4457,4788,723,102,83,21290
8/19/2016,18,11137,4398,4531,708,42,80,20896
8/19/2016,19,11158,4191,4330,601,8,82,20370
8/19/2016,20,11185,4296,4168,615,1,83,20348
8/19/2016,21,11226,4346,3867,663,1,82,20185
8/19/2016,22,11252,4029,3742,452,1,82,19558
8/19/2016,23,11255,3215,3270,488,1,58,18287
8/19/2016,24,11253,1973,3042,565,0,49,16882
8/20/2016,1,11248,1345,3011,575,0,50,16229
8/20/2016,2,11239,901,3052,667,0,50,15909
8/20/2016,3,11237,837,3103,545,0,48,15770
8/20/2016,4,11221,803,3072,542,0,48,15686
8/20/2016,5,11176,883,3339,510,0,48,15956
8/20/2016,6,11174,1202,3127,422,1,47,15973
8/20/2016,7,11164,1609,3074,324,15,47,16233
8/20/2016,8,11168,1971,3605,254,51,46,17095
8/20/2016,9,11167,2312,3889,226,113,46,17753
8/20/2016,10,11170,2981,4017,310,169,46,18693
8/20/2016,11,11164,3454,4092,551,194,46,19501
8/20/2016,12,11160,3483,4211,835,193,46,19928
8/20/2016,13,11156,3549,4293,1172,197,46,20413
8/20/2016,14,11162,3136,4387,1386,185,46,20302
8/20/2016,15,11167,3201,4581,1591,184,46,20770
8/20/2016,16,11164,3353,4516,1699,148,46,20926
8/20/2016,17,11169,3711,4336,1565,93,46,20920
8/20/2016,18,11166,3666,4251,1647,40,46,20816
8/20/2016,19,11157,3248,3719,2018,8,46,20196
8/20/2016,20,11126,2772,3681,2382,1,46,20008
8/20/2016,21,11106,2588,3189,2889,1,46,19819
8/20/2016,22,11086,1872,2860,3112,0,46,18976
8/20/2016,23,11098,1262,2938,3182,0,46,18526
8/20/2016,24,11114,866,2822,3086,0,48,17936
8/21/2016,1,11103,757,3006,2792,0,51,17709
8/21/2016,2,11106,760,2919,2543,0,51,17379
8/21/2016,3,11110,748,2714,2260,0,51,16883
8/21/2016,4,11096,747,2786,1968,0,51,16648
8/21/2016,5,11089,713,2798,1908,0,51,16559
8/21/2016,6,11086,804,2844,1775,2,51,16562
8/21/2016,7,11082,1011,2896,1935,7,51,16982
8/21/2016,8,11085,1290,3129,1953,24,51,17532
8/21/2016,9,11087,1382,3169,2082,49,50,17819
8/21/2016,10,11102,1379,3304,2305,103,51,18244
8/21/2016,11,11103,1394,3221,2574,98,51,18441
8/21/2016,12,11097,1493,3591,2572,76,51,18880
8/21/2016,13,11099,1656,3551,2473,120,51,18950
8/21/2016,14,11089,1930,3679,2060,91,51,18900
8/21/2016,15,11038,2002,3807,1974,104,51,18976
8/21/2016,16,11071,2039,3840,1991,101,51,19093
8/21/2016,17,11080,1709,3943,1856,65,51,18704
8/21/2016,18,11083,1577,3871,1606,46,51,18234
8/21/2016,19,11110,1539,3537,1500,10,51,17747
8/21/2016,20,11141,1567,3619,1074,2,51,17454
8/21/2016,21,11184,1372,3866,822,2,51,17297
8/21/2016,22,11220,860,3661,733,1,50,16525
8/21/2016,23,11243,783,3053,641,0,53,15773
8/21/2016,24,11251,755,2896,510,0,65,15477
8/22/2016,1,11254,724,2934,322,0,68,15302
8/22/2016,2,11280,771,2903,287,0,66,15307
8/22/2016,3,11239,786,2918,233,0,66,15242
8/22/2016,4,11222,853,2857,185,0,65,15182
8/22/2016,5,11212,1158,2756,116,0,66,15308
8/22/2016,6,11205,1440,2834,200,1,76,15756
8/22/2016,7,11203,1681,2985,214,23,82,16188
8/22/2016,8,11198,1891,3125,236,92,81,16623
8/22/2016,9,11197,2002,3431,143,167,82,17022
8/22/2016,10,11209,2004,3434,238,215,83,17183
8/22/2016,11,11201,2164,3856,290,184,83,17778
8/22/2016,12,11184,1890,3881,276,160,83,17474
8/22/2016,13,11185,1908,3968,309,172,83,17625
8/22/2016,14,11184,1823,3976,368,144,83,17578
8/22/2016,15,11196,2073,3899,394,148,83,17793
8/22/2016,16,11234,2237,4042,364,107,83,18067
8/22/2016,17,11278,2202,4245,352,88,83,18248
8/22/2016,18,11346,2221,4394,373,49,83,18466
8/22/2016,19,11359,2371,4178,308,7,83,18306
8/22/2016,20,11343,2455,4154,309,0,83,18344
8/22/2016,21,11269,2309,3763,371,0,83,17795
8/22/2016,22,10533,1647,3379,538,0,83,16180
8/22/2016,23,10534,870,3083,787,0,74,15348
8/22/2016,24,10508,723,2943,775,0,72,15021
8/23/2016,1,10506,728,2755,704,0,69,14762
8/23/2016,2,10485,735,2808,624,0,69,14721
8/23/2016,3,10427,814,2750,279,0,69,14339
8/23/2016,4,9988,967,2779,264,0,68,14066
8/23/2016,5,9905,1164,3017,743,0,73,14902
8/23/2016,6,10188,1356,3413,772,0,79,15808
8/23/2016,7,10471,1485,3560,814,20,83,16433
8/23/2016,8,10479,1418,3688,830,76,83,16574
8/23/2016,9,10489,1665,3823,816,144,83,17020
8/23/2016,10,10499,1931,3602,874,192,83,17181
8/23/2016,11,10535,2152,3574,768,202,83,17314
8/23/2016,12,10524,2396,3636,907,184,83,17730
8/23/2016,13,10516,2565,3836,1417,185,83,18602
8/23/2016,14,10506,2581,4136,1403,196,83,18905
8/23/2016,15,10487,2597,3990,1322,212,83,18691
8/23/2016,16,10465,2616,4323,1192,148,83,18827
8/23/2016,17,10457,2706,4577,998,115,83,18936
8/23/2016,18,10460,2892,4583,844,46,83,18908
8/23/2016,19,10458,3036,4459,561,7,83,18604
8/23/2016,20,10460,3047,4290,606,0,83,18486
8/23/2016,21,10454,3040,4029,771,0,83,18377
8/23/2016,22,10468,2310,3757,885,0,83,17503
8/23/2016,23,10498,1743,3380,893,0,76,16590
8/23/2016,24,10534,1030,3392,962,0,70,15988
8/24/2016,1,10570,739,3099,1090,0,69,15567
8/24/2016,2,10589,718,2950,1008,0,70,15335
8/24/2016,3,10591,736,2878,1010,0,69,15284
8/24/2016,4,10598,747,2895,1137,0,70,15447
8/24/2016,5,10610,842,2893,1038,1,75,15459
8/24/2016,6,10611,1098,3078,1138,4,78,16007
8/24/2016,7,10588,1466,3377,1159,19,82,16691
8/24/2016,8,10543,1789,3843,1006,75,82,17338
8/24/2016,9,10369,2221,4147,1012,149,82,17980
8/24/2016,10,10492,2458,3934,1474,204,82,18644
8/24/2016,11,10135,2806,3812,1951,227,83,19014
8/24/2016,12,9724,2958,4090,2281,221,83,19357
8/24/2016,13,9713,3226,4369,2410,207,82,20007
8/24/2016,14,9700,3415,4393,2394,206,82,20190
8/24/2016,15,9697,3848,4590,2276,203,82,20696
8/24/2016,16,9685,4354,4767,2088,163,82,21139
8/24/2016,17,9682,4379,4675,1964,87,82,20869
8/24/2016,18,9703,4329,4510,1977,36,82,20637
8/24/2016,19,9726,3801,4404,1966,6,83,19986
8/24/2016,20,9726,3869,4492,2027,0,83,20197
8/24/2016,21,9687,3821,4284,2173,0,83,20048
8/24/2016,22,9670,3329,3991,1941,0,84,19015
8/24/2016,23,9669,3034,3669,1462,0,77,17911
8/24/2016,24,9666,2700,3629,1061,0,69,17125
8/25/2016,1,9659,2088,3592,1038,0,66,16443
8/25/2016,2,9653,1973,3257,1016,0,67,15966
8/25/2016,3,9656,1987,3340,996,0,67,16046
8/25/2016,4,9663,2127,3261,1120,0,66,16237
8/25/2016,5,9645,2423,3231,1025,0,73,16397
8/25/2016,6,9659,2920,3418,772,2,83,16854
8/25/2016,7,9668,3901,3868,631,4,87,18159
8/25/2016,8,9675,4696,4113,458,15,84,19041
8/25/2016,9,9679,5198,4203,410,43,84,19617
8/25/2016,10,9685,5745,4321,366,97,84,20298
8/25/2016,11,9672,6027,4226,452,94,84,20555
8/25/2016,12,9624,5755,4380,600,131,79,20569
8/25/2016,13,9598,5767,4158,779,166,83,20551
8/25/2016,14,9588,5143,4152,1070,180,90,20223
8/25/2016,15,9572,4858,4332,1144,140,90,20136
8/25/2016,16,9571,4974,4334,1150,110,88,20227
8/25/2016,17,9572,5078,4374,942,68,92,20126
8/25/2016,18,9580,5134,4496,665,19,89,19983
8/25/2016,19,9582,5433,4650,334,4,85,20088
8/25/2016,20,9621,5754,4684,232,0,85,20376
8/25/2016,21,9665,5755,4440,292,0,85,20237
8/25/2016,22,9676,5080,4048,389,0,85,19278
8/25/2016,23,9692,4198,3683,563,0,78,18214
8/25/2016,24,9697,3236,3526,784,0,72,17315
8/26/2016,1,9705,2449,3077,900,0,66,16197
8/26/2016,2,9713,2213,2767,824,0,67,15584
8/26/2016,3,9719,2258,2914,785,0,67,15743
8/26/2016,4,9707,2285,3118,634,0,66,15810
8/26/2016,5,9699,2494,3302,440,0,74,16009
8/26/2016,6,9702,2862,3299,395,1,82,16341
8/26/2016,7,9690,3672,3399,409,17,85,17272
8/26/2016,8,9666,4109,3879,210,71,85,18020
8/26/2016,9,9658,4739,4017,131,129,85,18759
8/26/2016,10,9654,4916,4243,114,163,85,19175
8/26/2016,11,9656,5034,4341,150,182,85,19448
8/26/2016,12,9653,5332,4226,244,195,85,19735
8/26/2016,13,9641,5248,4318,334,195,85,19821
8/26/2016,14,9639,5271,4467,398,192,85,20052
8/26/2016,15,9638,5306,4695,477,180,86,20382
8/26/2016,16,9660,5226,4520,427,159,86,20078
8/26/2016,17,9670,5050,4740,365,101,86,20012
8/26/2016,18,9678,5440,4660,311,43,86,20218
8/26/2016,19,9699,5614,4326,244,6,86,19975
8/26/2016,20,9705,5228,4351,188,0,85,19557
8/26/2016,21,9704,5317,4055,155,0,84,19315
8/26/2016,22,9718,4312,3848,140,0,83,18101
8/26/2016,23,9726,3245,3884,106,0,69,17030
8/26/2016,24,9721,2784,3573,114,0,51,16243
8/27/2016,1,9765,2070,3350,185,0,50,15420
8/27/2016,2,9901,1543,3278,230,0,50,15002
8/27/2016,3,9897,1369,3265,270,0,50,14851
8/27/2016,4,9899,1373,3290,326,0,50,14938
8/27/2016,5,9922,1364,3224,431,0,50,14991
8/27/2016,6,9832,1392,2919,671,1,50,14865
8/27/2016,7,9814,1485,2924,635,20,51,14929
8/27/2016,8,9798,1568,3334,814,80,52,15646
8/27/2016,9,9792,1822,3780,899,125,52,16470
8/27/2016,10,9793,2311,4164,793,197,51,17309
8/27/2016,11,9776,2829,4426,623,212,51,17917
8/27/2016,12,9766,3246,4230,512,209,51,18014
8/27/2016,13,9945,3368,4323,394,190,51,18271
8/27/2016,14,10192,3576,4178,308,211,50,18515
8/27/2016,15,10208,4129,4179,170,201,51,18938
8/27/2016,16,10198,4080,4215,280,148,51,18972
8/27/2016,17,10288,3928,4243,326,87,51,18923
8/27/2016,18,10295,3557,4170,733,26,51,18832
8/27/2016,19,10328,3074,3962,963,4,51,18382
8/27/2016,20,10332,2816,3786,1242,0,51,18227
8/27/2016,21,10340,2543,3592,1280,0,51,17806
8/27/2016,22,10328,2089,3376,1229,0,51,17073
8/27/2016,23,10302,1609,3525,914,0,51,16401
8/27/2016,24,10319,1093,3584,613,0,50,15659
8/28/2016,1,10329,944,3620,380,0,50,15323
8/28/2016,2,10289,920,3698,267,0,49,15223
8/28/2016,3,10373,865,3413,261,0,49,14961
8/28/2016,4,10423,815,3289,349,0,50,14926
8/28/2016,5,10406,804,3031,417,0,51,14709
8/28/2016,6,10341,871,3033,410,0,50,14705
8/28/2016,7,10309,1155,2833,323,10,50,14680
8/28/2016,8,10328,1383,3220,426,63,50,15470
8/28/2016,9,10337,1776,3928,412,119,50,16622
8/28/2016,10,10382,2569,3936,406,142,49,17484
8/28/2016,11,10123,3391,4133,427,194,49,18317
8/28/2016,12,9721,4291,4213,594,202,49,19070
8/28/2016,13,9660,4403,3955,586,214,49,18867
8/28/2016,14,9640,4587,4438,638,167,49,19519
8/28/2016,15,9805,4620,4311,569,98,49,19452
8/28/2016,16,9930,4633,4517,513,79,49,19721
8/28/2016,17,9965,4873,4384,454,79,48,19803
8/28/2016,18,10129,4431,4307,418,26,48,19359
8/28/2016,19,10153,4288,4283,299,6,48,19077
8/28/2016,20,10146,4368,4172,262,0,48,18996
8/28/2016,21,10152,4438,3835,260,0,47,18732
8/28/2016,22,10150,3991,3465,355,0,45,18006
8/28/2016,23,10203,3144,3420,459,0,46,17272
8/28/2016,24,10592,1987,3022,363,0,46,16010
8/29/2016,1,10612,1283,3036,400,0,46,15377
8/29/2016,2,10599,1154,2992,447,0,46,15238
8/29/2016,3,10596,1166,3167,403,0,46,15378
8/29/2016,4,10592,1342,3170,413,0,46,15563
8/29/2016,5,10593,1767,3178,343,0,46,15927
8/29/2016,6,10662,2128,2970,369,1,46,16176
8/29/2016,7,10701,2436,3134,443,23,46,16783
8/29/2016,8,10690,2878,3268,309,87,46,17278
8/29/2016,9,10696,3346,3922,168,162,46,18340
8/29/2016,10,10365,3919,4192,134,214,46,18870
8/29/2016,11,9867,4531,4501,82,226,46,19253
8/29/2016,12,9869,4703,4043,49,218,46,18928
8/29/2016,13,9932,4871,4270,70,227,46,19416
8/29/2016,14,10090,4702,4443,142,223,46,19646
8/29/2016,15,10088,5325,4413,153,208,46,20233
8/29/2016,16,10151,5389,4472,159,174,54,20399
8/29/2016,17,10372,5362,4573,160,101,56,20624
8/29/2016,18,10401,5328,4573,115,44,56,20517
8/29/2016,19,10411,5212,4634,107,5,50,20419
8/29/2016,20,10424,4806,4519,151,0,47,19947
8/29/2016,21,10429,4705,4086,169,0,46,19435
8/29/2016,22,10423,4055,3758,135,0,48,18419
8/29/2016,23,10440,2562,3464,123,0,48,16637
8/29/2016,24,10454,1559,3245,113,0,48,15419
8/30/2016,1,10491,988,3054,138,0,48,14719
8/30/2016,2,10493,984,2906,179,0,48,14610
8/30/2016,3,10496,1000,3099,194,0,48,14837
8/30/2016,4,10496,1139,3226,235,0,48,15144
8/30/2016,5,10493,1416,3160,254,0,48,15371
8/30/2016,6,10487,1907,2756,242,1,48,15441
8/30/2016,7,10474,2277,2964,391,18,49,16173
8/30/2016,8,10455,2359,3542,416,73,49,16894
8/30/2016,9,10455,2805,4071,344,112,48,17835
8/30/2016,10,10629,3232,4161,387,153,48,18610
8/30/2016,11,10644,3478,4250,393,171,48,18984
8/30/2016,12,10701,3667,4365,460,199,48,19440
8/30/2016,13,10785,3813,4376,631,222,48,19875
8/30/2016,14,10789,4068,4315,758,213,48,20191
8/30/2016,15,10809,4375,4306,797,174,48,20509
8/30/2016,16,10836,4551,4294,807,148,48,20684
8/30/2016,17,10847,4465,4320,767,74,48,20521
8/30/2016,18,10853,4442,4357,639,28,48,20367
8/30/2016,19,10863,4028,4624,505,5,48,20073
8/30/2016,20,10870,4127,4546,494,0,48,20085
8/30/2016,21,10879,4042,4183,477,0,48,19629
8/30/2016,22,10825,3694,3876,361,0,48,18804
8/30/2016,23,10816,2875,3732,402,0,47,17872
8/30/2016,24,10838,1992,3331,376,0,48,16585
8/31/2016,1,10912,1826,3279,323,0,48,16388
8/31/2016,2,10919,1817,3087,254,0,48,16125
8/31/2016,3,10923,1805,2964,272,0,48,16012
8/31/2016,4,10964,1876,2756,281,0,48,15925
8/31/2016,5,10966,2126,3036,290,1,48,16467
8/31/2016,6,10972,2553,3025,347,1,48,16946
8/31/2016,7,10987,3022,3085,280,3,48,17425
8/31/2016,8,10990,3289,3323,209,20,47,17878
8/31/2016,9,10982,3757,3831,232,48,48,18898
8/31/2016,10,10982,3772,4082,361,79,48,19324
8/31/2016,11,11050,3654,4293,523,117,48,19685
8/31/2016,12,11059,3970,4208,642,156,48,20083
8/31/2016,13,11054,3897,4152,827,145,48,20123
8/31/2016,14,11046,3955,4141,1108,132,48,20430
8/31/2016,15,11025,3716,4229,1540,89,48,20647
8/31/2016,16,11032,3400,4181,1792,96,48,20549
8/31/2016,17,11020,3328,4161,1910,65,48,20532
8/31/2016,18,10995,3473,4069,1856,36,48,20477
8/31/2016,19,11011,3480,3744,1608,6,48,19897
8/31/2016,20,11024,3453,4283,1269,0,48,20077
8/31/2016,21,11032,3157,4040,1196,0,48,19473
8/31/2016,22,11050,2103,3745,999,0,48,17945
8/31/2016,23,11074,1109,3717,813,0,48,16761
8/31/2016,24,11059,748,3264,707,0,48,15826
9/1/2016,1,11064,652,2631,728,0,48,15123
9/1/2016,2,11081,652,2617,680,0,48,15078
9/1/2016,3,11122,661,2633,770,0,48,15234
9/1/2016,4,11155,750,2547,737,0,50,15239
9/1/2016,5,11190,1061,2568,720,0,52,15591
9/1/2016,6,11112,1398,2879,775,1,54,16219
9/1/2016,7,11126,1500,2928,696,16,57,16323
9/1/2016,8,11071,1472,3313,424,66,65,16411
9/1/2016,9,11056,1464,3898,566,125,62,17171
9/1/2016,10,11044,1466,4120,706,142,67,17545
9/1/2016,11,11041,1471,3966,952,136,62,17628
9/1/2016,12,11042,1500,3805,1155,120,60,17682
9/1/2016,13,10924,1533,4164,1003,113,64,17801
9/1/2016,14,10974,1659,3883,1159,99,66,17840
9/1/2016,15,10974,1821,3600,1100,101,64,17660
9/1/2016,16,10981,1671,3564,1486,122,68,17892
9/1/2016,17,11003,1362,3738,1840,66,64,18073
9/1/2016,18,11032,1074,3785,1900,29,59,17879
9/1/2016,19,11035,1063,4113,1513,4,52,17780
9/1/2016,20,11024,1250,4448,1309,0,56,18087
9/1/2016,21,11215,1222,4114,1331,0,52,17934
9/1/2016,22,11337,842,3622,1328,0,51,17180
9/1/2016,23,11480,671,3082,1150,0,51,16434
9/1/2016,24,11474,669,2589,1015,0,51,15798
9/2/2016,1,11455,586,2517,659,0,51,15268
9/2/2016,2,11452,565,2513,436,0,51,15017
9/2/2016,3,11421,568,2486,219,0,51,14745
9/2/2016,4,11028,573,2553,571,0,51,14776
9/2/2016,5,10998,572,2596,856,0,51,15073
9/2/2016,6,11410,655,2771,933,0,51,15820
9/2/2016,7,11598,628,2824,754,20,51,15875
9/2/2016,8,11617,849,3411,527,83,51,16538
9/2/2016,9,11598,1120,3666,364,157,52,16957
9/2/2016,10,11725,1202,3576,339,211,51,17104
9/2/2016,11,11910,1225,3449,497,218,51,17350
9/2/2016,12,11888,1321,3537,597,218,51,17612
9/2/2016,13,11867,1313,3528,563,214,52,17537
9/2/2016,14,11853,1335,3422,502,219,52,17383
9/2/2016,15,11841,1364,3384,496,216,52,17353
9/2/2016,16,11827,1367,3436,521,178,52,17381
9/2/2016,17,11824,1373,3885,765,114,52,18013
9/2/2016,18,11830,872,3731,766,40,52,17291
9/2/2016,19,11839,738,3821,820,4,52,17274
9/2/2016,20,11840,744,3588,767,0,53,16992
9/2/2016,21,11851,661,3399,916,0,53,16880
9/2/2016,22,11845,531,3348,659,0,53,16436
9/2/2016,23,11866,389,3032,460,0,53,15800
9/2/2016,24,11807,309,2612,178,0,53,14959
9/3/2016,1,11446,311,2502,181,0,53,14493
9/3/2016,2,11115,307,2611,475,0,53,14561
9/3/2016,3,11001,309,2521,368,0,48,14247
9/3/2016,4,10800,307,2466,223,0,48,13844
9/3/2016,5,10797,307,2465,393,0,48,14010
9/3/2016,6,10795,307,2512,613,4,48,14279
9/3/2016,7,10919,308,2747,357,20,48,14399
9/3/2016,8,11035,307,2984,381,83,47,14837
9/3/2016,9,11274,306,3587,219,155,47,15588
9/3/2016,10,11603,304,3603,151,204,47,15912
9/3/2016,11,11615,348,3673,195,205,46,16082
9/3/2016,12,11604,360,3781,85,163,45,16038
9/3/2016,13,11602,410,3724,146,171,45,16098
9/3/2016,14,11591,590,3722,130,198,47,16278
9/3/2016,15,11794,727,3791,218,204,47,16781
9/3/2016,16,11887,708,3899,213,164,46,16917
9/3/2016,17,11888,731,4260,234,111,46,17270
9/3/2016,18,11895,799,4229,213,42,46,17224
9/3/2016,19,11905,828,4103,188,4,48,17076
9/3/2016,20,11902,781,4066,254,0,48,17051
9/3/2016,21,11907,434,3592,269,0,48,16250
9/3/2016,22,11909,323,3482,256,0,48,16018
9/3/2016,23,11825,305,2783,185,0,48,15146
9/3/2016,24,11340,304,2658,240,0,48,14590
9/4/2016,1,10844,331,2795,370,0,48,14388
9/4/2016,2,10789,310,2549,461,0,48,14157
9/4/2016,3,10782,305,2516,487,0,48,14138
9/4/2016,4,10784,304,2569,446,0,48,14151
9/4/2016,5,10788,303,2632,401,1,48,14173
9/4/2016,6,10795,302,2825,371,3,48,14344
9/4/2016,7,10798,301,2564,110,13,48,13834
9/4/2016,8,10797,303,2973,235,81,46,14435
9/4/2016,9,10944,303,3131,91,150,46,14665
9/4/2016,10,11461,302,3241,45,202,47,15298
9/4/2016,11,11775,299,3255,61,213,48,15651
9/4/2016,12,11911,299,3352,93,220,48,15923
9/4/2016,13,11904,327,3523,129,211,47,16141
9/4/2016,14,11897,353,3518,151,218,46,16183
9/4/2016,15,11893,384,3597,227,205,46,16352
9/4/2016,16,11889,521,3666,217,168,46,16507
9/4/2016,17,11880,684,4173,180,104,47,17068
9/4/2016,18,11889,822,4425,166,48,47,17397
9/4/2016,19,11886,726,4125,145,4,47,16933
9/4/2016,20,11878,715,3973,206,0,47,16819
9/4/2016,21,11881,591,4013,279,0,48,16812
9/4/2016,22,11881,376,3668,295,0,49,16269
9/4/2016,23,11875,322,3105,295,0,49,15646
9/4/2016,24,11876,300,2693,199,0,49,15117
9/5/2016,1,11726,301,2291,158,0,48,14524
9/5/2016,2,11320,303,2329,265,0,47,14264
9/5/2016,3,11087,304,2449,421,0,48,14309
9/5/2016,4,11003,305,2495,484,0,48,14335
9/5/2016,5,11004,340,2619,367,0,48,14378
9/5/2016,6,11022,382,2497,146,0,48,14095
9/5/2016,7,11018,456,2663,152,10,48,14347
9/5/2016,8,11015,473,2831,198,47,48,14612
9/5/2016,9,11007,508,3132,236,122,48,15053
9/5/2016,10,11343,554,3487,230,168,48,15830
9/5/2016,11,11724,737,3635,334,189,48,16667
9/5/2016,12,11872,911,3614,459,193,48,17097
9/5/2016,13,11864,963,3755,580,183,48,17393
9/5/2016,14,11858,961,3582,692,189,49,17331
9/5/2016,15,11953,978,3804,677,185,49,17646
9/5/2016,16,12031,1089,4265,584,160,49,18178
9/5/2016,17,12016,1457,4653,635,96,48,18905
9/5/2016,18,12008,1757,4665,550,37,48,19065
9/5/2016,19,12007,1467,4539,545,4,48,18610
9/5/2016,20,12002,1414,4566,702,0,48,18732
9/5/2016,21,11971,1339,3930,833,0,48,18121
9/5/2016,22,11956,718,3900,976,0,48,17598
9/5/2016,23,11969,433,3248,1178,0,48,16876
9/5/2016,24,11986,334,2746,1107,0,48,16221
9/6/2016,1,11998,335,2573,625,0,48,15579
9/6/2016,2,11933,340,2566,589,0,48,15476
9/6/2016,3,11711,362,2584,503,0,62,15222
9/6/2016,4,11752,438,2591,604,0,60,15445
9/6/2016,5,11753,490,2683,486,0,50,15462
9/6/2016,6,11899,614,3036,854,1,56,16460
9/6/2016,7,12036,1096,3306,636,16,70,17160
9/6/2016,8,12049,1775,3571,428,76,52,17951
9/6/2016,9,12043,2208,3834,221,137,48,18491
9/6/2016,10,12020,2758,4128,152,160,48,19266
9/6/2016,11,11992,3313,4176,128,195,48,19852
9/6/2016,12,11983,3789,4603,183,177,49,20784
9/6/2016,13,11974,4271,4616,305,198,65,21429
9/6/2016,14,11972,4700,4208,485,203,58,21626
9/6/2016,15,11949,4733,4095,710,190,57,21734
9/6/2016,16,11911,4704,4161,889,152,70,21887
9/6/2016,17,11913,4827,4285,763,91,71,21950
9/6/2016,18,11920,4762,4329,521,29,72,21633
9/6/2016,19,11935,5044,4202,448,2,71,21702
9/6/2016,20,11916,5015,4012,668,0,69,21680
9/6/2016,21,11915,4673,3951,904,0,74,21517
9/6/2016,22,11907,3713,3660,1057,0,82,20419
9/6/2016,23,11937,2506,3264,1040,0,70,18817
9/6/2016,24,11950,1372,2626,1032,0,67,17047
9/7/2016,1,11963,1099,2567,949,0,64,16642
9/7/2016,2,11970,1089,2559,865,0,64,16547
9/7/2016,3,11983,1092,2716,798,0,79,16668
9/7/2016,4,11987,1182,2775,713,0,81,16738
9/7/2016,5,11994,1420,2580,594,1,98,16687
9/7/2016,6,12007,1778,2786,517,1,112,17201
9/7/2016,7,12002,2342,3117,507,11,110,18089
9/7/2016,8,11994,3325,3172,349,66,112,19018
9/7/2016,9,11991,3815,3712,222,112,113,19965
9/7/2016,10,11843,4572,4022,156,143,113,20849
9/7/2016,11,11904,4923,4006,161,166,116,21276
9/7/2016,12,11998,5389,4217,272,175,118,22169
9/7/2016,13,11993,5423,4328,351,179,118,22392
9/7/2016,14,11986,5250,4105,536,214,119,22210
9/7/2016,15,11969,4977,4315,666,200,119,22246
9/7/2016,16,11955,5249,4428,728,137,119,22616
9/7/2016,17,11952,5314,4392,698,65,118,22539
9/7/2016,18,11948,4953,4362,602,31,116,22012
9/7/2016,19,11954,4916,4236,430,2,103,21641
9/7/2016,20,11963,5410,3913,388,0,102,21776
9/7/2016,21,11959,5468,3685,385,0,103,21600
9/7/2016,22,11954,4620,3532,682,0,89,20877
9/7/2016,23,11957,2935,3136,1047,0,73,19148
9/7/2016,24,11954,1883,3136,1268,0,71,18312
9/8/2016,1,11948,1373,3207,1023,0,67,17618
9/8/2016,2,11950,1387,3315,1001,0,70,17723
9/8/2016,3,11948,1236,2886,1164,0,73,17307
9/8/2016,4,11953,1335,2914,1351,0,70,17623
9/8/2016,5,11964,1664,2695,1472,0,82,17877
9/8/2016,6,11979,2027,2921,1588,0,77,18592
9/8/2016,7,11982,2383,3125,1763,6,82,19341
9/8/2016,8,11973,2469,3289,1799,27,81,19638
9/8/2016,9,11946,2610,3217,1860,61,83,19777
9/8/2016,10,11930,2960,3969,1592,56,85,20592
9/8/2016,11,11922,3588,3871,1645,69,85,21180
9/8/2016,12,11911,3608,3945,1810,64,91,21429
9/8/2016,13,11903,3740,4094,2077,69,113,21996
9/8/2016,14,11905,3825,3853,2143,140,109,21975
9/8/2016,15,11896,3843,3960,1942,99,104,21844
9/8/2016,16,11888,3850,4509,1963,66,105,22381
9/8/2016,17,11875,3880,4730,1669,28,101,22283
9/8/2016,18,11880,4615,4650,1010,6,101,22262
9/8/2016,19,11892,4587,4639,660,2,98,21878
9/8/2016,20,11897,4650,4452,669,0,98,21766
9/8/2016,21,11903,4314,4186,735,1,96,21235
9/8/2016,22,11922,3589,3509,729,0,109,19858
9/8/2016,23,11190,3004,3446,890,0,96,18626
9/8/2016,24,11117,2244,2962,898,0,97,17318
9/9/2016,1,11115,2175,2930,802,0,91,17113
9/9/2016,2,11114,1873,2978,723,0,86,16774
9/9/2016,3,11096,1838,2896,636,0,79,16545
9/9/2016,4,11063,2078,3057,428,0,90,16716
9/9/2016,5,11055,2462,2939,328,0,105,16889
9/9/2016,6,11053,2986,3057,307,4,104,17511
9/9/2016,7,11040,3639,3247,265,13,106,18310
9/9/2016,8,11031,4052,3348,115,72,103,18721
9/9/2016,9,11030,4413,3478,73,142,106,19242
9/9/2016,10,11034,4259,3613,40,172,111,19229
9/9/2016,11,11042,4300,3725,24,184,115,19390
9/9/2016,12,11039,4632,3892,103,160,110,19936
9/9/2016,13,11044,4716,3943,166,191,122,20182
9/9/2016,14,11045,4785,3906,228,209,114,20287
9/9/2016,15,11043,4743,3988,238,207,113,20332
9/9/2016,16,11046,4921,4287,195,159,111,20719
9/9/2016,17,11047,4737,4400,152,93,107,20536
9/9/2016,18,11049,4769,4004,92,21,94,20029
9/9/2016,19,11074,4621,3967,105,2,92,19861
9/9/2016,20,10866,4576,3985,131,0,86,19644
9/9/2016,21,10549,4580,3565,234,0,87,19015
9/9/2016,22,10315,3951,3360,358,0,86,18070
9/9/2016,23,10335,3160,3193,532,0,71,17291
9/9/2016,24,10340,2083,3197,531,0,57,16208
9/10/2016,1,10326,1581,2988,540,0,45,15480
9/10/2016,2,10322,976,2745,737,0,47,14827
9/10/2016,3,10310,852,2817,826,0,48,14853
9/10/2016,4,10308,868,2769,957,0,48,14950
9/10/2016,5,10317,817,2796,1011,0,48,14989
9/10/2016,6,10329,899,2608,991,1,48,14876
9/10/2016,7,10331,1047,2688,1406,9,48,15529
9/10/2016,8,10330,1170,2745,1456,37,48,15786
9/10/2016,9,10326,1398,2965,1921,68,48,16726
9/10/2016,10,10327,1528,3224,2278,87,48,17492
9/10/2016,11,10313,1572,3500,2537,126,48,18096
9/10/2016,12,10295,1530,3842,2669,68,48,18452
9/10/2016,13,10285,1535,3892,2760,97,48,18617
9/10/2016,14,10230,1646,3560,3031,151,48,18666
9/10/2016,15,10261,1810,3957,2804,123,48,19003
9/10/2016,16,10269,2201,4331,2334,55,48,19238
9/10/2016,17,10266,2251,4426,2215,28,48,19234
9/10/2016,18,10295,2203,4202,2327,5,48,19080
9/10/2016,19,10284,2167,4367,1748,0,48,18614
9/10/2016,20,10276,2570,4459,1436,0,48,18789
9/10/2016,21,10277,1405,4054,2228,1,48,18013
9/10/2016,22,10284,1023,3404,2458,0,51,17220
9/10/2016,23,10275,635,2773,2552,0,53,16288
9/10/2016,24,10272,525,2476,2284,0,53,15610
9/11/2016,1,10275,515,2417,1989,0,53,15249
9/11/2016,2,10297,520,2381,1421,0,53,14672
9/11/2016,3,10322,521,2364,1059,0,53,14319
9/11/2016,4,10343,522,2357,880,0,53,14155
9/11/2016,5,10388,524,2391,1064,0,53,14420
9/11/2016,6,10417,526,2475,1095,0,53,14566
9/11/2016,7,10428,529,2667,927,13,53,14617
9/11/2016,8,10441,593,2911,990,83,53,15071
9/11/2016,9,10462,588,3100,999,152,53,15354
9/11/2016,10,10479,649,3148,789,214,53,15332
9/11/2016,11,10501,792,3282,716,205,53,15549
9/11/2016,12,10501,1206,3447,628,193,53,16028
9/11/2016,13,10516,1390,3364,576,196,53,16095
9/11/2016,14,10546,1575,3426,463,172,53,16235
9/11/2016,15,10560,1778,3421,399,157,52,16367
9/11/2016,16,10573,2021,3518,332,155,52,16651
9/11/2016,17,10586,2113,3660,354,83,52,16848
9/11/2016,18,10588,1827,4130,284,24,52,16905
9/11/2016,19,10582,1926,4101,154,2,52,16817
9/11/2016,20,10560,1693,4174,242,0,51,16720
9/11/2016,21,10545,1599,3721,299,0,51,16215
9/11/2016,22,10516,1347,3451,358,0,52,15724
9/11/2016,23,10511,796,3001,405,0,62,14775
9/11/2016,24,10514,584,2644,250,0,65,14057
9/12/2016,1,10504,589,2736,324,0,67,14220
9/12/2016,2,10505,590,2761,403,0,69,14328
9/12/2016,3,10518,662,2589,279,0,68,14116
9/12/2016,4,10546,756,2684,270,0,70,14326
9/12/2016,5,10577,799,2581,266,0,88,14311
9/12/2016,6,10591,912,3018,381,3,94,14999
9/12/2016,7,10599,1180,3030,422,17,102,15350
9/12/2016,8,10588,1199,3192,348,51,106,15484
9/12/2016,9,10575,1228,3352,278,94,105,15632
9/12/2016,10,10577,1308,3815,310,196,104,16310
9/12/2016,11,10566,1501,3825,353,197,104,16546
9/12/2016,12,10553,1610,3832,404,179,100,16678
9/12/2016,13,10551,1759,3823,485,218,86,16922
9/12/2016,14,10520,1997,3669,559,226,84,17055
9/12/2016,15,10499,2436,3576,333,205,89,17138
9/12/2016,16,10483,2449,3618,422,167,91,17230
9/12/2016,17,10454,2611,4302,488,106,67,18028
9/12/2016,18,10436,2499,4523,362,36,66,17922
9/12/2016,19,10444,2455,4448,378,2,66,17793
9/12/2016,20,10447,2454,4298,483,0,86,17768
9/12/2016,21,10474,2122,3862,742,0,56,17256
9/12/2016,22,10515,1546,3188,599,0,38,15886
9/12/2016,23,10518,768,3046,742,0,28,15102
9/12/2016,24,10527,645,2871,580,0,23,14646
9/13/2016,1,10380,663,2789,389,0,21,14242
9/13/2016,2,10234,665,2557,381,0,18,13855
9/13/2016,3,10222,668,2529,261,0,18,13698
9/13/2016,4,9998,671,2571,435,0,18,13693
9/13/2016,5,9984,674,2730,831,0,26,14245
9/13/2016,6,10047,792,3086,873,0,33,14831
9/13/2016,7,10371,1011,3226,858,14,36,15516
9/13/2016,8,10517,1110,3457,845,71,36,16036
9/13/2016,9,10499,1255,3534,685,130,36,16139
9/13/2016,10,10477,1373,3771,886,172,37,16716
9/13/2016,11,10455,1641,3875,1048,192,37,17248
9/13/2016,12,10458,1692,3864,1414,199,37,17664
9/13/2016,13,10506,1922,3731,1321,192,37,17709
9/13/2016,14,10522,2148,3801,1447,199,36,18153
9/13/2016,15,10533,2459,3752,1493,185,36,18458
9/13/2016,16,10548,2464,3905,1932,135,36,19020
9/13/2016,17,10531,2471,4278,1778,71,40,19169
9/13/2016,18,10514,2457,4216,1559,23,37,18806
9/13/2016,19,10507,2463,4407,1358,1,37,18773
9/13/2016,20,10483,2474,4453,1231,0,37,18678
9/13/2016,21,10477,2174,4096,1268,0,37,18052
9/13/2016,22,10477,1573,3979,1265,0,37,17331
9/13/2016,23,10479,763,3471,1348,0,31,16092
9/13/2016,24,10470,584,3203,1284,0,23,15564
9/14/2016,1,10460,584,2967,966,0,19,14996
9/14/2016,2,10453,585,2913,857,0,20,14828
9/14/2016,3,10463,589,2886,650,0,20,14608
9/14/2016,4,10481,671,2879,523,0,21,14575
9/14/2016,5,10537,800,2914,433,0,27,14711
9/14/2016,6,10581,949,3373,591,3,35,15532
9/14/2016,7,10594,1119,3646,670,6,37,16072
9/14/2016,8,10610,1355,3788,458,28,40,16279
9/14/2016,9,10612,1316,3933,394,79,39,16373
9/14/2016,10,10625,1359,4091,402,83,37,16597
9/14/2016,11,10629,1326,3996,439,142,36,16568
9/14/2016,12,10619,1223,3899,454,101,35,16331
9/14/2016,13,10605,1045,3822,520,163,36,16191
9/14/2016,14,10608,1197,3974,593,183,35,16590
9/14/2016,15,10600,1535,4023,620,190,35,17003
9/14/2016,16,10592,1861,3977,724,165,34,17353
9/14/2016,17,10588,1890,4009,688,93,34,17302
9/14/2016,18,10588,1857,4280,550,26,34,17335
9/14/2016,19,10588,1885,4281,557,0,34,17345
9/14/2016,20,10579,1966,4322,761,0,35,17663
9/14/2016,21,10581,1733,3913,703,0,35,16965
9/14/2016,22,10549,1626,3335,627,0,35,16172
9/14/2016,23,10083,1714,2923,584,0,21,15325
9/14/2016,24,9466,1713,2801,295,0,19,14294
9/15/2016,1,9041,1715,2517,657,0,19,13949
9/15/2016,2,8973,1715,2500,639,0,20,13847
9/15/2016,3,8979,1715,2445,476,0,23,13638
9/15/2016,4,8978,1716,2458,496,0,24,13672
9/15/2016,5,9073,1716,2438,796,0,28,14051
9/15/2016,6,9901,1714,2595,729,1,27,14967
9/15/2016,7,10602,1722,2799,493,14,35,15665
9/15/2016,8,10614,1728,2881,441,72,35,15771
9/15/2016,9,10608,1721,3090,226,146,35,15826
9/15/2016,10,10593,1692,3236,174,194,36,15925
9/15/2016,11,10585,1684,3389,174,189,36,16057
9/15/2016,12,10580,1410,3766,162,201,36,16155
9/15/2016,13,10575,1319,3922,189,201,36,16242
9/15/2016,14,10565,1346,3940,235,206,36,16328
9/15/2016,15,10553,1371,4227,232,182,36,16601
9/15/2016,16,10541,1526,4123,256,160,37,16643
9/15/2016,17,10536,1451,4344,258,100,37,16726
9/15/2016,18,10536,1620,4439,236,29,40,16900
9/15/2016,19,10547,1674,4313,241,1,41,16817
9/15/2016,20,10547,1678,4372,360,0,37,16994
9/15/2016,21,10556,1675,4223,433,0,37,16924
9/15/2016,22,10559,912,3694,556,0,37,15758
9/15/2016,23,10588,668,3163,524,0,22,14965
9/15/2016,24,10608,664,2896,446,0,19,14633
9/16/2016,1,10614,662,2595,378,0,19,14268
9/16/2016,2,10329,653,2602,340,0,19,13943
9/16/2016,3,10070,658,2663,354,0,18,13763
9/16/2016,4,10052,658,2609,302,0,19,13640
9/16/2016,5,10040,661,2748,637,0,21,14107
9/16/2016,6,10359,662,3118,861,0,24,15024
9/16/2016,7,10540,675,3298,806,14,34,15367
9/16/2016,8,10529,754,3697,321,67,35,15403
9/16/2016,9,10515,801,3486,326,132,35,15295
9/16/2016,10,10506,909,3999,261,171,36,15882
9/16/2016,11,10504,1068,3750,283,191,36,15832
9/16/2016,12,10494,1155,3742,391,193,36,16011
9/16/2016,13,10491,1162,3865,468,193,41,16220
9/16/2016,14,10492,1207,3846,617,192,54,16408
9/16/2016,15,10483,1362,3917,557,174,54,16547
9/16/2016,16,10476,1652,3950,494,134,43,16749
9/16/2016,17,10473,1666,4335,645,74,35,17228
9/16/2016,18,10484,1664,4420,614,14,35,17231
9/16/2016,19,10496,1660,4336,878,0,36,17406
9/16/2016,20,10505,1664,4117,1329,0,36,17651
9/16/2016,21,10378,1667,4019,1206,0,35,17305
9/16/2016,22,9694,832,3714,1960,0,35,16235
9/16/2016,23,9681,595,3380,2098,0,10,15764
9/16/2016,24,9668,594,2993,2154,0,4,15413
9/17/2016,1,9647,612,2677,2086,0,3,15025
9/17/2016,2,9638,614,2714,1625,0,3,14594
9/17/2016,3,9630,622,2724,986,0,3,13965
9/17/2016,4,9619,635,2715,933,0,3,13905
9/17/2016,5,9623,707,2839,890,0,3,14062
9/17/2016,6,9654,922,2803,1058,0,3,14440
9/17/2016,7,9656,1089,3102,1319,5,2,15173
9/17/2016,8,9649,1208,3451,1514,42,4,15868
9/17/2016,9,9643,1226,3967,1730,71,3,16640
9/17/2016,10,9635,1223,4139,1826,56,1,16880
9/17/2016,11,9626,1266,4245,2068,48,0,17253
9/17/2016,12,9612,1273,4186,2169,50,0,17290
9/17/2016,13,9473,1282,4146,2097,68,0,17066
9/17/2016,14,9561,1459,4214,1584,26,0,16844
9/17/2016,15,9594,1743,4191,1245,35,3,16811
9/17/2016,16,9597,1757,4153,1086,25,1,16619
9/17/2016,17,9597,1813,4338,1036,14,0,16798
9/17/2016,18,9593,1614,4515,969,10,0,16701
9/17/2016,19,9605,1496,4220,954,6,0,16281
9/17/2016,20,9606,1447,4035,1172,6,0,16266
9/17/2016,21,9607,1360,3761,1388,6,0,16122
9/17/2016,22,9607,890,3415,1463,6,0,15381
9/17/2016,23,9626,738,3286,1350,6,0,15006
9/17/2016,24,9643,612,3281,1231,6,0,14773
9/18/2016,1,9652,605,3061,1104,6,0,14428
9/18/2016,2,9655,605,2974,943,6,0,14183
9/18/2016,3,9659,612,3094,741,6,0,14112
9/18/2016,4,9662,667,3059,651,6,0,14045
9/18/2016,5,9655,700,3050,509,6,0,13920
9/18/2016,6,9658,940,3293,399,6,0,14296
9/18/2016,7,9657,1214,3410,266,9,0,14556
9/18/2016,8,9652,1418,3643,192,36,0,14941
9/18/2016,9,9656,1637,3806,160,76,0,15335
9/18/2016,10,9651,1717,4070,196,94,0,15728
9/18/2016,11,9644,1981,3965,385,113,0,16088
9/18/2016,12,9642,2191,3914,516,166,0,16429
9/18/2016,13,9638,2484,3811,676,173,0,16782
9/18/2016,14,9635,2761,3909,697,168,7,17177
9/18/2016,15,9588,2893,4241,605,151,9,17487
9/18/2016,16,9627,3343,4506,421,107,0,18004
9/18/2016,17,9631,3670,4843,265,59,0,18468
9/18/2016,18,9629,3643,4875,152,19,0,18318
9/18/2016,19,9629,3779,4824,78,6,0,18316
9/18/2016,20,9628,3819,4686,88,3,0,18224
9/18/2016,21,9624,3802,4528,107,1,0,18062
9/18/2016,22,9626,3109,4190,146,0,0,17071
9/18/2016,23,9637,2054,3866,125,0,5,15687
9/18/2016,24,9639,1594,3524,111,0,17,14885
9/19/2016,1,9646,1300,3539,101,0,18,14604
9/19/2016,2,9643,1063,3437,105,0,19,14267
9/19/2016,3,9640,1057,3406,185,0,18,14306
9/19/2016,4,9645,1323,3555,216,0,19,14758
9/19/2016,5,9643,1850,3474,299,0,23,15289
9/19/2016,6,9645,2735,3735,318,0,27,16460
9/19/2016,7,9646,3461,3591,306,1,34,17039
9/19/2016,8,9633,3385,3712,320,25,34,17109
9/19/2016,9,9623,3382,3990,248,93,34,17370
9/19/2016,10,9625,3584,4130,217,147,35,17738
9/19/2016,11,9618,3794,4027,308,166,35,17948
9/19/2016,12,9608,3883,4154,389,176,35,18245
9/19/2016,13,9597,4065,4327,417,174,35,18615
9/19/2016,14,9584,4228,4309,465,178,36,18800
9/19/2016,15,9575,4004,4291,547,164,31,18612
9/19/2016,16,9575,4180,4587,743,132,36,19253
9/19/2016,17,9577,4329,4757,768,77,36,19544
9/19/2016,18,9577,4397,4697,806,20,36,19533
9/19/2016,19,9577,4479,4519,922,0,36,19533
9/19/2016,20,9580,4107,4396,1151,0,36,19270
9/19/2016,21,9569,3494,4404,1350,0,36,18853
9/19/2016,22,9568,2983,4015,1326,0,36,17928
9/19/2016,23,9563,1702,3812,1404,0,30,16511
9/19/2016,24,9552,813,3517,1536,0,21,15439
9/20/2016,1,9561,669,3146,1405,0,20,14801
9/20/2016,2,9587,679,3061,1297,0,21,14645
9/20/2016,3,9593,753,3050,1022,0,20,14438
9/20/2016,4,9592,1081,3097,749,0,20,14539
9/20/2016,5,9587,1485,3316,712,0,25,15125
9/20/2016,6,9589,2149,3427,642,0,32,15839
9/20/2016,7,9591,3096,3431,559,6,37,16720
9/20/2016,8,9584,3285,3692,429,48,37,17075
9/20/2016,9,9599,3546,3798,357,104,37,17441
9/20/2016,10,9584,3795,3994,339,139,37,17888
9/20/2016,11,9590,3941,4066,358,166,37,18158
9/20/2016,12,9589,4172,4167,389,168,37,18522
9/20/2016,13,9580,4404,4120,576,183,37,18900
9/20/2016,14,9575,4536,4120,705,161,37,19134
9/20/2016,15,9568,4509,3945,684,97,42,18845
9/20/2016,16,9573,4746,4258,661,107,38,19383
9/20/2016,17,9579,4530,4479,505,86,38,19217
9/20/2016,18,9582,4530,4580,417,26,37,19172
9/20/2016,19,9588,4544,4593,479,1,37,19242
9/20/2016,20,9590,4221,4614,536,0,37,18998
9/20/2016,21,9587,3499,4496,597,0,37,18216
9/20/2016,22,9601,2848,3988,635,0,37,17109
9/20/2016,23,9601,1871,3705,653,0,28,15858
9/20/2016,24,9605,1221,3309,599,0,22,14756
9/21/2016,1,9603,846,3052,518,0,23,14042
9/21/2016,2,9594,848,2965,644,0,21,14072
9/21/2016,3,9612,847,2920,638,0,20,14037
9/21/2016,4,9658,928,2825,433,0,21,13865
9/21/2016,5,9669,1232,2948,335,0,24,14208
9/21/2016,6,9698,1709,3200,380,2,26,15015
9/21/2016,7,9868,2061,3458,588,12,33,16020
9/21/2016,8,9861,2352,3485,582,74,35,16389
9/21/2016,9,9855,2639,3532,315,147,36,16524
9/21/2016,10,9877,2755,3744,291,194,37,16898
9/21/2016,11,9981,2793,3818,374,214,37,17217
9/21/2016,12,10033,3084,3780,465,219,37,17618
9/21/2016,13,10160,3202,4046,418,201,44,18071
9/21/2016,14,10244,3180,4283,312,173,43,18235
9/21/2016,15,10303,3218,4465,220,146,40,18392
9/21/2016,16,10310,3360,4593,272,117,36,18688
9/21/2016,17,10317,3515,4525,249,77,36,18719
9/21/2016,18,10278,3527,4511,192,23,37,18568
9/21/2016,19,10276,3541,4661,154,1,37,18670
9/21/2016,20,10282,3551,4574,189,0,37,18633
9/21/2016,21,10278,3313,4259,307,0,37,18194
9/21/2016,22,10272,2518,3765,316,0,36,16907
9/21/2016,23,10277,1285,3673,411,0,23,15669
9/21/2016,24,10277,793,3587,487,0,20,15164
9/22/2016,1,10288,673,3197,477,0,20,14655
9/22/2016,2,10227,678,3034,344,0,20,14303
9/22/2016,3,10060,689,3046,303,0,21,14119
9/22/2016,4,9835,733,3123,410,0,21,14122
9/22/2016,5,9909,824,3511,346,0,26,14616
9/22/2016,6,10254,1065,3479,377,1,34,15210
9/22/2016,7,10377,1690,3731,330,10,36,16174
9/22/2016,8,10374,2015,3708,289,64,36,16486
9/22/2016,9,10366,2254,3872,163,125,37,16817
9/22/2016,10,10368,2399,4031,162,168,35,17163
9/22/2016,11,10355,2563,4153,251,189,33,17544
9/22/2016,12,10356,2935,4202,251,197,34,17975
9/22/2016,13,10246,3480,4304,317,195,33,18575
9/22/2016,14,10352,3695,4344,339,185,33,18948
9/22/2016,15,10369,4056,4418,318,144,34,19339
9/22/2016,16,10368,4318,4407,232,112,34,19471
9/22/2016,17,10376,4297,4858,169,42,34,19776
9/22/2016,18,10380,4003,4884,166,7,34,19474
9/22/2016,19,10386,4212,5004,159,0,34,19795
9/22/2016,20,10383,3936,4868,173,0,34,19394
9/22/2016,21,10378,3659,4623,192,0,34,18886
9/22/2016,22,10376,2603,4386,295,0,34,17694
9/22/2016,23,10376,1180,4308,336,0,28,16228
9/22/2016,24,10380,851,3859,298,0,21,15409
9/23/2016,1,10380,863,3798,289,0,16,15346
9/23/2016,2,10381,832,3467,227,0,18,14925
9/23/2016,3,10378,768,3245,156,0,18,14565
9/23/2016,4,10371,845,3204,206,0,20,14646
9/23/2016,5,10374,997,3182,315,0,25,14893
9/23/2016,6,10374,1212,3552,412,0,29,15579
9/23/2016,7,10383,1624,4075,685,4,35,16806
9/23/2016,8,10389,1626,4107,843,31,35,17031
9/23/2016,9,10388,1748,4229,903,48,35,17351
9/23/2016,10,10393,1527,4076,904,81,35,17016
9/23/2016,11,10411,1647,3723,872,68,35,16756
9/23/2016,12,10434,1788,3555,795,78,36,16686
9/23/2016,13,10448,1798,3882,706,90,35,16959
9/23/2016,14,10454,1796,3957,834,77,34,17152
9/23/2016,15,10474,1505,3650,893,82,35,16639
9/23/2016,16,10479,1574,3739,797,62,37,16688
9/23/2016,17,10482,1600,3846,1064,39,36,17067
9/23/2016,18,10482,1652,3961,586,7,36,16724
9/23/2016,19,10482,1598,4356,779,1,36,17252
9/23/2016,20,10466,1603,4534,758,0,34,17395
9/23/2016,21,10472,1292,4480,850,1,32,17127
9/23/2016,22,10466,1083,4086,964,1,33,16633
9/23/2016,23,10475,627,3514,1037,0,10,15663
9/23/2016,24,10482,487,3039,917,0,3,14928
9/24/2016,1,10484,454,2851,551,0,3,14343
9/24/2016,2,10355,453,2805,538,0,3,14154
9/24/2016,3,10200,450,2639,629,0,3,13921
9/24/2016,4,10204,433,2635,591,0,3,13866
9/24/2016,5,10216,434,2783,725,0,2,14160
9/24/2016,6,10221,433,2867,739,3,3,14266
9/24/2016,7,10438,433,3218,719,12,3,14823
9/24/2016,8,10519,433,3405,618,81,3,15059
9/24/2016,9,10521,433,3558,387,159,4,15062
9/24/2016,10,10519,433,3654,508,208,4,15326
9/24/2016,11,10518,433,3886,433,209,3,15482
9/24/2016,12,10509,432,3820,273,217,3,15254
9/24/2016,13,10510,432,3576,213,228,3,14962
9/24/2016,14,10506,432,3617,184,230,3,14972
9/24/2016,15,10498,436,3724,206,214,3,15081
9/24/2016,16,10485,437,4010,206,162,5,15305
9/24/2016,17,10481,443,4508,270,94,5,15801
9/24/2016,18,10486,458,4645,249,23,4,15865
9/24/2016,19,10498,443,4721,281,0,2,15945
9/24/2016,20,10505,451,4746,356,0,2,16060
9/24/2016,21,10507,442,4050,574,0,3,15576
9/24/2016,22,10515,439,3764,663,0,2,15383
9/24/2016,23,10522,438,3155,600,0,3,14718
9/24/2016,24,10525,440,2827,550,0,2,14344
9/25/2016,1,10411,439,2777,515,0,3,14145
9/25/2016,2,10113,439,2698,853,0,3,14106
9/25/2016,3,9991,438,2611,810,0,4,13854
9/25/2016,4,9998,438,2558,871,0,2,13867
9/25/2016,5,9998,437,2585,710,0,2,13732
9/25/2016,6,10000,439,2699,1123,3,1,14265
9/25/2016,7,10204,439,2968,798,15,0,14424
9/25/2016,8,10461,438,3060,626,79,0,14664
9/25/2016,9,10526,440,3313,310,85,0,14674
9/25/2016,10,10531,475,3381,351,138,0,14876
9/25/2016,11,10521,519,3301,468,231,0,15040
9/25/2016,12,10520,577,3317,557,231,1,15203
9/25/2016,13,10523,604,3481,545,231,3,15387
9/25/2016,14,10540,630,3586,375,228,2,15361
9/25/2016,15,10538,621,3741,456,214,2,15572
9/25/2016,16,10537,626,3989,461,154,2,15769
9/25/2016,17,10530,663,3998,666,67,2,15926
9/25/2016,18,10535,668,4349,785,14,2,16353
9/25/2016,19,10535,686,4515,899,1,2,16638
9/25/2016,20,10525,691,4243,1268,0,2,16729
9/25/2016,21,10527,688,3653,1518,1,2,16389
9/25/2016,22,10527,530,3423,1437,0,8,15925
9/25/2016,23,10540,496,3092,1087,0,14,15229
9/25/2016,24,10542,496,2843,931,0,15,14827
9/26/2016,1,10487,496,2695,578,0,16,14272
9/26/2016,2,10235,496,2647,705,0,16,14099
9/26/2016,3,10229,496,2600,482,0,16,13823
9/26/2016,4,10165,497,2602,587,0,18,13869
9/26/2016,5,10135,541,2722,985,0,21,14404
9/26/2016,6,10308,592,3116,1207,0,30,15253
9/26/2016,7,10430,719,3289,1735,6,33,16212
9/26/2016,8,10430,744,3341,1844,37,33,16429
9/26/2016,9,10426,753,3896,1738,38,35,16886
9/26/2016,10,10410,880,4566,1015,54,34,16959
9/26/2016,11,10393,1094,4445,1215,52,35,17234
9/26/2016,12,10341,985,3813,1512,51,35,16737
9/26/2016,13,10219,728,3794,1748,54,37,16580
9/26/2016,14,10263,705,4129,1628,51,36,16812
9/26/2016,15,10381,708,4064,1938,28,36,17155
9/26/2016,16,10366,747,4462,1855,17,42,17489
9/26/2016,17,10352,1014,4346,1390,6,36,17144
9/26/2016,18,10366,1031,3991,1344,6,36,16774
9/26/2016,19,10369,854,4272,1692,0,36,17223
9/26/2016,20,10370,829,4336,2059,0,36,17630
9/26/2016,21,10375,810,4134,2007,0,36,17362
9/26/2016,22,10379,768,3402,1853,0,36,16438
9/26/2016,23,10378,747,3095,1603,0,28,15851
9/26/2016,24,10371,742,2692,840,0,25,14670
9/27/2016,1,10127,745,2747,577,0,23,14219
9/27/2016,2,9848,745,2707,587,0,22,13909
9/27/2016,3,9704,746,2718,423,0,22,13613
9/27/2016,4,9579,743,2656,703,0,23,13704
9/27/2016,5,9597,745,2809,959,0,27,14137
9/27/2016,6,9908,748,2910,1680,1,36,15283
9/27/2016,7,10190,762,3115,2235,10,40,16352
9/27/2016,8,10474,764,3166,1948,64,42,16458
9/27/2016,9,10479,760,3245,1880,132,44,16540
9/27/2016,10,10480,755,3229,1892,107,42,16505
9/27/2016,11,10485,757,3298,2012,162,41,16755
9/27/2016,12,10476,758,3456,1553,152,42,16437
9/27/2016,13,10470,760,3480,2087,165,42,17004
9/27/2016,14,10470,759,3471,2093,196,40,17029
9/27/2016,15,10481,758,3459,2235,121,43,17097
9/27/2016,16,10490,722,3735,1953,96,40,17036
9/27/2016,17,10485,709,3950,1786,71,39,17040
9/27/2016,18,10479,714,4566,1110,14,37,16920
9/27/2016,19,10468,763,5081,604,0,37,16953
9/27/2016,20,10462,857,5029,269,0,38,16655
9/27/2016,21,10472,845,4742,190,0,37,16286
9/27/2016,22,10479,739,4058,182,0,37,15495
9/27/2016,23,10480,699,3688,212,0,28,15107
9/27/2016,24,10266,701,3164,187,0,23,14341
9/28/2016,1,10172,701,3101,289,0,22,14285
9/28/2016,2,10178,701,3016,391,0,22,14308
9/28/2016,3,10103,701,2980,342,0,21,14147
9/28/2016,4,9932,702,3115,372,0,21,14142
9/28/2016,5,10003,705,3228,589,0,24,14549
9/28/2016,6,10381,814,3283,763,0,30,15271
9/28/2016,7,10486,796,3620,878,10,36,15826
9/28/2016,8,10485,718,3565,795,54,36,15653
9/28/2016,9,10475,756,3597,935,102,34,15899
9/28/2016,10,10464,769,3938,801,161,34,16167
9/28/2016,11,10464,736,3925,771,194,34,16124
9/28/2016,12,10473,720,3969,868,224,34,16288
9/28/2016,13,10557,719,4135,933,182,34,16560
9/28/2016,14,10644,723,3905,1210,189,34,16705
9/28/2016,15,10637,745,3685,1156,154,34,16411
9/28/2016,16,10580,704,4095,1257,85,34,16755
9/28/2016,17,10526,706,4234,1232,30,34,16762
9/28/2016,18,10508,710,4236,1101,10,35,16600
9/28/2016,19,10507,714,4138,1761,0,37,17157
9/28/2016,20,10469,720,3821,1873,0,42,16925
9/28/2016,21,10445,720,3610,1937,0,37,16749
9/28/2016,22,10412,719,3219,1875,0,36,16261
9/28/2016,23,10687,700,3052,1081,0,26,15546
9/28/2016,24,10776,648,2927,569,0,24,14944
9/29/2016,1,10445,655,2652,567,0,25,14344
9/29/2016,2,10262,701,2593,478,0,26,14060
9/29/2016,3,10075,702,2587,489,0,27,13880
9/29/2016,4,9939,702,2649,752,0,25,14067
9/29/2016,5,9935,705,2788,987,0,29,14444
9/29/2016,6,10335,705,2956,1670,1,34,15701
9/29/2016,7,10625,721,3037,2581,4,37,17005
9/29/2016,8,10785,723,2999,2829,25,37,17398
9/29/2016,9,10829,720,3122,2688,66,37,17462
9/29/2016,10,10950,717,3043,2180,113,37,17040
9/29/2016,11,10959,714,3028,1994,144,37,16876
9/29/2016,12,10962,712,2992,2466,94,37,17263
9/29/2016,13,10961,727,3014,2353,84,37,17176
9/29/2016,14,10971,736,3054,2365,92,37,17255
9/29/2016,15,11000,739,3095,2191,103,37,17165
9/29/2016,16,10995,737,3361,2228,47,36,17404
9/29/2016,17,10990,738,3422,2181,28,36,17395
9/29/2016,18,11004,741,3572,2169,8,36,17530
9/29/2016,19,11011,744,3685,2390,1,36,17867
9/29/2016,20,11001,745,3651,2280,0,36,17713
9/29/2016,21,10995,746,3539,1965,0,36,17281
9/29/2016,22,11018,745,3244,1619,0,36,16662
9/29/2016,23,11023,725,3119,581,0,26,15474
9/29/2016,24,10749,700,2774,498,0,19,14740
9/30/2016,1,10155,703,2777,356,0,17,14008
9/30/2016,2,9805,703,2757,404,0,17,13686
9/30/2016,3,9582,703,2729,603,0,17,13634
9/30/2016,4,9580,703,2709,546,0,17,13555
9/30/2016,5,9654,702,2889,980,0,23,14248
9/30/2016,6,10112,702,3027,1614,2,30,15487
9/30/2016,7,10579,718,3140,2347,4,34,16822
9/30/2016,8,11011,721,3310,2071,25,33,17171
9/30/2016,9,11039,718,3186,2273,55,34,17305
9/30/2016,10,11039,715,3175,2219,81,34,17263
9/30/2016,11,11035,710,3163,1844,98,38,16888
9/30/2016,12,11032,705,3254,1857,119,35,17002
9/30/2016,13,11027,701,3165,1913,108,35,16949
9/30/2016,14,11038,700,3233,1903,86,34,16994
9/30/2016,15,11041,698,3146,1875,90,33,16883
9/30/2016,16,11037,698,3206,1795,91,33,16860
9/30/2016,17,11043,699,3326,1656,40,28,16792
9/30/2016,18,11040,703,3473,1840,7,24,17087
9/30/2016,19,11039,707,3564,1933,0,25,17268
9/30/2016,20,11031,708,3591,1823,0,25,17178
9/30/2016,21,11028,710,3365,1975,0,25,17103
9/30/2016,22,11022,703,3090,1530,0,25,16370
9/30/2016,23,11035,606,2543,1098,0,13,15295
9/30/2016,24,10821,575,2349,868,0,9,14622
10/1/2016,1,10594,592,2257,990,0,3,14436
10/1/2016,2,10456,593,2275,769,0,3,14096
10/1/2016,3,10466,592,2252,606,0,3,13919
10/1/2016,4,10444,549,2363,546,0,3,13905
10/1/2016,5,10457,590,2380,375,0,3,13805
10/1/2016,6,10470,595,2436,967,1,3,14472
10/1/2016,7,10765,595,2777,1025,2,3,15167
10/1/2016,8,11067,593,3169,898,22,3,15752
10/1/2016,9,11058,590,3761,836,62,3,16310
10/1/2016,10,11066,588,3966,688,81,3,16392
10/1/2016,11,11074,578,3866,569,98,3,16188
10/1/2016,12,11073,579,3941,431,105,3,16132
10/1/2016,13,11071,577,3995,323,113,3,16082
10/1/2016,14,11067,576,3933,320,69,3,15968
10/1/2016,15,11018,573,3910,293,63,3,15860
10/1/2016,16,11056,574,3912,294,34,3,15873
10/1/2016,17,11059,576,4121,298,31,3,16088
10/1/2016,18,11065,578,4208,297,6,3,16157
10/1/2016,19,11072,581,4340,404,0,3,16400
10/1/2016,20,11069,583,4111,407,0,3,16173
10/1/2016,21,11068,585,3879,388,0,4,15924
10/1/2016,22,11077,585,3782,363,0,4,15811
10/1/2016,23,11016,585,3634,358,0,3,15596
10/1/2016,24,10722,586,3333,251,0,2,14894
10/2/2016,1,10357,584,3309,216,0,2,14468
10/2/2016,2,10170,587,3180,154,0,2,14093
10/2/2016,3,9933,588,3266,134,0,3,13924
10/2/2016,4,9916,587,3175,99,0,3,13780
10/2/2016,5,9971,589,3244,133,0,3,13940
10/2/2016,6,10319,590,3593,144,0,3,14649
10/2/2016,7,10601,596,3746,121,1,2,15067
10/2/2016,8,11013,590,3450,110,19,4,15186
10/2/2016,9,11155,628,3922,135,34,3,15877
10/2/2016,10,11159,656,4024,155,60,2,16056
10/2/2016,11,11155,589,3999,160,106,3,16012
10/2/2016,12,11153,584,4160,189,79,4,16169
10/2/2016,13,11168,585,4052,230,113,4,16152
10/2/2016,14,11163,580,4230,151,109,3,16236
10/2/2016,15,11165,608,4268,143,120,3,16307
10/2/2016,16,11165,626,4096,225,75,3,16190
10/2/2016,17,11164,617,4190,225,30,3,16229
10/2/2016,18,11149,589,4268,134,7,3,16150
10/2/2016,19,11135,594,4606,154,0,3,16492
10/2/2016,20,11129,595,4144,181,0,3,16052
10/2/2016,21,11134,597,4026,202,0,2,15961
10/2/2016,22,11116,598,3660,237,0,2,15613
10/2/2016,23,11049,607,3247,202,0,2,15107
10/2/2016,24,10791,598,3048,207,0,3,14647
10/3/2016,1,10779,608,2984,274,0,18,14663
10/3/2016,2,10770,686,2976,285,0,19,14736
10/3/2016,3,10757,687,2710,268,0,19,14441
10/3/2016,4,10753,741,2775,280,0,19,14568
10/3/2016,5,10906,791,3048,310,0,24,15079
10/3/2016,6,11042,867,3186,252,2,32,15381
10/3/2016,7,11028,1035,3300,228,2,32,15625
10/3/2016,8,11011,1094,3816,161,23,34,16139
10/3/2016,9,11001,1167,3811,116,58,33,16186
10/3/2016,10,10999,1231,3882,94,110,34,16350
10/3/2016,11,11010,1191,3638,54,92,35,16020
10/3/2016,12,11029,1232,3587,33,82,37,16000
10/3/2016,13,11030,1306,3779,53,122,36,16326
10/3/2016,14,11041,1350,3899,74,132,46,16542
10/3/2016,15,11046,1424,3810,76,78,65,16499
10/3/2016,16,11035,1517,3939,111,58,70,16730
10/3/2016,17,11046,1685,4192,97,29,33,17082
10/3/2016,18,11058,1701,4338,52,5,34,17188
10/3/2016,19,11017,1706,4385,66,0,35,17209
10/3/2016,20,11016,1709,4154,132,0,45,17056
10/3/2016,21,11012,1718,3873,174,0,63,16840
10/3/2016,22,11013,963,3298,180,0,101,15555
10/3/2016,23,10823,684,3230,230,0,26,14993
10/3/2016,24,10312,670,3057,393,0,17,14449
10/4/2016,1,10022,671,2557,524,0,17,13791
10/4/2016,2,9628,674,2530,498,0,18,13348
10/4/2016,3,9611,674,2479,546,0,17,13327
10/4/2016,4,9605,667,2480,621,0,19,13392
10/4/2016,5,9729,669,3009,755,0,20,14182
10/4/2016,6,10551,672,2896,621,1,26,14767
10/4/2016,7,11013,702,3011,426,6,30,15188
10/4/2016,8,11014,702,3100,316,41,48,15221
10/4/2016,9,11016,782,3303,240,76,92,15509
10/4/2016,10,11019,801,3794,188,107,119,16028
10/4/2016,11,11024,1002,3529,259,116,160,16090
10/4/2016,12,11020,1280,3472,137,140,129,16178
10/4/2016,13,11017,1463,3536,273,172,84,16545
10/4/2016,14,11015,1503,3542,337,165,82,16644
10/4/2016,15,11011,1530,3532,236,129,90,16528
10/4/2016,16,11019,1534,3585,487,103,96,16824
10/4/2016,17,11011,1538,3761,612,68,156,17146
10/4/2016,18,11003,1542,3800,656,10,162,17173
10/4/2016,19,11007,1541,4001,979,0,188,17716
10/4/2016,20,10998,1380,3603,1166,0,170,17317
10/4/2016,21,10995,867,3483,1163,0,148,16656
10/4/2016,22,10997,718,3189,976,0,166,16046
10/4/2016,23,11002,705,2912,808,0,82,15509
10/4/2016,24,10791,681,2753,719,0,25,14969
10/5/2016,1,10345,682,2556,576,0,19,14178
10/5/2016,2,10164,686,2538,483,0,20,13891
10/5/2016,3,10158,688,2519,387,0,17,13769
10/5/2016,4,10165,687,2614,423,0,20,13909
10/5/2016,5,10184,686,2791,741,0,18,14420
10/5/2016,6,10566,687,3012,959,0,26,15250
10/5/2016,7,10868,704,3066,1698,4,31,16371
10/5/2016,8,11006,630,3152,1570,54,47,16459
10/5/2016,9,11006,643,3258,1418,90,79,16494
10/5/2016,10,11007,643,3296,1075,133,138,16292
10/5/2016,11,10997,693,3322,718,189,178,16097
10/5/2016,12,10992,714,3390,746,208,180,16230
10/5/2016,13,10987,712,3462,888,219,149,16417
10/5/2016,14,10982,646,3501,906,225,134,16394
10/5/2016,15,10984,643,3432,1241,204,124,16628
10/5/2016,16,10980,696,3528,1319,139,169,16831
10/5/2016,17,10980,717,3770,1718,64,120,17369
10/5/2016,18,10984,720,3823,1985,8,108,17628
10/5/2016,19,10981,724,3828,2145,0,147,17825
10/5/2016,20,10982,724,3635,2332,1,183,17857
10/5/2016,21,10984,723,3621,2071,0,156,17555
10/5/2016,22,10982,721,3337,1323,0,136,16499
10/5/2016,23,10977,715,2796,815,0,34,15337
10/5/2016,24,10903,714,2650,704,0,24,14995
10/6/2016,1,10526,713,2556,587,0,21,14403
10/6/2016,2,10352,712,2664,481,0,21,14230
10/6/2016,3,10355,712,2656,403,0,21,14147
10/6/2016,4,10361,714,2686,462,0,23,14246
10/6/2016,5,10409,714,2848,775,0,28,14774
10/6/2016,6,10832,722,3203,744,1,49,15551
10/6/2016,7,10994,721,3800,639,8,99,16261
10/6/2016,8,10991,715,3596,563,52,170,16087
10/6/2016,9,10994,717,3785,302,112,189,16099
10/6/2016,10,10995,718,3580,151,182,167,15793
10/6/2016,11,10998,715,3661,118,213,166,15871
10/6/2016,12,10997,757,3631,206,230,189,16010
10/6/2016,13,10991,792,3907,266,228,185,16369
10/6/2016,14,10997,854,3849,345,219,183,16447
10/6/2016,15,11002,938,4192,362,190,191,16875
10/6/2016,16,10997,930,4190,331,140,192,16780
10/6/2016,17,11006,925,4450,303,63,192,16939
10/6/2016,18,11007,926,4474,396,8,191,17002
10/6/2016,19,10999,932,4119,760,0,191,17001
10/6/2016,20,10990,935,4045,1214,0,190,17374
10/6/2016,21,10987,776,3641,1462,0,191,17057
10/6/2016,22,10975,730,3184,1476,0,165,16530
10/6/2016,23,10977,728,2637,1102,0,52,15496
10/6/2016,24,10975,716,2716,720,0,22,15149
10/7/2016,1,10976,715,2625,635,0,20,14971
10/7/2016,2,10882,714,2545,457,0,19,14617
10/7/2016,3,10681,714,2590,394,0,19,14398
10/7/2016,4,10685,715,2681,271,0,19,14371
10/7/2016,5,10703,717,2838,632,0,24,14914
10/7/2016,6,10962,714,3013,763,1,53,15506
10/7/2016,7,10981,721,3290,1267,5,93,16357
10/7/2016,8,10982,693,3387,1179,57,169,16467
10/7/2016,9,10981,691,3634,945,124,189,16564
10/7/2016,10,10972,693,3864,811,174,191,16705
10/7/2016,11,10959,694,3919,787,200,191,16750
10/7/2016,12,10950,691,3904,784,209,192,16730
10/7/2016,13,10806,768,3779,977,204,190,16724
10/7/2016,14,10922,844,3641,990,213,165,16775
10/7/2016,15,10933,909,3587,1287,180,185,17081
10/7/2016,16,10928,921,3831,1254,125,191,17250
10/7/2016,17,10939,938,4087,1061,64,163,17252
10/7/2016,18,10964,1077,4440,924,9,156,17570
10/7/2016,19,10961,1103,4385,1152,0,188,17789
10/7/2016,20,10962,1118,4129,1318,0,184,17711
10/7/2016,21,10958,965,3966,1339,0,180,17408
10/7/2016,22,10951,894,3452,1314,0,153,16764
10/7/2016,23,10957,505,3289,1371,0,42,16164
10/7/2016,24,10959,440,2746,1346,0,11,15502
10/8/2016,1,10810,442,2645,862,0,0,14759
10/8/2016,2,10274,439,2576,1041,0,0,14330
10/8/2016,3,10133,438,2612,1081,0,0,14264
10/8/2016,4,10152,433,2530,1119,0,0,14234
10/8/2016,5,10155,439,2569,966,0,0,14129
10/8/2016,6,10353,440,2608,1284,2,0,14687
10/8/2016,7,10628,438,2678,1503,4,1,15252
10/8/2016,8,10771,441,2941,1378,13,1,15545
10/8/2016,9,11004,442,3082,1468,54,0,16050
10/8/2016,10,11006,442,3143,1479,65,13,16148
10/8/2016,11,10995,484,3070,1519,84,35,16187
10/8/2016,12,10992,494,3059,1508,109,45,16207
10/8/2016,13,10987,493,3078,1267,147,54,16026
10/8/2016,14,10944,494,3096,1149,181,54,15918
10/8/2016,15,10999,499,3083,1174,132,54,15941
10/8/2016,16,11009,504,3074,1451,83,54,16175
10/8/2016,17,11011,499,3266,1484,33,54,16347
10/8/2016,18,11023,502,3462,1511,6,55,16559
10/8/2016,19,11033,500,3990,1315,0,55,16893
10/8/2016,20,11047,500,3755,1369,0,55,16726
10/8/2016,21,11052,502,3350,1401,0,53,16358
10/8/2016,22,11081,500,3085,1012,0,4,15682
10/8/2016,23,11068,500,2904,731,0,0,15203
10/8/2016,24,10917,499,2583,395,0,0,14394
10/9/2016,1,10771,497,2594,492,0,0,14354
10/9/2016,2,10537,500,2517,284,0,0,13838
10/9/2016,3,10235,504,2554,474,0,0,13767
10/9/2016,4,9820,509,2741,491,0,9,13570
10/9/2016,5,9481,516,2646,1216,0,8,13867
10/9/2016,6,9829,504,2676,1096,0,11,14116
10/9/2016,7,10234,506,2723,1085,1,9,14558
10/9/2016,8,10312,506,3026,819,33,6,14702
10/9/2016,9,10316,507,3544,574,102,0,15043
10/9/2016,10,10320,509,3569,713,175,13,15299
10/9/2016,11,10330,511,3310,534,174,51,14910
10/9/2016,12,10347,509,3239,783,106,58,15042
10/9/2016,13,10346,513,3217,928,125,58,15187
10/9/2016,14,10350,510,3250,1195,102,59,15466
10/9/2016,15,10407,519,3208,1155,147,59,15495
10/9/2016,16,10423,520,3222,1312,86,59,15622
10/9/2016,17,10423,543,3434,1116,54,59,15629
10/9/2016,18,10430,696,3696,852,5,59,15738
10/9/2016,19,10427,704,4273,911,0,58,16373
10/9/2016,20,10426,701,4123,952,0,58,16260
10/9/2016,21,10438,701,3586,988,0,54,15767
10/9/2016,22,10482,572,3235,929,0,6,15224
10/9/2016,23,10506,511,3058,779,0,0,14854
10/9/2016,24,10510,515,2798,782,0,4,14609
10/10/2016,1,10504,517,2584,685,0,4,14294
10/10/2016,2,10510,519,2492,559,0,4,14084
10/10/2016,3,10513,514,2525,363,0,4,13919
10/10/2016,4,10497,513,2567,377,0,4,13958
10/10/2016,5,10241,515,2555,452,0,4,13767
10/10/2016,6,10220,516,2658,605,0,4,14003
10/10/2016,7,10438,515,2706,380,7,4,14050
10/10/2016,8,10514,513,2841,365,71,4,14308
10/10/2016,9,10516,501,2875,191,75,5,14163
10/10/2016,10,10504,497,3169,123,163,16,14472
10/10/2016,11,10488,493,3293,101,77,54,14506
10/10/2016,12,10486,497,3290,161,191,62,14687
10/10/2016,13,10336,499,3328,257,226,61,14707
10/10/2016,14,10327,490,3274,278,232,59,14660
10/10/2016,15,10407,490,3328,287,207,62,14781
10/10/2016,16,10480,492,3704,290,152,59,15177
10/10/2016,17,10474,495,3916,297,71,63,15316
10/10/2016,18,10473,506,4416,317,8,62,15782
10/10/2016,19,10474,530,4465,537,0,62,16068
10/10/2016,20,10473,496,4095,750,0,63,15877
10/10/2016,21,10472,496,3781,845,0,62,15656
10/10/2016,22,10473,491,3307,935,0,15,15221
10/10/2016,23,10472,489,2973,1030,0,3,14967
10/10/2016,24,10476,484,2593,861,0,3,14417
10/11/2016,1,10411,491,2567,544,0,3,14016
10/11/2016,2,10185,490,2537,861,0,19,14092
10/11/2016,3,10183,497,2579,805,0,21,14085
10/11/2016,4,9920,518,2589,1214,0,19,14260
10/11/2016,5,9884,542,2680,905,0,25,14036
10/11/2016,6,10167,593,3213,1292,0,31,15296
10/11/2016,7,10479,719,3776,1403,8,35,16420
10/11/2016,8,10482,785,3646,1240,68,35,16256
10/11/2016,9,10472,796,3674,845,144,35,15966
10/11/2016,10,10483,819,3758,639,180,46,15925
10/11/2016,11,10485,841,3623,749,196,82,15976
10/11/2016,12,10490,869,3726,680,168,142,16075
10/11/2016,13,10482,900,3825,672,176,182,16237
10/11/2016,14,10479,967,4043,648,141,185,16463
10/11/2016,15,10474,1035,4151,629,100,184,16573
10/11/2016,16,10469,1048,4413,649,69,185,16833
10/11/2016,17,10484,1184,4587,598,27,185,17065
10/11/2016,18,10484,1247,4855,584,2,185,17357
10/11/2016,19,10488,1230,4757,812,0,186,17473
10/11/2016,20,10482,1212,4400,1148,0,186,17428
10/11/2016,21,10482,907,4033,1418,0,186,17026
10/11/2016,22,10481,793,3348,1534,1,158,16315
10/11/2016,23,10483,780,2780,1296,0,46,15385
10/11/2016,24,10419,771,2657,863,0,20,14730
10/12/2016,1,10190,766,2628,771,0,21,14376
10/12/2016,2,10193,771,2565,837,0,22,14388
10/12/2016,3,10197,771,2548,631,0,20,14167
10/12/2016,4,10190,772,2584,742,0,20,14308
10/12/2016,5,10203,769,2727,661,0,26,14386
10/12/2016,6,10464,770,2783,1625,0,32,15674
10/12/2016,7,10478,790,2979,1938,3,62,16250
10/12/2016,8,10477,789,3154,1855,44,89,16408
10/12/2016,9,10482,784,3356,1524,123,94,16363
10/12/2016,10,10496,781,3499,1245,185,94,16300
10/12/2016,11,10496,779,3434,1206,205,94,16214
10/12/2016,12,10489,777,3403,1550,200,94,16513
10/12/2016,13,10504,776,3594,1422,197,95,16588
10/12/2016,14,10488,774,3535,1636,192,94,16719
10/12/2016,15,10483,763,3599,1611,145,95,16696
10/12/2016,16,10481,784,3507,2295,75,94,17236
10/12/2016,17,10474,778,3608,2649,34,95,17638
10/12/2016,18,10472,782,3685,2842,1,97,17879
10/12/2016,19,10475,787,3667,3314,0,99,18342
10/12/2016,20,10469,789,3659,3126,0,94,18137
10/12/2016,21,10472,788,3412,2708,0,93,17473
10/12/2016,22,10462,785,3119,2072,0,51,16489
10/12/2016,23,10463,775,2742,1354,0,24,15358
10/12/2016,24,10467,767,2654,1035,0,21,14944
10/13/2016,1,10385,763,2621,662,0,21,14452
10/13/2016,2,10126,760,2591,465,0,20,13962
10/13/2016,3,10092,764,2618,411,0,24,13909
10/13/2016,4,10013,765,2749,477,0,30,14034
10/13/2016,5,9995,764,2736,1042,0,40,14577
10/13/2016,6,10246,769,2779,1513,0,51,15358
10/13/2016,7,10269,794,2875,1993,1,74,16006
10/13/2016,8,10279,798,3371,2269,10,69,16796
10/13/2016,9,10284,799,3415,2163,46,46,16753
10/13/2016,10,10284,808,3381,2143,70,65,16751
10/13/2016,11,10285,820,3223,1968,97,54,16447
10/13/2016,12,10290,859,3225,1557,156,57,16144
10/13/2016,13,10304,938,3219,1505,153,55,16174
10/13/2016,14,10317,1039,3263,1062,141,55,15877
10/13/2016,15,10326,1228,3477,636,161,54,15882
10/13/2016,16,10327,1308,3638,478,136,57,15944
10/13/2016,17,10348,1339,3934,387,55,53,16116
10/13/2016,18,10361,1573,4411,319,5,56,16725
10/13/2016,19,10375,1608,4779,304,1,48,17115
10/13/2016,20,10386,1617,4750,277,0,34,17064
10/13/2016,21,10396,1502,4379,260,0,33,16570
10/13/2016,22,10394,953,3921,278,0,36,15582
10/13/2016,23,10399,791,3612,263,0,23,15088
10/13/2016,24,10404,775,2953,241,0,20,14393
10/14/2016,1,10334,735,2894,407,0,19,14389
10/14/2016,2,10102,752,2898,507,0,19,14278
10/14/2016,3,10123,761,2780,538,0,19,14221
10/14/2016,4,10164,758,2763,606,0,20,14311
10/14/2016,5,10385,763,3057,580,0,25,14810
10/14/2016,6,10471,774,3932,373,1,29,15580
10/14/2016,7,10481,876,4505,398,9,41,16310
10/14/2016,8,10479,824,4115,423,66,83,15990
10/14/2016,9,10471,799,4204,346,135,122,16077
10/14/2016,10,10464,874,4363,256,190,167,16314
10/14/2016,11,10465,885,3928,433,211,162,16084
10/14/2016,12,10459,817,3707,684,170,155,15992
10/14/2016,13,10449,813,3742,708,186,191,16089
10/14/2016,14,10455,888,3732,599,188,190,16052
10/14/2016,15,10456,963,3843,430,180,189,16061
10/14/2016,16,10453,966,4080,424,126,189,16238
10/14/2016,17,10454,1010,4622,515,57,189,16847
10/14/2016,18,10451,1019,4766,609,4,189,17038
10/14/2016,19,10452,1020,4802,818,0,189,17281
10/14/2016,20,10452,1000,4448,1366,0,164,17430
10/14/2016,21,10446,847,4043,1728,0,156,17220
10/14/2016,22,9728,788,3854,1535,0,120,16025
10/14/2016,23,9608,669,3534,1717,0,65,15593
10/14/2016,24,9615,599,2846,2037,0,2,15099
10/15/2016,1,9613,593,2591,2080,0,0,14877
10/15/2016,2,9583,593,2542,2187,0,0,14905
10/15/2016,3,9612,588,2644,1980,0,0,14824
10/15/2016,4,9618,536,2625,1520,0,0,14299
10/15/2016,5,9623,536,2703,1601,0,0,14463
10/15/2016,6,9628,535,2771,1749,0,0,14683
10/15/2016,7,9630,535,3115,1964,5,0,15249
10/15/2016,8,9626,540,3603,1894,54,0,15717
10/15/2016,9,9622,561,4070,1613,115,0,15981
10/15/2016,10,9619,601,3648,1694,159,0,15721
10/15/2016,11,9621,507,3380,1701,194,0,15403
10/15/2016,12,9622,486,3824,1658,199,0,15789
10/15/2016,13,9615,484,3703,1769,198,0,15769
10/15/2016,14,9606,483,3580,1939,196,0,15804
10/15/2016,15,9605,488,3629,1972,163,0,15857
10/15/2016,16,9603,513,3981,1799,104,0,16000
10/15/2016,17,9607,545,4475,1636,40,0,16303
10/15/2016,18,9603,616,4575,1791,1,0,16586
10/15/2016,19,9591,766,4693,2051,0,0,17101
10/15/2016,20,9583,800,3993,2661,1,0,17038
10/15/2016,21,9585,698,3424,3094,0,0,16801
10/15/2016,22,9587,577,2995,2910,0,0,16069
10/15/2016,23,9592,611,2623,2199,0,0,15025
10/15/2016,24,9595,613,2572,1225,0,0,14005
10/16/2016,1,9597,580,2606,1226,0,0,14009
10/16/2016,2,9605,603,2575,1211,0,0,13994
10/16/2016,3,9605,603,2563,843,0,0,13614
10/16/2016,4,9460,605,2574,796,0,0,13435
10/16/2016,5,9311,612,2721,1283,0,0,13927
10/16/2016,6,9309,631,2705,1177,0,0,13822
10/16/2016,7,9318,654,2723,1683,1,0,14379
10/16/2016,8,9577,698,2780,1940,21,0,15016
10/16/2016,9,9598,711,3066,2486,48,0,15909
10/16/2016,10,9598,749,3166,2523,106,0,16142
10/16/2016,11,9606,770,3490,2547,131,0,16544
10/16/2016,12,9610,810,3921,2179,113,0,16633
10/16/2016,13,9613,1055,4366,1927,65,0,17026
10/16/2016,14,9617,1277,4084,1671,47,0,16696
10/16/2016,15,9621,1309,3813,1521,29,0,16293
10/16/2016,16,9584,1346,4320,1297,21,0,16568
10/16/2016,17,9393,1524,4759,1024,21,0,16721
10/16/2016,18,9190,1793,4958,758,0,0,16699
10/16/2016,19,9194,1966,5004,679,0,0,16843
10/16/2016,20,9193,1680,4839,674,0,0,16386
10/16/2016,21,9196,1487,4593,445,0,0,15721
10/16/2016,22,9193,1148,4437,346,0,0,15124
10/16/2016,23,9192,790,4205,385,0,0,14572
10/16/2016,24,9197,542,4199,404,0,0,14342
10/17/2016,1,9202,519,3758,467,0,4,13950
10/17/2016,2,9205,538,3530,472,0,22,13767
10/17/2016,3,9202,614,3570,505,0,33,13924
10/17/2016,4,9205,845,3370,543,0,23,13986
10/17/2016,5,9205,1141,3254,705,0,36,14341
10/17/2016,6,9204,1394,3491,905,0,48,15042
10/17/2016,7,9202,1569,4057,1114,3,47,15992
10/17/2016,8,9195,1756,4273,1284,6,60,16574
10/17/2016,9,9195,1685,4297,1482,20,64,16743
10/17/2016,10,9193,1686,4094,1756,47,64,16840
10/17/2016,11,9187,1697,3902,1934,102,65,16887
10/17/2016,12,9191,1657,3767,2135,65,64,16879
10/17/2016,13,9193,1715,3718,2389,66,66,17147
10/17/2016,14,9188,1219,3787,2451,77,63,16785
10/17/2016,15,9183,1139,4095,2409,85,60,16971
10/17/2016,16,9182,1268,4617,2057,53,59,17236
10/17/2016,17,9188,1617,5034,1765,23,63,17690
10/17/2016,18,9191,1739,4574,1835,1,63,17403
10/17/2016,19,9186,1590,4109,2067,0,65,17017
10/17/2016,20,9182,1327,4110,2262,0,64,16945
10/17/2016,21,9171,1274,3757,2543,0,60,16805
10/17/2016,22,9169,966,3337,2470,0,63,16005
10/17/2016,23,9163,763,3023,2474,0,54,15477
10/17/2016,24,9164,711,2698,2288,0,49,14910
10/18/2016,1,9179,697,2584,1879,0,46,14385
10/18/2016,2,9187,697,2519,1624,0,49,14076
10/18/2016,3,9192,766,2494,1480,0,51,13983
10/18/2016,4,9192,778,2515,1363,0,50,13898
10/18/2016,5,9194,980,2652,1633,0,56,14515
10/18/2016,6,9194,1238,2768,2402,0,67,15669
10/18/2016,7,9191,1352,2753,2972,0,73,16341
10/18/2016,8,9190,1348,3123,2878,40,72,16651
10/18/2016,9,9185,1504,3166,3073,72,71,17071
10/18/2016,10,9184,1654,3523,2725,92,76,17254
10/18/2016,11,9181,1730,3774,2608,144,73,17510
10/18/2016,12,9153,1770,3748,2949,134,73,17827
10/18/2016,13,9147,2016,3606,3128,62,73,18032
10/18/2016,14,9149,2410,3376,3084,44,72,18135
10/18/2016,15,9160,2543,3187,2872,12,67,17841
10/18/2016,16,9166,2630,3333,2560,6,74,17769
10/18/2016,17,9163,2789,3659,2339,2,113,18065
10/18/2016,18,9167,2985,3919,1970,0,209,18250
10/18/2016,19,9165,3309,4160,1771,0,224,18629
10/18/2016,20,9162,3170,4062,1547,0,222,18163
10/18/2016,21,9167,2742,3967,1080,0,224,17180
10/18/2016,22,9196,1750,3729,769,0,195,15639
10/18/2016,23,9168,875,3372,569,0,96,14080
10/18/2016,24,9168,709,3203,544,0,45,13669
10/19/2016,1,9170,714,3061,614,0,37,13596
10/19/2016,2,9172,732,3073,521,0,43,13541
10/19/2016,3,9171,836,3156,395,0,45,13603
10/19/2016,4,9175,1190,2992,283,0,49,13689
10/19/2016,5,9183,1676,2933,264,0,56,14112
10/19/2016,6,9199,2264,3050,199,1,56,14769
10/19/2016,7,9202,3004,3235,228,3,57,15729
10/19/2016,8,9199,2782,3418,235,47,60,15741
10/19/2016,9,9197,2643,3169,185,103,58,15355
10/19/2016,10,9193,2624,3144,136,146,58,15301
10/19/2016,11,9194,2467,3133,146,155,61,15156
10/19/2016,12,9193,2171,3308,291,175,58,15196
10/19/2016,13,9188,2189,3503,313,185,55,15433
10/19/2016,14,9184,2387,3374,449,185,51,15630
10/19/2016,15,9178,2634,3392,432,155,58,15849
10/19/2016,16,9172,2886,3552,293,107,47,16057
10/19/2016,17,9170,3149,3729,235,42,52,16377
10/19/2016,18,9172,3329,3984,210,1,44,16740
10/19/2016,19,9173,3495,4181,269,0,50,17168
10/19/2016,20,9159,3278,4152,233,0,54,16876
10/19/2016,21,9160,2710,3764,223,0,56,15913
10/19/2016,22,9163,2371,3123,211,0,55,14923
10/19/2016,23,9172,1431,2788,152,0,35,13578
10/19/2016,24,9169,806,2681,155,0,23,12834
10/20/2016,1,9212,726,2794,298,0,17,13047
10/20/2016,2,9221,738,3076,281,0,16,13332
10/20/2016,3,9219,829,2899,321,0,18,13286
10/20/2016,4,9217,1060,2839,452,0,20,13588
10/20/2016,5,9215,1436,2792,583,0,22,14048
10/20/2016,6,9212,2008,2901,710,0,28,14859
10/20/2016,7,9212,2423,2977,986,0,38,15636
10/20/2016,8,9206,2350,3170,746,0,38,15510
10/20/2016,9,9199,2485,3618,809,7,34,16152
10/20/2016,10,9195,2878,3668,593,11,34,16379
10/20/2016,11,9217,2793,3512,644,22,35,16223
10/20/2016,12,9396,2152,3462,783,27,35,15855
10/20/2016,13,9498,2002,3471,759,26,34,15790
10/20/2016,14,9580,2094,3295,778,20,34,15801
10/20/2016,15,9561,2166,3297,713,9,34,15780
10/20/2016,16,9577,2297,3369,768,6,34,16051
10/20/2016,17,9719,2161,3538,866,2,40,16326
10/20/2016,18,9764,2273,3604,974,1,34,16650
10/20/2016,19,9764,2187,3888,1034,1,33,16907
10/20/2016,20,9764,2160,3782,1066,1,33,16806
10/20/2016,21,9759,1890,3720,1176,1,32,16578
10/20/2016,22,9760,1421,3248,1276,1,33,15739
10/20/2016,23,9773,870,2976,1434,1,23,15077
10/20/2016,24,9778,721,2785,850,1,17,14152
10/21/2016,1,9774,719,2740,906,1,16,14156
10/21/2016,2,9797,726,2737,560,1,17,13838
10/21/2016,3,9798,726,2737,371,1,16,13649
10/21/2016,4,9578,722,2764,621,1,19,13705
10/21/2016,5,9725,721,2833,863,1,21,14164
10/21/2016,6,9873,793,2879,1295,1,28,14869
10/21/2016,7,9875,830,3001,1954,1,33,15694
10/21/2016,8,9889,791,3262,2241,2,35,16220
10/21/2016,9,9898,745,3551,2311,4,37,16546
10/21/2016,10,9900,743,3460,2290,10,34,16437
10/21/2016,11,9901,745,3440,2330,16,34,16466
10/21/2016,12,9911,811,3473,2168,23,34,16420
10/21/2016,13,9953,827,3296,2082,31,34,16223
10/21/2016,14,9878,971,3250,2372,34,34,16539
10/21/2016,15,9904,1109,3355,2044,36,39,16487
10/21/2016,16,9997,1168,3524,2195,19,53,16956
10/21/2016,17,9997,1150,3592,1994,6,34,16773
10/21/2016,18,9997,1147,3733,2360,1,34,17272
10/21/2016,19,9994,1150,3751,2249,0,34,17178
10/21/2016,20,9994,1150,3615,2232,0,34,17025
10/21/2016,21,9992,1151,3628,2065,0,34,16870
10/21/2016,22,10013,1149,3348,1693,0,34,16237
10/21/2016,23,10004,989,3060,1014,0,7,15074
10/21/2016,24,10009,664,2875,1020,0,0,14568
10/22/2016,1,10002,553,2803,740,0,0,14098
10/22/2016,2,10007,552,2801,400,0,0,13760
10/22/2016,3,10012,551,2814,311,0,0,13688
10/22/2016,4,10018,550,2787,383,0,0,13738
10/22/2016,5,10041,551,2799,521,0,0,13912
10/22/2016,6,10051,551,2865,994,0,0,14461
10/22/2016,7,10055,551,2953,1610,0,0,15169
10/22/2016,8,10054,553,3137,2042,17,0,15803
10/22/2016,9,10053,553,3284,2208,47,0,16145
10/22/2016,10,10052,553,3398,1966,42,1,16012
10/22/2016,11,10050,553,3333,1949,59,4,15948
10/22/2016,12,10047,551,3318,1709,99,6,15730
10/22/2016,13,10049,550,3302,1441,101,10,15453
10/22/2016,14,10058,549,3373,1219,97,21,15317
10/22/2016,15,10075,549,3326,1321,91,23,15385
10/22/2016,16,10071,550,3320,1706,67,16,15730
10/22/2016,17,10074,553,3713,2205,27,4,16576
10/22/2016,18,10067,553,4151,1908,0,4,16683
10/22/2016,19,10077,563,4507,1888,0,4,17039
10/22/2016,20,10080,584,4507,1643,0,3,16817
10/22/2016,21,10078,558,4113,1777,0,3,16529
10/22/2016,22,10089,551,3714,1964,0,3,16321
10/22/2016,23,10096,550,3060,1840,0,2,15548
10/22/2016,24,10094,553,2795,2031,0,2,15475
10/23/2016,1,10100,550,2853,1464,0,2,14969
10/23/2016,2,10099,546,2784,1075,0,2,14506
10/23/2016,3,10090,550,2751,986,0,2,14379
10/23/2016,4,10085,549,2749,950,0,2,14335
10/23/2016,5,10087,547,2796,1016,0,0,14446
10/23/2016,6,10088,543,2895,1101,0,0,14627
10/23/2016,7,10085,558,2928,1159,4,0,14734
10/23/2016,8,10092,550,2944,1032,47,0,14665
10/23/2016,9,10096,548,3044,891,124,0,14703
10/23/2016,10,10100,545,3233,726,177,0,14781
10/23/2016,11,10109,544,3367,688,198,1,14907
10/23/2016,12,10159,548,3300,720,174,0,14901
10/23/2016,13,10070,547,3308,781,163,0,14869
10/23/2016,14,10045,569,3322,1083,144,0,15163
10/23/2016,15,10156,576,3384,826,85,0,15027
10/23/2016,16,10250,596,3588,1020,55,0,15509
10/23/2016,17,10316,778,4206,856,21,4,16181
10/23/2016,18,10368,1078,4598,592,0,9,16645
10/23/2016,19,10375,1172,4385,445,0,13,16390
10/23/2016,20,10464,916,4039,473,0,10,15902
10/23/2016,21,10490,610,3647,362,0,2,15111
10/23/2016,22,10491,552,3359,606,0,2,15010
10/23/2016,23,10494,550,3216,381,0,2,14643
10/23/2016,24,10488,552,2839,495,0,15,14389
10/24/2016,1,10483,550,2787,498,0,19,14337
10/24/2016,2,10248,551,2794,315,0,20,13928
10/24/2016,3,10196,548,2782,469,0,24,14019
10/24/2016,4,10199,548,2779,571,0,22,14119
10/24/2016,5,10279,554,2821,800,0,26,14480
10/24/2016,6,10512,577,2834,1634,0,34,15591
10/24/2016,7,10512,703,3116,2026,2,46,16405
10/24/2016,8,10515,738,3397,2048,20,54,16772
10/24/2016,9,10523,736,3268,2155,75,55,16812
10/24/2016,10,10527,738,3386,2271,98,54,17074
10/24/2016,11,10527,743,3379,2120,123,44,16936
10/24/2016,12,10525,743,3358,2194,129,40,16989
10/24/2016,13,10523,743,3280,2303,132,34,17015
10/24/2016,14,10517,741,3259,2165,159,41,16882
10/24/2016,15,10511,748,3345,2278,163,37,17082
10/24/2016,16,10532,751,3418,2270,102,35,17108
10/24/2016,17,10551,782,3705,2252,28,41,17359
10/24/2016,18,10582,981,4214,2082,0,45,17904
10/24/2016,19,10605,1282,4194,1779,0,53,17913
10/24/2016,20,10604,1202,4270,1740,0,51,17867
10/24/2016,21,10602,1048,3865,1697,0,37,17249
10/24/2016,22,10630,784,3644,1421,0,35,16514
10/24/2016,23,10645,748,3060,1299,0,24,15776
10/24/2016,24,10645,715,2887,756,0,21,15024
10/25/2016,1,10652,703,2804,723,0,19,14901
10/25/2016,2,10658,730,2791,368,0,23,14570
10/25/2016,3,10636,734,2702,323,0,25,14420
10/25/2016,4,10367,758,2755,590,0,22,14492
10/25/2016,5,10347,826,2919,882,0,28,15002
10/25/2016,6,10427,1035,3041,1196,1,43,15743
10/25/2016,7,10654,1106,3238,1458,3,73,16532
10/25/2016,8,10649,1157,3419,1336,37,124,16722
10/25/2016,9,10650,1197,3139,1148,93,138,16365
10/25/2016,10,10655,1237,3242,1065,191,138,16528
10/25/2016,11,10656,1273,3215,906,206,138,16394
10/25/2016,12,10658,1150,3215,825,184,138,16170
10/25/2016,13,10666,1243,3200,1015,123,139,16386
10/25/2016,14,10660,1361,3228,651,120,138,16158
10/25/2016,15,10650,1331,3346,801,106,138,16372
10/25/2016,16,10661,1420,3428,1185,37,139,16870
10/25/2016,17,10663,1615,4063,964,6,138,17449
10/25/2016,18,10661,2007,4522,771,0,131,18092
10/25/2016,19,10665,1993,4604,630,0,63,17955
10/25/2016,20,10663,1948,4332,569,1,43,17556
10/25/2016,21,10650,1928,4288,491,0,35,17392
10/25/2016,22,10656,1168,3328,381,0,34,15567
10/25/2016,23,10654,762,3085,405,0,24,14930
10/25/2016,24,10664,734,2904,394,0,20,14716
10/26/2016,1,10665,733,2835,662,0,19,14914
10/26/2016,2,10671,743,2821,340,0,18,14593
10/26/2016,3,10671,826,2850,399,0,19,14765
10/26/2016,4,10640,1038,2823,331,0,18,14850
10/26/2016,5,10383,1372,3065,632,0,26,15478
10/26/2016,6,10453,1720,3466,718,0,32,16389
10/26/2016,7,10677,1904,3684,878,1,47,17191
10/26/2016,8,10676,2212,3839,1016,37,85,17865
10/26/2016,9,10671,1950,3328,683,101,136,16869
10/26/2016,10,10670,1810,3322,559,130,138,16629
10/26/2016,11,10671,1904,3491,534,137,138,16875
10/26/2016,12,10676,1785,3438,601,143,138,16781
10/26/2016,13,10539,1786,3431,661,131,138,16686
10/26/2016,14,10518,2117,3551,593,106,138,17023
10/26/2016,15,10518,2117,3556,709,61,136,17097
10/26/2016,16,10650,2218,3530,865,29,137,17429
10/26/2016,17,10683,2337,3487,891,8,137,17543
10/26/2016,18,10684,2224,3768,1343,0,137,18156
10/26/2016,19,10685,2223,3920,1419,0,138,18385
10/26/2016,20,10680,2089,3872,1154,0,138,17933
10/26/2016,21,10678,1261,3590,1489,0,125,17143
10/26/2016,22,10671,771,3213,2042,0,44,16741
10/26/2016,23,10673,758,2825,1949,0,25,16230
10/26/2016,24,10674,743,2874,1315,0,20,15626
10/27/2016,1,10688,743,2780,1011,0,20,15242
10/27/2016,2,10686,746,2767,709,0,20,14928
10/27/2016,3,10682,841,2721,577,0,22,14843
10/27/2016,4,10680,1071,2757,496,0,20,15024
10/27/2016,5,10665,1402,2741,723,0,26,15557
10/27/2016,6,10649,1776,2730,1444,0,36,16635
10/27/2016,7,10651,1805,3224,1791,4,61,17536
10/27/2016,8,10652,2122,3613,1679,6,97,18169
10/27/2016,9,10651,2359,3800,1394,21,138,18363
10/27/2016,10,10657,2442,3727,1313,30,138,18307
10/27/2016,11,10644,2450,3578,1331,40,143,18186
10/27/2016,12,10631,2103,3479,1523,37,138,17911
10/27/2016,13,10633,1849,3629,1568,30,130,17839
10/27/2016,14,10631,2023,3769,1403,37,139,18002
10/27/2016,15,10633,2046,3784,1331,28,141,17963
10/27/2016,16,10629,1921,3946,1480,17,175,18168
10/27/2016,17,10640,1844,4283,1424,3,130,18324
10/27/2016,18,10654,2280,4475,1058,0,93,18560
10/27/2016,19,10662,2480,4459,720,0,147,18468
10/27/2016,20,10663,2258,4397,571,0,195,18084
10/27/2016,21,10663,1595,3800,588,0,190,16836
10/27/2016,22,10661,1074,3239,604,0,160,15738
10/27/2016,23,10702,955,2961,450,0,55,15123
10/27/2016,24,10703,769,2905,440,0,20,14837
10/28/2016,1,10705,743,2910,455,0,19,14832
10/28/2016,2,10707,746,3042,466,0,18,14979
10/28/2016,3,10702,855,3012,469,0,18,15056
10/28/2016,4,10699,1158,2970,492,0,19,15338
10/28/2016,5,10695,1569,3020,541,0,24,15849
10/28/2016,6,10687,2065,3204,492,0,28,16476
10/28/2016,7,10677,2780,3828,382,2,45,17714
10/28/2016,8,10675,3123,3881,337,22,79,18117
10/28/2016,9,10687,2909,3953,299,73,160,18081
10/28/2016,10,10683,2292,3827,230,122,190,17344
10/28/2016,11,10699,2030,3789,239,131,189,17077
10/28/2016,12,10706,1848,3581,431,132,190,16888
10/28/2016,13,10711,1744,3713,611,126,190,17095
10/28/2016,14,10701,1765,3492,453,117,150,16678
10/28/2016,15,10710,1772,3420,619,91,114,16726
10/28/2016,16,10710,1773,3471,423,46,97,16520
10/28/2016,17,10710,1743,3629,1065,23,107,17277
10/28/2016,18,10709,1744,4039,1473,0,111,18076
10/28/2016,19,10710,1860,3985,2018,0,107,18680
10/28/2016,20,10704,1154,3621,2475,0,75,18029
10/28/2016,21,10702,833,3411,2906,0,62,17914
10/28/2016,22,10706,732,3077,2589,0,8,17112
10/28/2016,23,10719,574,2894,2014,0,2,16203
10/28/2016,24,10706,518,2829,913,0,2,14968
10/29/2016,1,10452,517,2849,852,0,2,14672
10/29/2016,2,10441,519,2768,1328,0,2,15058
10/29/2016,3,10427,518,2802,1190,0,2,14939
10/29/2016,4,10422,517,2756,1078,0,2,14775
10/29/2016,5,10402,551,2785,894,0,2,14634
10/29/2016,6,10406,472,2828,1288,0,2,14996
10/29/2016,7,10438,471,2894,1735,1,2,15541
10/29/2016,8,10693,471,2915,2579,3,2,16663
10/29/2016,9,10701,471,2974,3079,18,2,17245
10/29/2016,10,10698,470,3187,3138,28,2,17523
10/29/2016,11,10697,472,3355,3095,29,2,17650
10/29/2016,12,10717,546,3397,2895,35,2,17592
10/29/2016,13,10721,554,3470,2367,45,3,17160
10/29/2016,14,10719,704,3610,2146,45,3,17227
10/29/2016,15,10676,833,3534,1703,20,2,16768
10/29/2016,16,10709,890,3662,1681,13,2,16957
10/29/2016,17,10724,870,3724,1442,1,2,16763
10/29/2016,18,10735,895,4022,1163,1,2,16818
10/29/2016,19,10736,871,4062,1196,1,2,16868
10/29/2016,20,10729,883,4117,893,1,2,16625
10/29/2016,21,10729,924,4208,714,1,2,16578
10/29/2016,22,10729,922,4049,625,1,2,16328
10/29/2016,23,10733,909,3424,482,1,2,15551
10/29/2016,24,10736,592,3011,405,1,3,14748
10/30/2016,1,10736,501,2926,315,1,2,14481
10/30/2016,2,10739,502,3269,232,1,4,14747
10/30/2016,3,10741,503,3090,162,1,5,14502
10/30/2016,4,10749,498,3210,112,1,11,14581
10/30/2016,5,10746,498,2962,99,1,11,14317
10/30/2016,6,10744,482,3130,115,1,3,14475
10/30/2016,7,10745,487,3318,286,2,4,14842
10/30/2016,8,10740,575,3381,446,7,4,15153
10/30/2016,9,10741,561,3275,556,20,4,15157
10/30/2016,10,10735,609,3581,733,36,4,15698
10/30/2016,11,10733,681,3790,827,43,4,16078
10/30/2016,12,10736,799,3571,958,44,3,16111
10/30/2016,13,10734,961,3595,1001,47,3,16341
10/30/2016,14,10733,1057,3438,1169,51,17,16465
10/30/2016,15,10735,1234,3630,1397,37,49,17082
10/30/2016,16,10732,1351,3775,1395,22,140,17415
10/30/2016,17,10731,1401,3600,1292,3,158,17185
10/30/2016,18,10732,1553,4067,1079,0,165,17596
10/30/2016,19,10731,1851,4262,799,0,164,17807
10/30/2016,20,10724,1947,4170,733,0,153,17727
10/30/2016,21,10734,1747,4048,599,0,120,17248
10/30/2016,22,10719,1451,3759,466,0,19,16414
10/30/2016,23,10724,1080,3541,420,0,3,15768
10/30/2016,24,10740,719,3027,304,0,4,14794
10/31/2016,1,10741,520,3139,196,0,4,14600
10/31/2016,2,10745,522,3083,134,0,5,14489
10/31/2016,3,10747,542,3051,166,0,5,14511
10/31/2016,4,10745,643,3096,214,0,5,14703
10/31/2016,5,10747,1045,3069,236,0,5,15102
10/31/2016,6,10746,1753,3030,199,0,6,15734
10/31/2016,7,10746,2136,3578,322,2,33,16817
10/31/2016,8,10744,2207,3682,362,35,63,17093
10/31/2016,9,10744,1964,3571,356,117,133,16885
10/31/2016,10,10742,1749,3675,328,167,155,16816
10/31/2016,11,10747,1700,3757,375,166,160,16905
10/31/2016,12,10742,1560,3697,410,175,162,16746
10/31/2016,13,10735,1542,3760,388,184,133,16742
10/31/2016,14,10733,1465,3675,488,164,133,16658
10/31/2016,15,10741,1360,3503,646,115,133,16498
10/31/2016,16,10735,1545,3598,876,65,133,16952
10/31/2016,17,10744,1758,3823,709,13,137,17184
10/31/2016,18,10742,1777,3938,916,0,110,17483
10/31/2016,19,10741,1738,3995,967,1,121,17563
10/31/2016,20,10739,1410,3693,1359,0,122,17323
10/31/2016,21,10735,985,3743,1762,0,88,17313
10/31/2016,22,10723,888,3481,1844,0,15,16951
10/31/2016,23,10736,769,3069,1328,0,13,15915
10/31/2016,24,10727,695,2755,483,0,21,14681
11/1/2016,1,10468,693,2733,868,0,20,14782
11/1/2016,2,10426,694,2580,762,0,20,14482
11/1/2016,3,10422,691,2572,673,0,21,14379
11/1/2016,4,10409,692,2244,1206,0,22,14573
11/1/2016,5,10413,696,2386,1148,0,27,14670
11/1/2016,6,10640,698,2618,2010,0,33,15999
11/1/2016,7,10717,706,2882,2678,1,38,17022
11/1/2016,8,10717,705,3055,2442,20,39,16978
11/1/2016,9,10717,785,3137,2426,91,39,17195
11/1/2016,10,10734,807,3128,2511,132,38,17350
11/1/2016,11,10716,1062,3278,2149,124,38,17367
11/1/2016,12,10717,1255,3259,1833,110,38,17212
11/1/2016,13,10718,1372,3219,1835,120,38,17302
11/1/2016,14,10720,1342,3187,1813,93,37,17192
11/1/2016,15,10730,1390,3172,1893,65,39,17289
11/1/2016,16,10727,1522,3102,2194,38,36,17619
11/1/2016,17,10727,1552,3346,2226,15,35,17901
11/1/2016,18,10729,1697,3616,2521,0,35,18598
11/1/2016,19,10729,1710,3438,2596,0,35,18508
11/1/2016,20,10724,1706,3386,2154,0,35,18005
11/1/2016,21,10709,1259,3400,1887,0,36,17291
11/1/2016,22,10706,817,3164,1724,1,35,16447
11/1/2016,23,10717,834,2801,996,0,26,15374
11/1/2016,24,10653,839,2606,604,0,24,14726
11/2/2016,1,10356,900,2626,575,0,22,14479
11/2/2016,2,10128,910,2596,528,0,20,14182
11/2/2016,3,10111,1004,2580,332,0,21,14048
11/2/2016,4,9666,1323,2589,453,0,24,14055
11/2/2016,5,9654,1760,2802,395,0,27,14638
11/2/2016,6,10121,2172,3209,271,0,30,15803
11/2/2016,7,10683,2459,3631,278,3,35,17089
11/2/2016,8,10729,2565,3755,248,14,36,17347
11/2/2016,9,10726,2297,3880,226,52,55,17236
11/2/2016,10,10725,2332,3864,118,119,93,17251
11/2/2016,11,10726,2419,3276,73,124,183,16801
11/2/2016,12,10733,2195,3178,37,77,183,16403
11/2/2016,13,10596,2431,3568,29,109,126,16859
11/2/2016,14,10649,2407,3467,73,119,83,16798
11/2/2016,15,10722,2482,3558,147,100,80,17089
11/2/2016,16,10717,3156,3756,146,47,126,17948
11/2/2016,17,10719,3151,4303,116,4,202,18495
11/2/2016,18,10727,3314,4400,132,0,206,18779
11/2/2016,19,10723,3190,4452,110,0,208,18683
11/2/2016,20,10723,3222,4168,123,1,198,18435
11/2/2016,21,10712,2885,3702,160,0,151,17610
11/2/2016,22,10714,2417,3186,164,0,112,16593
11/2/2016,23,10725,2022,2836,145,0,99,15827
11/2/2016,24,10663,1037,2781,98,0,93,14672
11/3/2016,1,10442,725,3074,95,0,84,14420
11/3/2016,2,10445,725,2904,196,0,50,14320
11/3/2016,3,10430,732,2571,283,0,16,14032
11/3/2016,4,10164,863,2546,497,0,17,14087
11/3/2016,5,10149,1257,2609,527,0,23,14565
11/3/2016,6,10298,1628,2805,1058,0,31,15820
11/3/2016,7,10745,2013,3697,858,0,37,17350
11/3/2016,8,10749,2306,3822,635,0,34,17546
11/3/2016,9,10750,1943,3621,695,7,34,17050
11/3/2016,10,10727,2053,3701,846,24,34,17385
11/3/2016,11,10701,2184,3730,913,32,34,17594
11/3/2016,12,10698,2022,3459,928,80,34,17221
11/3/2016,13,10697,2013,3650,845,93,33,17331
11/3/2016,14,10694,2154,3651,828,128,34,17489
11/3/2016,15,10694,2260,3654,751,59,34,17452
11/3/2016,16,10689,2623,3895,467,33,34,17741
11/3/2016,17,10703,2742,4100,414,5,34,17998
11/3/2016,18,10708,2769,4333,426,0,34,18270
11/3/2016,19,10704,3205,4339,511,0,34,18793
11/3/2016,20,10706,3189,4198,608,0,34,18735
11/3/2016,21,10700,2372,3925,629,0,34,17660
11/3/2016,22,10688,2110,3229,611,0,34,16672
11/3/2016,23,10697,1365,2789,580,0,26,15457
11/3/2016,24,10695,885,2734,662,0,20,14996
11/4/2016,1,10699,795,2633,425,0,17,14569
11/4/2016,2,10670,736,2617,510,0,17,14550
11/4/2016,3,10414,745,2646,528,0,17,14350
11/4/2016,4,10405,836,2593,552,0,17,14403
11/4/2016,5,10410,1108,2893,572,0,24,15007
11/4/2016,6,10482,1528,3269,431,0,28,15738
11/4/2016,7,10707,1873,3890,366,3,34,16873
11/4/2016,8,10708,2033,3858,366,25,33,17023
11/4/2016,9,10711,1845,3905,325,106,33,16925
11/4/2016,10,10695,1868,3721,292,188,24,16788
11/4/2016,11,10692,1947,3595,509,218,26,16987
11/4/2016,12,10690,1877,3162,733,202,26,16690
11/4/2016,13,10686,1548,3275,827,182,26,16544
11/4/2016,14,10671,1421,3271,1064,153,26,16606
11/4/2016,15,10519,1445,3196,962,117,26,16265
11/4/2016,16,10653,1566,3627,771,69,25,16711
11/4/2016,17,10683,1885,3854,603,15,24,17064
11/4/2016,18,10680,2034,4218,700,1,26,17659
11/4/2016,19,10681,2119,4255,1015,0,26,18096
11/4/2016,20,10676,1794,4193,1318,0,26,18007
11/4/2016,21,10668,1564,3377,1711,0,26,17346
11/4/2016,22,10665,1200,2776,1775,0,26,16442
11/4/2016,23,10661,676,2666,1345,0,17,15365
11/4/2016,24,10666,562,2648,1147,0,4,15027
11/5/2016,1,10596,561,2644,764,0,1,14566
11/5/2016,2,10230,562,2616,844,0,1,14253
11/5/2016,3,10074,564,2631,653,0,1,13923
11/5/2016,4,10076,565,2610,514,0,1,13766
11/5/2016,5,10076,564,2667,718,0,1,14026
11/5/2016,6,10225,566,2758,737,0,1,14287
11/5/2016,7,10592,568,3070,1086,2,1,15319
11/5/2016,8,10662,568,3189,1132,22,1,15574
11/5/2016,9,10659,598,3225,890,100,1,15473
11/5/2016,10,10658,657,3243,673,134,1,15366
11/5/2016,11,10654,728,3356,683,148,1,15570
11/5/2016,12,10653,736,3525,670,147,1,15732
11/5/2016,13,10661,1032,3544,660,130,1,16028
11/5/2016,14,10626,1302,3138,685,122,1,15874
11/5/2016,15,10663,1478,3076,460,56,1,15734
11/5/2016,16,10660,1483,3122,644,82,1,15992
11/5/2016,17,10659,1400,3817,670,18,1,16565
11/5/2016,18,10660,1610,4185,849,0,1,17305
11/5/2016,19,10658,1420,3687,986,0,1,16752
11/5/2016,20,10655,1375,3754,932,0,1,16717
11/5/2016,21,10655,1376,3332,993,0,1,16357
11/5/2016,22,10656,1278,3001,931,0,1,15867
11/5/2016,23,10654,716,2682,867,0,1,14920
11/5/2016,24,10581,570,2609,574,0,1,14335
11/6/2016,1,10199,570,2664,499,0,1,13933
11/6/2016,2,9834,570,2659,609,0,1,13673
11/6/2016,3,9752,570,2669,400,0,1,13392
11/6/2016,4,9746,569,2629,614,0,1,13559
11/6/2016,5,9735,568,2765,615,0,1,13684
11/6/2016,6,9826,573,2778,713,0,1,13891
11/6/2016,7,10211,576,2692,690,4,1,14174
11/6/2016,8,10631,577,2983,613,24,1,14829
11/6/2016,9,10648,641,3241,539,89,1,15159
11/6/2016,10,10652,671,3101,347,140,1,14912
11/6/2016,11,10656,892,3172,184,150,1,15055
11/6/2016,12,10657,1131,3051,161,192,1,15193
11/6/2016,13,10656,1241,3039,82,123,1,15142
11/6/2016,14,10650,1271,2944,73,175,1,15114
11/6/2016,15,10644,1436,2984,66,151,1,15282
11/6/2016,16,10636,1599,3298,135,102,1,15771
11/6/2016,17,10633,2137,3705,251,20,1,16747
11/6/2016,18,10631,2289,4094,493,0,1,17508
11/6/2016,19,10632,2357,4049,695,0,1,17734
11/6/2016,20,10631,2179,3736,868,0,1,17415
11/6/2016,21,10626,1871,3594,896,0,1,16988
11/6/2016,22,10629,1205,3518,1026,0,1,16379
11/6/2016,23,10634,605,2983,1073,0,1,15296
11/6/2016,24,10637,602,2628,933,0,1,14801
11/7/2016,1,10615,619,2780,669,0,0,14683
11/7/2016,2,10279,622,2774,737,0,8,14420
11/7/2016,3,10039,623,2738,822,0,13,14235
11/7/2016,4,10036,692,2745,764,0,13,14250
11/7/2016,5,10042,774,3131,533,0,14,14494
11/7/2016,6,10191,857,3070,765,0,15,14898
11/7/2016,7,10484,1098,3342,1119,4,28,16075
11/7/2016,8,10637,1351,3769,1111,27,48,16943
11/7/2016,9,10634,1504,3697,850,111,54,16850
11/7/2016,10,10631,1497,3537,556,186,52,16459
11/7/2016,11,10645,1793,3540,399,224,46,16647
11/7/2016,12,10638,1999,3241,406,232,32,16548
11/7/2016,13,10628,2044,2983,386,230,25,16296
11/7/2016,14,10625,2272,3037,392,217,25,16568
11/7/2016,15,10619,2274,3099,352,170,25,16539
11/7/2016,16,10618,2211,3566,405,101,25,16926
11/7/2016,17,10611,2443,4103,441,18,25,17641
11/7/2016,18,10617,2671,4268,712,0,25,18293
11/7/2016,19,10626,2774,4219,915,0,25,18559
11/7/2016,20,10629,2854,3967,1070,0,25,18545
11/7/2016,21,10620,2823,3846,1284,0,25,18598
11/7/2016,22,10624,2273,3538,1509,0,25,17969
11/7/2016,23,10615,1310,3151,1587,0,25,16688
11/7/2016,24,10625,830,2675,1608,0,13,15751
11/8/2016,1,10626,707,2673,1058,0,12,15076
11/8/2016,2,10627,707,2646,713,0,12,14705
11/8/2016,3,10628,709,2645,450,0,13,14445
11/8/2016,4,10632,707,2605,440,0,12,14396
11/8/2016,5,10634,707,2691,565,0,13,14610
11/8/2016,6,10635,710,2793,906,0,16,15060
11/8/2016,7,10642,718,3077,1479,2,21,15939
11/8/2016,8,10645,773,3410,1630,19,53,16530
11/8/2016,9,10639,891,3624,1401,79,59,16693
11/8/2016,10,10626,883,3414,1176,115,58,16272
11/8/2016,11,10627,1142,3697,1135,126,57,16784
11/8/2016,12,10619,1383,3332,1464,138,60,16996
11/8/2016,13,10624,1367,3152,1244,109,58,16554
11/8/2016,14,10623,1380,3067,712,67,57,15906
11/8/2016,15,10619,1549,3079,1034,44,57,16382
11/8/2016,16,10616,1652,3386,1156,26,55,16891
11/8/2016,17,10618,2153,4126,1387,2,58,18344
11/8/2016,18,10619,2847,4481,1233,0,52,19232
11/8/2016,19,10627,2740,4361,1402,0,48,19178
11/8/2016,20,10626,2328,4182,1721,0,43,18900
11/8/2016,21,10625,2002,3739,1649,0,33,18048
11/8/2016,22,10622,1472,3252,1863,0,26,17235
11/8/2016,23,10624,1166,2983,1714,0,25,16512
11/8/2016,24,10620,922,2667,1628,0,17,15854
11/9/2016,1,10619,720,2737,1114,0,12,15202
11/9/2016,2,10625,721,2642,711,0,12,14711
11/9/2016,3,10623,721,2632,407,0,12,14395
11/9/2016,4,10626,722,2626,381,0,13,14368
11/9/2016,5,10632,719,2717,519,0,14,14601
11/9/2016,6,10636,722,2700,1083,0,16,15157
11/9/2016,7,10644,722,2756,1962,0,20,16104
11/9/2016,8,10648,729,2922,2537,6,27,16869
11/9/2016,9,10649,730,3195,2553,42,28,17197
11/9/2016,10,10647,728,3285,2396,98,28,17182
11/9/2016,11,10643,730,3268,1877,123,27,16668
11/9/2016,12,10663,826,3274,1701,127,27,16618
11/9/2016,13,10663,922,3387,906,136,27,16041
11/9/2016,14,10515,1357,3407,513,97,29,15918
11/9/2016,15,10496,1710,3290,375,36,27,15934
11/9/2016,16,10544,1932,3536,476,50,28,16566
11/9/2016,17,10661,2574,3749,895,15,27,17921
11/9/2016,18,10663,3116,4234,755,0,26,18794
11/9/2016,19,10673,3442,4153,684,0,26,18978
11/9/2016,20,10676,3433,4173,502,0,26,18810
11/9/2016,21,10674,3469,3981,451,0,27,18602
11/9/2016,22,10670,3089,3764,452,1,27,18003
11/9/2016,23,10586,2673,3276,526,0,27,17088
11/9/2016,24,10672,1762,2968,715,0,16,16133
11/10/2016,1,10672,1018,2738,1123,0,14,15565
11/10/2016,2,10673,715,2674,1062,0,13,15137
11/10/2016,3,10681,717,2675,876,0,12,14961
11/10/2016,4,10681,722,2657,963,0,12,15035
11/10/2016,5,10682,745,2731,835,0,12,15005
11/10/2016,6,10701,741,2731,1414,0,16,15603
11/10/2016,7,10705,740,2887,2224,1,23,16580
11/10/2016,8,10706,746,3087,2953,16,30,17538
11/10/2016,9,10691,745,3255,2496,79,41,17307
11/10/2016,10,10686,743,3128,2038,135,39,16769
11/10/2016,11,10684,742,3164,2260,158,38,17046
11/10/2016,12,10687,739,3125,2090,136,38,16815
11/10/2016,13,10683,793,3157,1560,120,36,16349
11/10/2016,14,10679,748,3193,1361,48,33,16062
11/10/2016,15,10678,734,3198,1982,94,34,16720
11/10/2016,16,10679,736,3221,2380,70,34,17120
11/10/2016,17,10671,738,3541,2627,16,29,17622
11/10/2016,18,10669,742,3795,3161,0,26,18393
11/10/2016,19,10666,743,3742,3550,0,26,18727
11/10/2016,20,10674,746,3604,3565,0,27,18616
11/10/2016,21,10671,746,3430,3378,0,27,18252
11/10/2016,22,10658,719,3233,2678,0,26,17314
11/10/2016,23,10661,718,2863,2237,0,26,16505
11/10/2016,24,10666,712,2769,2117,0,15,16279
11/11/2016,1,10674,713,2738,1854,0,13,15992
11/11/2016,2,10672,715,2640,1600,0,13,15640
11/11/2016,3,10669,717,2649,724,0,13,14772
11/11/2016,4,10450,719,2596,638,0,13,14416
11/11/2016,5,10369,729,2727,683,0,14,14522
11/11/2016,6,10369,726,2691,1274,0,16,15076
11/11/2016,7,10612,729,2718,2100,1,21,16181
11/11/2016,8,10676,736,2763,3177,8,25,17385
11/11/2016,9,10673,735,2849,2625,91,25,16998
11/11/2016,10,10684,737,3187,1979,162,25,16774
11/11/2016,11,10685,736,3272,1779,155,27,16654
11/11/2016,12,10687,783,3259,1720,170,27,16646
11/11/2016,13,10683,825,3263,1553,167,26,16517
11/11/2016,14,10682,957,3302,1372,128,26,16467
11/11/2016,15,10686,1142,3288,1392,115,26,16649
11/11/2016,16,10683,1306,3293,1892,56,27,17257
11/11/2016,17,10688,1457,3687,2030,9,26,17897
11/11/2016,18,10680,1655,4430,2047,0,26,18838
11/11/2016,19,10677,1725,4795,1528,0,26,18751
11/11/2016,20,10675,1913,4762,971,0,26,18347
11/11/2016,21,10672,1900,4637,764,0,27,18000
11/11/2016,22,10670,2002,4382,706,0,26,17786
11/11/2016,23,10671,1733,4022,578,0,26,17030
11/11/2016,24,10672,1715,4029,420,0,12,16848
11/12/2016,1,10677,1220,3957,415,0,0,16269
11/12/2016,2,10680,904,3669,400,0,0,15653
11/12/2016,3,10477,864,3460,384,0,0,15185
11/12/2016,4,10381,704,3247,374,0,0,14706
11/12/2016,5,10388,679,3248,449,0,0,14764
11/12/2016,6,10368,680,3476,462,0,0,14986
11/12/2016,7,10612,684,3797,641,0,0,15734
11/12/2016,8,10692,680,3590,892,18,0,15872
11/12/2016,9,10690,678,3451,1085,90,1,15995
11/12/2016,10,10684,677,3588,1389,157,1,16496
11/12/2016,11,10680,675,3619,1264,173,1,16412
11/12/2016,12,10686,672,3417,1049,198,1,16023
11/12/2016,13,10058,712,3661,1309,191,1,15932
11/12/2016,14,9843,699,3504,1881,194,2,16123
11/12/2016,15,9839,668,3340,2003,140,0,15990
11/12/2016,16,9839,670,3527,2297,81,0,16414
11/12/2016,17,9836,668,3867,2476,13,0,16860
11/12/2016,18,9833,706,4458,2829,0,0,17826
11/12/2016,19,9835,747,4385,3161,1,0,18129
11/12/2016,20,9834,676,3606,3297,0,0,17413
11/12/2016,21,9832,668,3410,3283,0,0,17193
11/12/2016,22,9825,667,3147,3124,0,0,16763
11/12/2016,23,9826,670,2691,2917,0,0,16104
11/12/2016,24,9826,670,2488,2378,0,0,15362
11/13/2016,1,9825,670,2598,1528,0,0,14621
11/13/2016,2,9837,673,2486,1320,0,0,14316
11/13/2016,3,9829,675,2522,938,0,0,13964
11/13/2016,4,9835,676,2533,851,0,0,13895
11/13/2016,5,9833,677,2605,1008,0,0,14123
11/13/2016,6,9834,677,2532,1256,0,0,14299
11/13/2016,7,9835,677,2632,1381,4,0,14529
11/13/2016,8,9831,672,2541,1949,16,1,15010
11/13/2016,9,9835,674,2948,1561,72,0,15090
11/13/2016,10,9843,672,3273,1193,160,0,15141
11/13/2016,11,9841,669,3246,1157,210,1,15124
11/13/2016,12,9844,666,3218,1328,226,0,15282
11/13/2016,13,9841,662,3273,1304,209,11,15300
11/13/2016,14,9846,662,3275,1110,120,4,15017
11/13/2016,15,9846,665,3324,1272,132,0,15239
11/13/2016,16,9813,664,3360,1905,91,0,15833
11/13/2016,17,9851,667,3898,2675,15,0,17106
11/13/2016,18,9854,669,4243,3459,0,0,18225
11/13/2016,19,9855,669,4141,3548,0,0,18213
11/13/2016,20,9858,667,3833,3462,0,0,17820
11/13/2016,21,9852,670,3515,3436,0,0,17473
11/13/2016,22,9849,670,2919,3508,0,0,16946
11/13/2016,23,9848,669,2727,2682,0,0,15926
11/13/2016,24,9850,674,2557,2109,0,0,15190
11/14/2016,1,9852,675,2485,1433,0,2,14447
11/14/2016,2,9850,674,2480,1418,0,9,14431
11/14/2016,3,9854,689,2472,1246,0,8,14269
11/14/2016,4,9854,718,2450,1291,0,8,14321
11/14/2016,5,9854,768,2585,1153,0,8,14368
11/14/2016,6,9855,847,2581,1516,0,18,14817
11/14/2016,7,9853,978,3199,1969,1,27,16027
11/14/2016,8,9859,1064,3659,1923,14,40,16559
11/14/2016,9,9861,1095,3788,1594,80,43,16461
11/14/2016,10,9858,1112,3711,1146,147,47,16021
11/14/2016,11,9845,1110,3586,1191,184,47,15963
11/14/2016,12,9837,1110,3684,1090,195,42,15958
11/14/2016,13,9841,1129,3670,1033,175,29,15877
11/14/2016,14,9845,1234,3721,1019,133,26,15978
11/14/2016,15,9845,1432,3900,1021,102,26,16326
11/14/2016,16,9851,1545,3946,1094,45,25,16506
11/14/2016,17,9851,1898,4499,1098,4,28,17378
11/14/2016,18,9845,2039,5051,1208,0,27,18170
11/14/2016,19,9845,1871,4889,1404,0,26,18035
11/14/2016,20,9850,1773,4746,1538,0,26,17933
11/14/2016,21,9839,1878,4665,1496,0,26,17904
11/14/2016,22,9839,1716,4139,1373,0,26,17093
11/14/2016,23,9842,1102,3791,1247,0,26,16008
11/14/2016,24,9834,971,3257,1116,0,15,15193
11/15/2016,1,9833,969,3250,925,0,11,14988
11/15/2016,2,9837,971,3083,825,0,11,14727
11/15/2016,3,9834,806,3026,690,0,11,14367
11/15/2016,4,9834,781,3281,488,0,12,14396
11/15/2016,5,9839,885,3331,484,0,16,14555
11/15/2016,6,9834,1224,2980,364,0,42,14444
11/15/2016,7,9840,1432,4140,397,1,46,15856
11/15/2016,8,9836,1786,4879,399,7,70,16977
11/15/2016,9,9834,1663,4538,511,57,119,16722
11/15/2016,10,9694,1566,4424,446,69,154,16353
11/15/2016,11,9674,1712,4515,307,146,167,16521
11/15/2016,12,9670,1675,4250,294,177,169,16235
11/15/2016,13,9759,1660,4037,304,163,169,16092
11/15/2016,14,9835,1859,3893,307,170,171,16235
11/15/2016,15,9835,1967,3795,298,129,172,16196
11/15/2016,16,9836,2165,4015,217,70,169,16472
11/15/2016,17,9839,2680,4782,154,10,178,17643
11/15/2016,18,9842,3199,5210,177,0,183,18611
11/15/2016,19,9839,3108,5118,332,0,182,18579
11/15/2016,20,9841,3066,4737,358,0,96,18098
11/15/2016,21,9834,2935,4700,455,0,67,17991
11/15/2016,22,9827,2225,4264,510,0,36,16862
11/15/2016,23,9837,1716,3547,514,0,26,15640
11/15/2016,24,9840,1162,3135,533,0,16,14686
11/16/2016,1,9839,874,3279,589,0,14,14595
11/16/2016,2,9840,773,2904,603,0,14,14134
11/16/2016,3,9870,778,2805,677,0,13,14143
11/16/2016,4,9853,775,2806,712,0,13,14159
11/16/2016,5,9894,778,2945,755,0,16,14388
11/16/2016,6,9902,832,2973,668,0,56,14431
11/16/2016,7,9916,977,3736,902,0,107,15638
11/16/2016,8,9924,1034,4424,911,4,144,16441
11/16/2016,9,9926,1269,4548,958,19,159,16879
11/16/2016,10,9920,1084,4507,1010,56,168,16745
11/16/2016,11,9914,1102,4444,922,83,172,16637
11/16/2016,12,9918,1121,4322,896,123,171,16551
11/16/2016,13,9877,1088,4094,1003,112,174,16348
11/16/2016,14,9710,1397,4303,988,107,169,16674
11/16/2016,15,9788,1673,4145,1105,73,172,16956
11/16/2016,16,9912,1971,4110,965,18,169,17145
11/16/2016,17,9860,2121,4480,797,4,94,17356
11/16/2016,18,9865,2716,5190,485,1,138,18395
11/16/2016,19,9869,2733,5049,401,1,182,18235
11/16/2016,20,9872,2509,5015,407,1,183,17987
11/16/2016,21,9869,2402,4873,341,1,125,17611
11/16/2016,22,9862,2704,4172,350,1,51,17140
11/16/2016,23,9855,2074,3755,346,1,26,16057
11/16/2016,24,9844,1218,3442,310,0,16,14830
11/17/2016,1,9845,834,3475,291,0,15,14460
11/17/2016,2,9853,804,3514,266,0,16,14453
11/17/2016,3,9853,788,3545,236,0,15,14437
11/17/2016,4,9852,779,3434,237,0,18,14320
11/17/2016,5,9853,780,3507,331,0,19,14490
11/17/2016,6,9864,783,3472,578,0,54,14751
11/17/2016,7,9865,796,4217,687,2,119,15686
11/17/2016,8,9868,864,4565,1056,8,163,16524
11/17/2016,9,9866,809,4288,1319,33,172,16487
11/17/2016,10,9865,817,3801,1271,82,174,16010
11/17/2016,11,9861,814,3686,1379,106,176,16022
11/17/2016,12,9863,811,3872,1528,112,169,16355
11/17/2016,13,9864,814,3796,1617,116,171,16378
11/17/2016,14,9865,983,3794,1633,108,170,16553
11/17/2016,15,9900,1088,3550,1709,100,170,16517
11/17/2016,16,9857,1186,3616,1803,61,170,16693
11/17/2016,17,9858,1192,4238,2030,9,169,17496
11/17/2016,18,9851,1190,4359,2573,0,170,18143
11/17/2016,19,9856,1187,4340,2895,0,170,18448
11/17/2016,20,9853,1185,4069,2935,0,114,18156
11/17/2016,21,9852,1191,4014,3004,0,31,18092
11/17/2016,22,9852,904,3454,3009,0,26,17245
11/17/2016,23,9849,784,3028,2732,0,25,16418
11/17/2016,24,9856,775,2692,2612,0,18,15953
11/18/2016,1,9852,774,2562,2008,0,14,15210
11/18/2016,2,9854,775,2541,1588,0,13,14771
11/18/2016,3,9854,776,2535,1150,0,13,14328
11/18/2016,4,9850,777,2518,1235,0,13,14393
11/18/2016,5,9849,776,2618,1146,0,12,14401
11/18/2016,6,9854,777,2800,1622,0,16,15069
11/18/2016,7,9867,781,3295,2357,0,22,16322
11/18/2016,8,9870,790,3385,2589,7,27,16668
11/18/2016,9,9857,799,3458,2410,58,27,16609
11/18/2016,10,9868,811,3528,2000,123,27,16357
11/18/2016,11,9787,811,3581,2018,147,27,16371
11/18/2016,12,9784,812,3561,1708,164,27,16056
11/18/2016,13,9787,813,3569,1563,179,27,15938
11/18/2016,14,9783,818,3480,1825,165,27,16098
11/18/2016,15,9797,868,3519,1996,128,27,16335
11/18/2016,16,9804,959,3504,2350,60,28,16705
11/18/2016,17,9862,1093,3887,2114,8,27,16991
11/18/2016,18,9863,1103,3999,3037,0,27,18029
11/18/2016,19,9865,861,3868,3050,0,43,17687
11/18/2016,20,9863,789,3734,3066,0,39,17491
11/18/2016,21,9864,773,3612,3339,0,28,17616
11/18/2016,22,9861,769,3146,3509,0,33,17318
11/18/2016,23,9857,767,2811,3386,0,49,16870
11/18/2016,24,9864,621,2572,2647,0,31,15735
11/19/2016,1,9863,579,2502,2109,0,27,15080
11/19/2016,2,9863,579,2474,1733,0,11,14660
11/19/2016,3,9862,574,2466,1477,0,3,14382
11/19/2016,4,9859,573,2496,1120,0,4,14052
11/19/2016,5,9863,572,2523,1202,0,3,14163
11/19/2016,6,9869,574,2541,1347,0,5,14336
11/19/2016,7,9866,573,2711,1656,0,7,14813
11/19/2016,8,9862,571,3271,1626,7,4,15341
11/19/2016,9,9863,566,3438,2405,35,4,16311
11/19/2016,10,9866,570,3480,2891,69,3,16879
11/19/2016,11,9863,589,3479,3098,85,10,17124
11/19/2016,12,9854,610,3411,3187,84,12,17158
11/19/2016,13,9849,654,3584,3123,68,2,17280
11/19/2016,14,9845,729,3682,3032,51,0,17339
11/19/2016,15,9847,955,3526,3180,38,0,17546
11/19/2016,16,9866,963,3335,3235,22,0,17421
11/19/2016,17,10069,973,3466,2979,4,0,17491
11/19/2016,18,10035,985,3814,3667,0,0,18501
11/19/2016,19,10032,995,3748,3533,0,0,18308
11/19/2016,20,10027,990,3640,3562,0,0,18219
11/19/2016,21,10027,991,3659,3194,0,0,17871
11/19/2016,22,10035,994,3092,3364,0,0,17485
11/19/2016,23,10054,991,2918,2823,0,0,16786
11/19/2016,24,10084,672,2594,2681,0,0,16031
11/20/2016,1,10084,623,2555,2093,0,0,15355
11/20/2016,2,10298,627,2485,1841,0,0,15251
11/20/2016,3,10561,626,2483,1423,0,0,15093
11/20/2016,4,10541,627,2474,1248,0,0,14890
11/20/2016,5,10542,627,2540,1168,0,0,14877
11/20/2016,6,10544,627,2548,1413,0,0,15132
11/20/2016,7,10545,618,2682,1636,1,0,15482
11/20/2016,8,10541,621,2785,2009,3,0,15959
11/20/2016,9,10538,628,2842,2653,14,0,16675
11/20/2016,10,10523,723,3174,2500,30,0,16950
11/20/2016,11,10519,998,3254,2706,53,0,17530
11/20/2016,12,10588,998,3248,2988,34,0,17856
11/20/2016,13,10675,998,3368,3041,27,0,18109
11/20/2016,14,10685,997,3309,3122,25,0,18138
11/20/2016,15,10699,1001,3419,3198,14,0,18331
11/20/2016,16,10695,997,3426,3475,10,0,18603
11/20/2016,17,10697,998,3869,3419,2,0,18985
11/20/2016,18,10699,999,4521,3511,0,0,19730
11/20/2016,19,10704,1000,4346,3533,0,0,19583
11/20/2016,20,10704,1001,3984,3563,1,0,19253
11/20/2016,21,10693,997,3875,3488,0,0,19053
11/20/2016,22,10694,998,3626,3404,0,0,18722
11/20/2016,23,10697,676,3246,3235,0,0,17854
11/20/2016,24,10705,628,2687,2950,0,0,16970
11/21/2016,1,10704,625,2559,2390,0,0,16278
11/21/2016,2,10704,626,2547,1995,0,4,15876
11/21/2016,3,10719,626,2508,1864,0,9,15726
11/21/2016,4,10724,627,2523,1854,0,10,15738
11/21/2016,5,10724,645,2590,1943,0,10,15912
11/21/2016,6,10726,664,2523,2635,0,17,16565
11/21/2016,7,10726,686,3016,3039,1,22,17490
11/21/2016,8,10729,799,3356,3391,2,26,18303
11/21/2016,9,10724,871,3397,3449,18,26,18485
11/21/2016,10,10729,1013,3363,3362,45,27,18539
11/21/2016,11,10724,1009,3387,3254,52,27,18453
11/21/2016,12,10728,1010,3380,2961,74,27,18180
11/21/2016,13,10728,1006,3445,2937,80,27,18223
11/21/2016,14,10719,981,3455,2952,64,26,18197
11/21/2016,15,10720,1008,3528,3092,44,26,18418
11/21/2016,16,10722,1008,3687,3330,12,27,18786
11/21/2016,17,10720,1018,4361,3305,2,27,19433
11/21/2016,18,10721,1155,4995,3270,1,26,20168
11/21/2016,19,10720,1215,4982,3300,0,26,20243
11/21/2016,20,10722,1182,4771,3395,0,26,20096
11/21/2016,21,10722,1055,4644,3291,0,25,19737
11/21/2016,22,10729,863,4334,3051,0,25,19002
11/21/2016,23,10724,826,3389,2820,0,25,17784
11/21/2016,24,10734,816,2824,2679,0,17,17070
11/22/2016,1,10724,819,2438,2493,0,12,16486
11/22/2016,2,10723,810,2449,2076,0,12,16070
11/22/2016,3,10728,805,2430,1758,0,12,15733
11/22/2016,4,10722,811,2437,1904,0,12,15886
11/22/2016,5,10734,842,2718,1893,0,12,16199
11/22/2016,6,10733,947,2825,1653,0,13,16171
11/22/2016,7,10734,1006,3693,1498,1,26,16958
11/22/2016,8,10728,1161,4682,1308,3,60,17942
11/22/2016,9,10734,1548,4441,1063,22,82,17890
11/22/2016,10,10729,1472,4477,922,70,79,17749
11/22/2016,11,10729,1310,4492,751,122,95,17499
11/22/2016,12,10725,1583,4463,623,150,164,17708
11/22/2016,13,10722,1708,4275,599,163,175,17642
11/22/2016,14,10718,1688,4260,544,129,177,17516
11/22/2016,15,10714,1862,4256,502,102,175,17611
11/22/2016,16,10715,2166,4378,462,52,172,17945
11/22/2016,17,10713,2759,4745,387,2,173,18779
11/22/2016,18,10711,3342,5019,342,1,173,19588
11/22/2016,19,10711,3349,4928,264,0,174,19426
11/22/2016,20,10714,3312,4766,203,0,104,19099
11/22/2016,21,10710,3101,4398,208,0,26,18443
11/22/2016,22,10693,2869,3955,230,0,27,17774
11/22/2016,23,10701,2799,3375,202,0,27,17104
11/22/2016,24,10698,2241,3118,178,0,14,16249
11/23/2016,1,10703,1652,2964,181,0,11,15511
11/23/2016,2,10709,1329,2958,235,0,11,15242
11/23/2016,3,10709,1404,2798,279,0,11,15201
11/23/2016,4,10699,1495,2720,348,0,12,15274
11/23/2016,5,10706,1615,2762,436,0,14,15533
11/23/2016,6,10705,1797,3001,196,0,26,15725
11/23/2016,7,10698,1948,3552,534,0,68,16800
11/23/2016,8,10702,2443,4167,607,6,113,18038
11/23/2016,9,10701,2433,4025,628,63,141,17991
11/23/2016,10,10694,2334,4021,728,127,162,18066
11/23/2016,11,10540,2519,4054,667,105,169,18054
11/23/2016,12,10535,2749,4087,619,77,170,18237
11/23/2016,13,10538,2614,4086,618,66,170,18092
11/23/2016,14,10537,2612,4055,637,47,171,18059
11/23/2016,15,10532,2549,3980,659,29,171,17920
11/23/2016,16,10667,2626,4109,833,12,169,18416
11/23/2016,17,10689,2599,4256,958,1,170,18673
11/23/2016,18,10693,2680,4802,1164,0,175,19514
11/23/2016,19,10693,2600,4375,1834,1,149,19652
11/23/2016,20,10690,2622,3887,2083,0,69,19351
11/23/2016,21,10678,2587,3804,2199,0,34,19302
11/23/2016,22,10678,1799,3536,2369,0,26,18408
11/23/2016,23,10674,1576,3262,2158,0,26,17696
11/23/2016,24,10677,1098,3038,2053,0,15,16881
11/24/2016,1,10679,1032,2882,1976,0,13,16582
11/24/2016,2,10658,1073,2438,1736,0,14,15919
11/24/2016,3,10656,909,2525,1689,0,15,15794
11/24/2016,4,10650,1073,2460,1575,0,13,15771
11/24/2016,5,10648,1188,2551,1359,0,16,15762
11/24/2016,6,10634,1243,2652,1206,0,30,15765
11/24/2016,7,10641,1454,3306,1198,0,87,16686
11/24/2016,8,10651,1872,4130,935,1,129,17718
11/24/2016,9,10656,2127,4389,700,3,186,18061
11/24/2016,10,10648,2451,4337,507,4,187,18134
11/24/2016,11,10644,2577,4282,369,8,195,18075
11/24/2016,12,10649,2662,4408,383,9,191,18302
11/24/2016,13,10658,2749,4434,403,16,190,18450
11/24/2016,14,10661,2595,4311,396,21,187,18171
11/24/2016,15,10659,2534,4335,346,15,175,18064
11/24/2016,16,10657,2556,4433,288,3,168,18105
11/24/2016,17,10652,2657,4520,294,0,107,18230
11/24/2016,18,10650,2619,4758,228,0,76,18331
11/24/2016,19,10646,2616,4772,241,0,85,18360
11/24/2016,20,10635,2616,4580,295,0,70,18196
11/24/2016,21,10627,2615,4356,329,0,43,17970
11/24/2016,22,10626,2596,3804,386,0,24,17436
11/24/2016,23,10624,1840,3463,420,0,25,16372
11/24/2016,24,10628,1301,3015,444,0,14,15402
11/25/2016,1,10628,1040,2889,517,0,14,15088
11/25/2016,2,10631,915,2877,486,0,14,14923
11/25/2016,3,10630,970,2815,472,0,13,14900
11/25/2016,4,10629,1177,2910,507,0,13,15236
11/25/2016,5,10629,1323,2745,471,0,15,15183
11/25/2016,6,10626,1476,2843,357,0,17,15319
11/25/2016,7,10630,1542,3458,602,0,21,16253
11/25/2016,8,10627,1837,3968,782,1,27,17242
11/25/2016,9,10631,2074,4272,879,7,26,17889
11/25/2016,10,10632,2218,4217,895,23,27,18012
11/25/2016,11,10650,2160,4232,994,30,27,18093
11/25/2016,12,10655,1841,4265,942,26,27,17756
11/25/2016,13,10661,1548,4090,1133,27,27,17486
11/25/2016,14,10507,1522,4141,1017,20,19,17226
11/25/2016,15,10573,1637,4474,817,13,26,17540
11/25/2016,16,10639,1725,4572,723,6,27,17692
11/25/2016,17,10638,1836,4623,569,0,27,17693
11/25/2016,18,10637,1964,4989,562,0,26,18178
11/25/2016,19,10634,1847,4822,615,0,27,17945
11/25/2016,20,10640,1781,4550,717,0,27,17715
11/25/2016,21,10653,1790,4471,741,0,27,17682
11/25/2016,22,10648,1510,4209,672,0,27,17066
11/25/2016,23,10641,1101,3680,691,0,27,16140
11/25/2016,24,10650,857,3389,582,0,18,15496
11/26/2016,1,10658,652,3100,601,0,15,15026
11/26/2016,2,10655,617,2751,621,0,14,14658
11/26/2016,3,10657,617,2843,672,0,13,14802
11/26/2016,4,10654,701,2992,684,0,12,15043
11/26/2016,5,10668,956,3022,727,0,3,15376
11/26/2016,6,10644,1335,2614,814,0,0,15407
11/26/2016,7,10573,1449,2878,777,0,0,15677
11/26/2016,8,10577,1507,3103,711,2,0,15900
11/26/2016,9,10583,1689,4027,758,11,0,17068
11/26/2016,10,10582,1593,4089,735,32,0,17031
11/26/2016,11,10599,1590,4026,743,62,0,17020
11/26/2016,12,10599,1465,4113,744,67,0,16988
11/26/2016,13,10596,1541,4329,676,57,0,17199
11/26/2016,14,10595,1590,4146,772,48,0,17151
11/26/2016,15,10595,1206,4263,838,28,0,16930
11/26/2016,16,10568,1293,4372,759,6,0,16998
11/26/2016,17,10594,1536,4131,847,1,0,17109
11/26/2016,18,10697,1532,4478,1066,0,0,17773
11/26/2016,19,10711,1525,4361,1343,0,0,17940
11/26/2016,20,10712,1337,4547,1201,0,0,17797
11/26/2016,21,10709,1352,4594,996,0,0,17651
11/26/2016,22,10711,1184,4004,1029,0,0,16928
11/26/2016,23,10706,842,3661,1144,0,0,16353
11/26/2016,24,10708,607,3486,1046,0,0,15847
11/27/2016,1,10706,558,3200,1004,0,0,15468
11/27/2016,2,10704,559,2937,1149,0,0,15349
11/27/2016,3,10705,559,2760,1178,0,0,15202
11/27/2016,4,10717,560,2840,908,0,0,15025
11/27/2016,5,10717,560,3087,785,0,0,15149
11/27/2016,6,10699,560,2686,750,0,0,14695
11/27/2016,7,10618,560,2690,700,0,0,14568
11/27/2016,8,10615,563,3118,849,2,0,15147
11/27/2016,9,10609,635,3709,823,33,0,15809
11/27/2016,10,10606,646,3627,703,31,0,15613
11/27/2016,11,10610,850,3705,676,52,0,15893
11/27/2016,12,10613,1121,3925,788,106,0,16553
11/27/2016,13,10609,1298,3717,995,122,0,16741
11/27/2016,14,10660,1542,3541,1040,101,0,16884
11/27/2016,15,10706,1815,3489,908,72,0,16990
11/27/2016,16,10706,1816,3715,861,27,0,17125
11/27/2016,17,10707,1834,4171,719,5,0,17436
11/27/2016,18,10709,1820,4715,737,0,0,17981
11/27/2016,19,10723,1873,4699,836,0,0,18131
11/27/2016,20,10720,1786,4433,959,0,0,17898
11/27/2016,21,10721,824,4276,1096,0,0,16917
11/27/2016,22,10720,662,4114,1212,0,0,16708
11/27/2016,23,10720,628,3530,1357,0,0,16235
11/27/2016,24,10722,569,2893,1624,0,0,15808
11/28/2016,1,10725,557,2675,1732,0,14,15703
11/28/2016,2,10718,556,2518,1807,0,13,15612
11/28/2016,3,10724,555,2508,1483,0,13,15283
11/28/2016,4,10721,555,2505,1598,0,13,15392
11/28/2016,5,10725,556,2594,1835,0,14,15724
11/28/2016,6,10726,560,2733,2084,0,17,16120
11/28/2016,7,10724,584,3592,2278,0,27,17205
11/28/2016,8,10723,686,3680,2600,4,37,17730
11/28/2016,9,10721,700,3584,2145,36,37,17223
11/28/2016,10,10713,748,3371,1753,102,27,16714
11/28/2016,11,10732,783,3497,1568,142,27,16749
11/28/2016,12,10730,803,3585,1420,133,29,16700
11/28/2016,13,10714,811,3560,1341,117,27,16570
11/28/2016,14,10716,812,3619,1571,81,26,16825
11/28/2016,15,10713,809,3537,1768,68,26,16921
11/28/2016,16,10713,813,3770,2535,16,27,17874
11/28/2016,17,10710,840,4451,2655,0,26,18682
11/28/2016,18,10711,1172,4652,2863,0,27,19425
11/28/2016,19,10705,1179,4287,3125,0,26,19322
11/28/2016,20,10704,928,3981,3333,0,26,18972
11/28/2016,21,10698,812,3973,3475,0,26,18984
11/28/2016,22,10685,811,3347,3538,0,26,18407
11/28/2016,23,10656,812,2648,3082,0,26,17224
11/28/2016,24,10658,806,2610,2344,0,16,16434
11/29/2016,1,10669,804,2514,1783,0,12,15782
11/29/2016,2,10670,804,2458,1407,0,12,15351
11/29/2016,3,10668,803,2479,1156,0,12,15118
11/29/2016,4,10661,802,2497,1073,0,13,15046
11/29/2016,5,10495,827,2711,1150,0,13,15196
11/29/2016,6,10161,889,2674,2042,0,17,15783
11/29/2016,7,10165,798,2847,3042,0,19,16871
11/29/2016,8,10166,807,3398,3355,0,26,17752
11/29/2016,9,10172,842,3547,3378,11,26,17976
11/29/2016,10,10160,883,3605,3341,19,26,18034
11/29/2016,11,10180,1021,3512,3215,31,27,17986
11/29/2016,12,10179,1334,3570,2799,35,26,17943
11/29/2016,13,10180,1483,3492,2411,44,31,17641
11/29/2016,14,10309,1564,3733,2013,48,30,17697
11/29/2016,15,10285,1732,3912,1572,49,27,17577
11/29/2016,16,10163,1880,4424,1135,20,26,17648
11/29/2016,17,10162,2074,4479,1021,2,26,17764
11/29/2016,18,10162,2111,4913,1310,0,26,18522
11/29/2016,19,10178,2080,4387,1646,0,27,18318
11/29/2016,20,10180,2001,4085,1870,0,27,18163
11/29/2016,21,10175,1429,4110,1931,0,26,17671
11/29/2016,22,10170,1218,4335,1843,0,26,17592
11/29/2016,23,10164,868,3797,1746,0,26,16601
11/29/2016,24,10173,746,3243,1854,0,16,16032
11/30/2016,1,10179,737,2726,1813,0,12,15467
11/30/2016,2,10180,743,2519,1733,0,11,15186
11/30/2016,3,10182,768,2557,1464,0,11,14982
11/30/2016,4,10188,769,2501,1521,0,11,14990
11/30/2016,5,10191,772,2566,1495,0,11,15035
11/30/2016,6,10192,894,2904,1445,0,16,15451
11/30/2016,7,10198,1086,3434,1381,0,23,16122
11/30/2016,8,10199,1178,4112,1168,1,26,16684
11/30/2016,9,10200,1187,4189,1174,29,26,16805
11/30/2016,10,10203,1253,4275,1060,38,26,16855
11/30/2016,11,10201,1365,4374,920,93,27,16980
11/30/2016,12,10202,1418,4525,853,107,27,17132
11/30/2016,13,10202,1339,4743,749,64,26,17123
11/30/2016,14,10054,1575,4844,606,13,26,17118
11/30/2016,15,10117,1738,4771,565,7,26,17224
11/30/2016,16,10201,1861,4722,665,3,26,17478
11/30/2016,17,10210,1920,4896,778,0,27,17831
11/30/2016,18,10215,2274,5134,968,0,27,18618
11/30/2016,19,10220,2061,4874,1357,0,27,18539
11/30/2016,20,10221,1878,4391,1829,0,30,18349
11/30/2016,21,10210,1687,3975,2028,0,28,17928
11/30/2016,22,10208,1247,3411,2332,0,26,17224
11/30/2016,23,10209,995,2893,2497,0,26,16620
11/30/2016,24,10250,804,2676,2358,0,17,16105
12/1/2016,1,9990,713,2414,2229,0,13,15359
12/1/2016,2,9444,709,2454,2199,0,13,14819
12/1/2016,3,9442,709,2504,1800,0,16,14471
12/1/2016,4,9438,733,2490,1664,0,15,14340
12/1/2016,5,9444,738,2556,1729,0,14,14481
12/1/2016,6,9451,740,2732,2254,0,17,15194
12/1/2016,7,9463,740,3204,2620,0,20,16047
12/1/2016,8,9460,747,3843,2893,0,26,16969
12/1/2016,9,9460,750,4299,2799,10,26,17344
12/1/2016,10,9460,750,4375,2815,26,26,17452
12/1/2016,11,9460,751,4384,2871,36,26,17528
12/1/2016,12,9472,754,4065,2972,49,26,17338
12/1/2016,13,9472,814,3951,3053,45,26,17361
12/1/2016,14,9477,862,3927,3078,29,26,17399
12/1/2016,15,9476,986,3871,3122,35,26,17516
12/1/2016,16,9478,1106,3990,3144,24,26,17768
12/1/2016,17,9478,1183,4314,3111,1,25,18112
12/1/2016,18,9476,1160,4973,3166,0,25,18800
12/1/2016,19,9474,1161,4708,3273,0,26,18642
12/1/2016,20,9475,1159,4733,3372,0,27,18766
12/1/2016,21,9473,1157,4384,3401,0,26,18441
12/1/2016,22,9466,1157,3787,3318,0,26,17754
12/1/2016,23,9465,1158,3552,2429,0,26,16630
12/1/2016,24,9465,1127,2888,2611,0,15,16106
12/2/2016,1,9471,812,2613,2517,0,0,15413
12/2/2016,2,9475,729,2429,2279,0,0,14912
12/2/2016,3,9473,724,2470,2061,0,0,14728
12/2/2016,4,9473,721,2528,1939,0,0,14661
12/2/2016,5,9470,722,2601,1966,0,0,14759
12/2/2016,6,9474,724,2573,2535,0,0,15306
12/2/2016,7,9474,723,3330,2754,0,0,16281
12/2/2016,8,9479,739,3965,2823,0,0,17006
12/2/2016,9,9476,747,4249,2855,3,1,17331
12/2/2016,10,9465,752,4606,2832,18,0,17673
12/2/2016,11,9463,804,4532,2827,60,0,17686
12/2/2016,12,9462,830,4455,2865,28,0,17640
12/2/2016,13,9459,1001,4135,3043,22,0,17660
12/2/2016,14,9465,1269,3793,3155,15,0,17697
12/2/2016,15,9468,1372,3784,3147,30,0,17801
12/2/2016,16,9469,1392,3890,3165,5,3,17924
12/2/2016,17,9469,1526,4544,3105,0,1,18645
12/2/2016,18,9461,1522,5156,3021,0,1,19161
12/2/2016,19,9459,1524,5230,2910,0,0,19123
12/2/2016,20,9462,1508,5046,2655,0,1,18672
12/2/2016,21,9456,1330,5111,2638,0,0,18535
12/2/2016,22,9446,1366,4662,2489,0,0,17963
12/2/2016,23,9449,847,4186,2418,0,0,16900
12/2/2016,24,9443,606,3724,2326,0,0,16099
12/3/2016,1,9444,589,3384,2296,0,4,15717
12/3/2016,2,9445,594,3167,2090,0,0,15296
12/3/2016,3,9448,593,3051,1928,0,0,15020
12/3/2016,4,9442,642,2910,1821,0,0,14815
12/3/2016,5,9448,649,3041,1697,0,0,14835
12/3/2016,6,9445,800,3230,1580,0,0,15055
12/3/2016,7,9443,1146,3327,1405,1,1,15323
12/3/2016,8,9444,1539,3528,1356,1,2,15870
12/3/2016,9,9439,1659,4452,1232,15,1,16798
12/3/2016,10,9437,1783,4529,1220,22,0,16991
12/3/2016,11,9437,1628,4525,1161,28,1,16780
12/3/2016,12,9437,1753,4681,1035,50,1,16957
12/3/2016,13,9447,1973,4731,925,57,2,17135
12/3/2016,14,9463,2138,4641,895,41,0,17178
12/3/2016,15,9428,2144,4830,973,21,0,17396
12/3/2016,16,9479,2255,4730,884,5,0,17353
12/3/2016,17,9488,2519,4872,777,0,0,17656
12/3/2016,18,9504,2934,5365,680,0,0,18483
12/3/2016,19,9525,2718,5320,567,0,0,18130
12/3/2016,20,9534,2581,5302,427,0,0,17844
12/3/2016,21,9529,2289,5226,383,0,2,17429
12/3/2016,22,9527,1880,4744,382,0,1,16534
12/3/2016,23,9567,1404,4463,341,0,0,15775
12/3/2016,24,9610,1037,4072,257,0,0,14976
12/4/2016,1,9627,627,3716,177,0,0,14147
12/4/2016,2,9645,584,3460,169,0,0,13858
12/4/2016,3,9660,586,3366,153,0,0,13765
12/4/2016,4,9691,589,3462,118,0,0,13860
12/4/2016,5,9694,673,3720,90,0,0,14177
12/4/2016,6,9691,838,3553,141,0,0,14223
12/4/2016,7,9689,949,3433,155,1,0,14227
12/4/2016,8,9689,1004,3603,247,2,0,14545
12/4/2016,9,9686,1120,4351,275,15,0,15447
12/4/2016,10,9682,1237,4477,262,50,0,15708
12/4/2016,11,9685,1278,4693,265,59,0,15980
12/4/2016,12,9680,1416,4807,219,59,0,16181
12/4/2016,13,9676,1683,4868,221,76,0,16524
12/4/2016,14,9679,1942,4582,293,53,0,16549
12/4/2016,15,9680,1974,4766,495,49,0,16964
12/4/2016,16,9680,1843,4859,705,21,0,17108
12/4/2016,17,9679,1923,5120,792,1,0,17515
12/4/2016,18,9679,2244,5429,1015,0,1,18368
12/4/2016,19,9681,1966,5344,1366,0,3,18360
12/4/2016,20,9674,1499,4871,1884,0,12,17940
12/4/2016,21,9664,1383,4368,2140,0,9,17564
12/4/2016,22,9664,1069,3768,2341,0,10,16852
12/4/2016,23,9669,975,3484,2079,0,9,16216
12/4/2016,24,9669,717,3539,1636,0,11,15572
12/5/2016,1,9653,591,3671,1161,0,10,15086
12/5/2016,2,9649,592,3549,1257,0,10,15057
12/5/2016,3,9646,595,3292,1599,0,10,15142
12/5/2016,4,9647,666,3075,1908,0,12,15308
12/5/2016,5,9654,753,2889,2104,0,14,15414
12/5/2016,6,9656,737,2858,2095,0,15,15361
12/5/2016,7,9671,705,3391,2417,0,20,16204
12/5/2016,8,9782,835,4179,2583,1,27,17407
12/5/2016,9,9845,849,4257,2669,11,27,17658
12/5/2016,10,9842,815,4414,2598,5,27,17701
12/5/2016,11,9845,957,4603,2318,11,27,17761
12/5/2016,12,9843,1150,4216,2315,31,27,17582
12/5/2016,13,9838,1483,3746,2093,47,27,17234
12/5/2016,14,9838,1947,3739,1652,43,28,17247
12/5/2016,15,9839,2349,3744,1550,28,28,17538
12/5/2016,16,9837,2661,3842,1640,10,27,18017
12/5/2016,17,9842,2856,4591,1394,0,28,18711
12/5/2016,18,9836,3633,5356,1214,0,27,20066
12/5/2016,19,9832,3672,5349,978,0,27,19858
12/5/2016,20,9830,3393,5277,745,0,28,19273
12/5/2016,21,9824,3107,5175,591,0,27,18724
12/5/2016,22,9816,2589,4837,471,0,27,17740
12/5/2016,23,9803,1954,4321,397,0,28,16503
12/5/2016,24,9807,1702,3687,222,0,19,15437
12/6/2016,1,9815,1034,3051,184,0,15,14099
12/6/2016,2,9816,648,3126,317,0,16,13923
12/6/2016,3,9821,616,2955,491,0,17,13900
12/6/2016,4,9828,618,2763,701,0,24,13934
12/6/2016,5,9880,616,2994,1008,0,23,14521
12/6/2016,6,9883,674,2990,1273,0,29,14849
12/6/2016,7,9885,801,3419,1973,1,40,16119
12/6/2016,8,9885,800,3964,2474,2,48,17173
12/6/2016,9,9880,808,3869,2757,13,50,17377
12/6/2016,10,9879,818,3884,2765,32,35,17413
12/6/2016,11,9881,878,3756,2737,71,27,17350
12/6/2016,12,9880,1192,3533,2695,96,27,17423
12/6/2016,13,9875,1288,3585,2450,100,27,17325
12/6/2016,14,9868,1587,3659,2245,67,27,17453
12/6/2016,15,9865,1721,3891,2021,21,27,17546
12/6/2016,16,9855,2051,3829,2214,7,27,17983
12/6/2016,17,9859,2255,4431,1931,0,27,18503
12/6/2016,18,9840,2496,5234,1565,0,27,19162
12/6/2016,19,9840,2562,5418,1235,0,27,19082
12/6/2016,20,9838,2566,5191,1129,0,27,18751
12/6/2016,21,9840,1874,5116,1201,0,27,18058
12/6/2016,22,9837,1411,4587,1414,0,27,17276
12/6/2016,23,9840,1296,3840,1318,0,27,16321
12/6/2016,24,9846,912,3327,1678,0,17,15780
12/7/2016,1,9856,644,2844,2106,0,15,15465
12/7/2016,2,9863,607,2560,2287,0,13,15330
12/7/2016,3,9873,608,2465,2058,0,13,15017
12/7/2016,4,9874,612,2443,1898,0,12,14839
12/7/2016,5,9871,633,2600,2042,0,12,15158
12/7/2016,6,9875,633,2699,2454,0,17,15678
12/7/2016,7,9874,632,3286,2558,0,23,16373
12/7/2016,8,9862,640,3847,2705,1,27,17082
12/7/2016,9,9863,632,3832,2941,6,26,17300
12/7/2016,10,9862,630,3809,2945,17,26,17289
12/7/2016,11,9858,635,4194,2850,46,27,17610
12/7/2016,12,9863,677,4109,2767,38,27,17481
12/7/2016,13,9861,789,3755,2824,41,27,17297
12/7/2016,14,9706,927,3702,2997,63,28,17423
12/7/2016,15,9719,1117,3781,2989,42,28,17676
12/7/2016,16,9863,1160,3807,2942,11,27,17810
12/7/2016,17,9869,1225,4044,2653,1,27,17819
12/7/2016,18,9882,1328,4652,3008,0,27,18897
12/7/2016,19,9886,1328,4520,3104,0,28,18866
12/7/2016,20,9889,1291,4346,3182,0,27,18735
12/7/2016,21,9883,946,4549,3111,0,27,18516
12/7/2016,22,9880,798,4376,2771,0,27,17852
12/7/2016,23,9875,796,3614,2450,0,27,16762
12/7/2016,24,9879,635,3139,2465,0,19,16137
12/8/2016,1,9889,612,2540,2369,0,13,15423
12/8/2016,2,9895,611,2496,1913,0,10,14925
12/8/2016,3,9892,612,2515,1880,0,8,14907
12/8/2016,4,9895,613,2543,1592,0,12,14655
12/8/2016,5,9898,642,2658,1784,0,15,14997
12/8/2016,6,9889,670,2706,2490,0,36,15791
12/8/2016,7,9889,672,2997,2889,0,56,16503
12/8/2016,8,9892,679,3623,3142,0,58,17394
12/8/2016,9,9888,700,4103,3122,3,56,17872
12/8/2016,10,9889,693,4137,3102,9,63,17893
12/8/2016,11,9870,750,4203,3119,27,63,18032
12/8/2016,12,9870,851,4090,3295,16,62,18184
12/8/2016,13,9879,960,3596,3268,17,63,17783
12/8/2016,14,9888,963,3589,3349,15,64,17868
12/8/2016,15,9887,965,3579,3291,32,63,17817
12/8/2016,16,9884,959,3863,3343,7,58,18114
12/8/2016,17,9885,1132,4446,3325,0,57,18845
12/8/2016,18,9880,1166,4895,3467,0,58,19466
12/8/2016,19,9880,1042,4855,3488,0,56,19321
12/8/2016,20,9878,708,4986,3314,0,57,18943
12/8/2016,21,9876,661,4826,3409,0,48,18820
12/8/2016,22,9864,654,4295,3348,0,48,18209
12/8/2016,23,9878,653,3545,3045,0,48,17169
12/8/2016,24,9881,637,3041,2468,0,36,16063
12/9/2016,1,9882,609,2624,2160,0,21,15296
12/9/2016,2,9882,615,2577,1910,0,15,14999
12/9/2016,3,9884,667,2582,1860,0,12,15005
12/9/2016,4,9883,780,2584,1660,0,9,14916
12/9/2016,5,9871,935,2728,1416,0,12,14962
12/9/2016,6,9875,1332,2840,1659,0,20,15726
12/9/2016,7,9878,1737,3286,1802,0,35,16738
12/9/2016,8,9874,2013,4037,1908,0,44,17876
12/9/2016,9,9870,2267,4139,1692,0,50,18018
12/9/2016,10,9876,2270,4013,1510,7,51,17727
12/9/2016,11,9882,2256,3923,1412,26,56,17555
12/9/2016,12,9880,2087,3832,1553,39,51,17442
12/9/2016,13,9880,2070,3847,1455,81,42,17375
12/9/2016,14,9878,2047,3806,1550,98,31,17410
12/9/2016,15,9872,1554,4136,1677,35,27,17301
12/9/2016,16,9872,1510,4587,1487,10,29,17495
12/9/2016,17,9870,2026,5043,1404,1,29,18373
12/9/2016,18,9868,2840,5337,1170,0,34,19249
12/9/2016,19,9870,2715,5224,1143,0,35,18987
12/9/2016,20,9868,2771,5174,1154,0,27,18994
12/9/2016,21,9861,2676,5018,1175,0,27,18757
12/9/2016,22,9854,2464,4737,1265,0,27,18347
12/9/2016,23,9854,2078,3987,1298,0,27,17244
12/9/2016,24,9865,1265,3175,1315,0,17,15637
12/10/2016,1,9847,530,3003,1357,0,12,14749
12/10/2016,2,9848,409,3227,1388,0,9,14881
12/10/2016,3,9864,418,2998,1388,0,6,14674
12/10/2016,4,9867,429,3074,1402,0,6,14778
12/10/2016,5,9869,509,2858,1456,0,0,14692
12/10/2016,6,9858,706,3019,1320,0,0,14903
12/10/2016,7,9849,776,3478,1342,0,0,15445
12/10/2016,8,9857,810,4316,1417,2,0,16402
12/10/2016,9,9852,932,4533,1491,23,1,16832
12/10/2016,10,9850,991,4486,1582,39,1,16949
12/10/2016,11,9850,837,4309,1737,129,0,16862
12/10/2016,12,9851,859,4272,1825,126,0,16933
12/10/2016,13,9882,606,4324,2233,147,0,17192
12/10/2016,14,9885,661,4235,2524,119,0,17424
12/10/2016,15,9884,952,4251,2464,78,0,17629
12/10/2016,16,9881,1419,4928,2162,15,0,18405
12/10/2016,17,9873,1916,4968,1900,2,1,18660
12/10/2016,18,9870,2924,5562,1633,0,1,19990
12/10/2016,19,9867,3109,5670,1352,0,0,19998
12/10/2016,20,9868,2603,5433,1367,0,0,19271
12/10/2016,21,9862,2247,4739,1460,0,0,18308
12/10/2016,22,9868,2246,3962,1503,0,0,17579
12/10/2016,23,9860,1958,3947,1392,0,0,17157
12/10/2016,24,9867,1522,3859,1186,0,0,16434
12/11/2016,1,9887,585,3793,965,0,0,15230
12/11/2016,2,9893,414,3814,750,0,0,14871
12/11/2016,3,9889,421,3971,583,0,0,14864
12/11/2016,4,9892,487,3896,527,0,1,14803
12/11/2016,5,9891,575,3742,433,0,0,14641
12/11/2016,6,9893,588,3970,330,0,0,14781
12/11/2016,7,9888,740,3934,233,1,12,14808
12/11/2016,8,9891,752,4350,400,3,35,15431
12/11/2016,9,9892,841,4647,592,10,85,16067
12/11/2016,10,9887,1040,4864,843,19,94,16747
12/11/2016,11,9892,921,5106,1095,27,94,17135
12/11/2016,12,9887,668,4952,1368,14,93,16982
12/11/2016,13,9908,883,4928,1720,14,94,17547
12/11/2016,14,9919,1245,4859,1938,21,94,18076
12/11/2016,15,9923,1286,4593,2195,6,94,18097
12/11/2016,16,9626,1354,4710,2471,1,92,18254
12/11/2016,17,9136,1971,5528,2314,0,95,19044
12/11/2016,18,9140,2121,5355,2380,0,43,19039
12/11/2016,19,9144,2079,5471,2485,0,36,19215
12/11/2016,20,9144,1779,5438,2576,0,54,18991
12/11/2016,21,9136,1745,5148,2268,0,12,18309
12/11/2016,22,9122,2135,4451,1886,0,0,17594
12/11/2016,23,9109,1715,4245,1782,0,0,16851
12/11/2016,24,9109,1039,3466,1874,0,3,15491
12/12/2016,1,9110,557,3363,1698,0,12,14740
12/12/2016,2,9108,485,3442,1806,0,11,14852
12/12/2016,3,9169,559,3339,2042,0,12,15121
12/12/2016,4,9290,758,3068,1883,0,12,15011
12/12/2016,5,9332,1026,3233,1802,0,10,15403
12/12/2016,6,9459,1535,3201,1730,0,13,15938
12/12/2016,7,9503,1669,3882,1879,0,27,16960
12/12/2016,8,9501,1841,4586,2252,1,71,18252
12/12/2016,9,9390,1845,4492,2496,2,91,18316
12/12/2016,10,9582,1854,4346,2828,6,117,18733
12/12/2016,11,9635,1895,4208,3001,19,127,18885
12/12/2016,12,9688,1840,3833,3085,34,121,18601
12/12/2016,13,9696,1844,4022,3078,25,110,18775
12/12/2016,14,9682,1680,3936,2993,23,108,18422
12/12/2016,15,9688,1467,4292,2864,46,109,18466
12/12/2016,16,9689,1628,4274,2741,5,108,18445
12/12/2016,17,9710,2037,4860,2573,0,112,19292
12/12/2016,18,9715,2626,5219,2333,0,116,20009
12/12/2016,19,9401,3148,5401,1995,0,99,20044
12/12/2016,20,9172,3109,5399,1738,0,26,19444
12/12/2016,21,9161,2913,5108,1627,0,19,18828
12/12/2016,22,9168,2360,4562,1692,0,20,17802
12/12/2016,23,9159,1987,3670,1683,0,20,16519
12/12/2016,24,9167,1405,3208,1755,0,15,15550
12/13/2016,1,9167,1252,3115,1819,0,14,15367
12/13/2016,2,9168,1259,3125,1691,0,10,15253
12/13/2016,3,9166,1139,3626,1630,0,11,15572
12/13/2016,4,9165,1542,2949,1363,0,11,15030
12/13/2016,5,9163,2015,2925,1399,0,13,15515
12/13/2016,6,9168,2323,3173,913,0,15,15592
12/13/2016,7,9171,2388,3722,1163,0,36,16480
12/13/2016,8,9175,2395,4070,2312,1,72,18025
12/13/2016,9,9179,2395,3855,2677,4,108,18218
12/13/2016,10,9175,1952,4404,2537,16,118,18202
12/13/2016,11,9176,2257,4564,2434,28,140,18599
12/13/2016,12,9186,1870,4519,2518,33,132,18258
12/13/2016,13,9190,1596,4368,2565,30,140,17889
12/13/2016,14,9186,1857,4570,2333,17,140,18103
12/13/2016,15,9216,2186,4559,2173,8,132,18274
12/13/2016,16,9396,2268,4632,1872,2,134,18304
12/13/2016,17,9416,2270,4681,1754,0,135,18256
12/13/2016,18,9401,2403,5391,2054,0,133,19382
12/13/2016,19,9371,2421,5281,2435,0,119,19627
12/13/2016,20,9377,2410,4941,2786,0,122,19636
12/13/2016,21,9364,2022,5120,2849,0,175,19530
12/13/2016,22,9357,1284,4788,2960,0,176,18565
12/13/2016,23,9536,806,3818,3012,0,88,17260
12/13/2016,24,9581,725,3165,2859,0,27,16357
12/14/2016,1,9662,738,2847,2586,0,12,15845
12/14/2016,2,9762,733,2805,2151,0,11,15462
12/14/2016,3,9765,732,2764,1884,0,11,15156
12/14/2016,4,9764,733,2799,2173,0,12,15481
12/14/2016,5,9765,727,2868,2397,0,13,15770
12/14/2016,6,9765,716,3249,2571,0,13,16314
12/14/2016,7,9765,727,3516,2863,1,50,16922
12/14/2016,8,9766,735,4301,3098,2,104,18006
12/14/2016,9,9768,868,4665,3188,33,138,18660
12/14/2016,10,9770,1109,4666,3148,94,131,18918
12/14/2016,11,9770,1343,4512,3196,127,133,19081
12/14/2016,12,9773,1315,4344,3324,165,138,19059
12/14/2016,13,9793,1487,4018,3446,129,135,19008
12/14/2016,14,9865,1383,4141,3384,54,121,18948
12/14/2016,15,9865,1401,4388,3457,27,132,19270
12/14/2016,16,9863,1555,4410,3500,10,123,19461
12/14/2016,17,9874,1647,4503,3473,0,79,19576
12/14/2016,18,9888,2226,5340,3421,0,78,20953
12/14/2016,19,9894,2005,5266,3440,0,75,20680
12/14/2016,20,9890,1983,5394,3502,0,77,20846
12/14/2016,21,9885,1985,5087,3457,0,75,20489
12/14/2016,22,9881,1803,4374,3401,0,75,19534
12/14/2016,23,9880,1234,3794,3248,0,79,18235
12/14/2016,24,9900,870,3208,3270,0,21,17269
12/15/2016,1,9951,671,2904,3016,0,16,16558
12/15/2016,2,9487,692,3426,2801,0,15,16421
12/15/2016,3,9364,848,3308,3099,0,19,16638
12/15/2016,4,9375,1180,3188,3132,0,20,16895
12/15/2016,5,9374,1694,3252,3095,0,20,17435
12/15/2016,6,9551,2075,3530,2722,0,23,17901
12/15/2016,7,9710,2373,4290,2474,1,31,18879
12/15/2016,8,9828,2893,4618,2417,1,38,19795
12/15/2016,9,9809,3065,4795,2560,32,42,20303
12/15/2016,10,9779,2685,4566,2541,99,39,19709
12/15/2016,11,9837,2275,4396,2813,137,38,19496
12/15/2016,12,9977,2106,4323,2936,142,36,19520
12/15/2016,13,10293,1894,3951,3213,156,36,19543
12/15/2016,14,10626,1805,4032,3230,123,36,19852
12/15/2016,15,10626,1993,3761,3107,113,36,19636
12/15/2016,16,10624,2216,3890,3199,54,63,20046
12/15/2016,17,10614,2539,4863,3207,5,62,21290
12/15/2016,18,10617,3278,5455,3159,0,66,22575
12/15/2016,19,10615,3499,5285,3111,0,74,22584
12/15/2016,20,10622,3552,5316,3032,0,76,22598
12/15/2016,21,10621,3653,5287,2766,0,73,22400
12/15/2016,22,10609,3420,4983,2705,0,73,21790
12/15/2016,23,10611,2302,4121,2584,0,69,19687
12/15/2016,24,10651,1694,3481,2524,0,55,18405
12/16/2016,1,10720,1470,2952,2333,0,51,17526
12/16/2016,2,10722,1452,3180,2227,0,50,17631
12/16/2016,3,10718,1456,3086,1903,0,48,17211
12/16/2016,4,10721,1649,2899,1732,0,47,17048
12/16/2016,5,10725,2009,2915,1748,0,49,17446
12/16/2016,6,10737,2601,3233,1316,0,56,17943
12/16/2016,7,10732,3055,4010,1665,1,61,19524
12/16/2016,8,10731,3867,4922,1636,2,71,21229
12/16/2016,9,10723,4517,4858,1633,13,72,21816
12/16/2016,10,10731,3472,4660,1661,58,73,20655
12/16/2016,11,10779,3182,4570,1573,96,74,20274
12/16/2016,12,10805,3151,4434,1608,107,73,20178
12/16/2016,13,10802,3179,4286,1432,81,68,19848
12/16/2016,14,10652,3257,4808,1193,41,65,20016
12/16/2016,15,10708,3464,4807,942,22,57,20000
12/16/2016,16,10807,3796,5082,687,5,47,20424
12/16/2016,17,10806,4635,5279,804,1,53,21578
12/16/2016,18,10821,4563,5297,1069,0,52,21802
12/16/2016,19,10827,4248,5397,1354,0,16,21842
12/16/2016,20,10829,4468,5201,1400,0,5,21903
12/16/2016,21,10824,4804,4992,1306,0,27,21953
12/16/2016,22,10823,4899,4480,1222,0,36,21460
12/16/2016,23,10820,3925,3825,1349,0,36,19955
12/16/2016,24,10821,2062,3547,1522,0,29,17981
12/17/2016,1,10835,1626,2958,1649,0,15,17083
12/17/2016,2,10851,1142,3035,1168,0,4,16200
12/17/2016,3,10845,1017,2987,1610,0,4,16463
12/17/2016,4,10844,1131,3112,1699,0,3,16789
12/17/2016,5,10843,1270,3029,1579,0,3,16724
12/17/2016,6,10841,1507,3089,1420,0,3,16860
12/17/2016,7,10848,1841,3471,1181,0,14,17355
12/17/2016,8,10850,2092,3553,998,0,19,17512
12/17/2016,9,10844,2744,3785,991,0,21,18385
12/17/2016,10,10844,3067,4113,850,1,23,18898
12/17/2016,11,10838,3201,4338,569,6,26,18978
12/17/2016,12,10837,3343,4530,510,8,27,19255
12/17/2016,13,10838,3340,4478,403,7,27,19093
12/17/2016,14,10833,3202,4153,233,7,6,18434
12/17/2016,15,10838,3313,4051,193,4,3,18402
12/17/2016,16,10839,3376,4214,187,1,3,18620
12/17/2016,17,10840,3249,4583,215,0,3,18890
12/17/2016,18,10838,3647,4690,336,0,3,19514
12/17/2016,19,10843,3902,4746,314,0,3,19808
12/17/2016,20,10840,4023,4586,329,0,7,19785
12/17/2016,21,10835,3985,4334,271,0,7,19432
12/17/2016,22,10830,3135,3960,264,0,3,18192
12/17/2016,23,10832,3059,3475,372,0,2,17740
12/17/2016,24,10835,2395,3058,415,0,1,16704
12/18/2016,1,10838,1764,3040,510,0,0,16152
12/18/2016,2,10827,1011,2721,1082,0,0,15641
12/18/2016,3,10829,773,2645,1191,0,0,15438
12/18/2016,4,10828,621,2584,1113,0,0,15146
12/18/2016,5,10824,628,2691,1416,0,0,15559
12/18/2016,6,10826,708,2680,1502,0,0,15716
12/18/2016,7,10824,862,2737,1602,0,0,16025
12/18/2016,8,10823,945,3111,2046,0,1,16926
12/18/2016,9,10822,1028,3791,2272,1,0,17914
12/18/2016,10,10824,1124,4359,2263,8,0,18578
12/18/2016,11,10821,1287,4460,2174,16,0,18758
12/18/2016,12,10819,1297,4322,2077,56,0,18571
12/18/2016,13,10821,1608,4124,1805,80,0,18438
12/18/2016,14,10824,2141,3915,1637,101,0,18618
12/18/2016,15,10822,2284,3887,1563,68,0,18624
12/18/2016,16,10824,2315,4642,1381,37,0,19199
12/18/2016,17,10826,2920,5133,1054,5,2,19940
12/18/2016,18,10827,4220,5463,894,0,2,21406
12/18/2016,19,10830,4014,5374,951,0,4,21173
12/18/2016,20,10828,3498,5326,922,0,0,20574
12/18/2016,21,10818,3733,5129,837,0,0,20517
12/18/2016,22,10821,3642,4805,903,0,1,20172
12/18/2016,23,10824,2850,3984,966,0,0,18624
12/18/2016,24,10831,2351,3613,878,0,2,17675
12/19/2016,1,10830,2101,3453,989,0,11,17384
12/19/2016,2,10828,1783,3305,1164,0,17,17097
12/19/2016,3,10824,1535,2691,1353,0,17,16420
12/19/2016,4,10817,1653,2760,1314,0,18,16562
12/19/2016,5,10823,1732,3000,1300,0,19,16874
12/19/2016,6,10826,2424,3413,1304,0,27,17994
12/19/2016,7,10830,3073,4323,1389,0,35,19650
12/19/2016,8,10830,3909,4928,1311,1,44,21023
12/19/2016,9,10825,4326,5076,1165,7,48,21447
12/19/2016,10,10827,4494,5155,1057,32,46,21611
12/19/2016,11,10825,4080,4933,1172,87,46,21143
12/19/2016,12,10827,4052,4767,1293,99,44,21082
12/19/2016,13,10831,3917,4673,1421,101,37,20980
12/19/2016,14,10831,3717,4560,1616,97,42,20863
12/19/2016,15,10835,3176,4532,1680,72,69,20364
12/19/2016,16,10840,3599,4620,1828,19,126,21032
12/19/2016,17,10844,4037,5050,2098,1,127,22157
12/19/2016,18,10840,4223,5358,2446,0,94,22961
12/19/2016,19,10848,4278,5347,2636,0,87,23196
12/19/2016,20,10854,4074,5261,2929,0,83,23201
12/19/2016,21,10849,4127,5185,3007,0,107,23275
12/19/2016,22,10833,3693,4376,3067,0,183,22152
12/19/2016,23,10834,2847,3227,3076,0,210,20194
12/19/2016,24,10836,1688,2516,3054,0,172,18266
12/20/2016,1,10836,1041,2370,2914,0,81,17242
12/20/2016,2,10834,796,2566,2954,0,74,17224
12/20/2016,3,10829,696,2657,3019,0,93,17294
12/20/2016,4,10837,720,2547,3214,0,71,17389
12/20/2016,5,10837,850,2482,3193,0,73,17435
12/20/2016,6,10841,1105,2705,3108,0,77,17836
12/20/2016,7,10839,1329,3332,3034,0,82,18616
12/20/2016,8,10843,1350,4376,3621,1,109,20300
12/20/2016,9,10842,1350,4508,3657,10,62,20429
12/20/2016,10,10835,1351,4208,3652,49,63,20158
12/20/2016,11,10843,1353,4100,3731,55,63,20145
12/20/2016,12,10843,1353,3885,3632,41,68,19822
12/20/2016,13,10844,961,3727,3767,41,68,19408
12/20/2016,14,10842,734,3977,3782,44,62,19441
12/20/2016,15,10844,750,3650,3770,35,60,19109
12/20/2016,16,10845,753,3935,3772,37,56,19398
12/20/2016,17,10847,745,4390,3696,3,50,19731
12/20/2016,18,10846,752,5116,3853,0,46,20613
12/20/2016,19,11017,748,5014,3871,0,35,20685
12/20/2016,20,11049,747,4729,3830,0,31,20386
12/20/2016,21,11044,748,4625,3804,0,33,20254
12/20/2016,22,11044,832,4167,3708,0,33,19784
12/20/2016,23,11053,847,3257,3606,0,33,18796
12/20/2016,24,11230,738,2559,3403,0,24,17954
12/21/2016,1,11347,728,2398,2448,0,21,16942
12/21/2016,2,11387,664,2453,1765,0,21,16290
12/21/2016,3,11386,723,2384,1734,0,20,16247
12/21/2016,4,11381,675,2371,1745,0,21,16193
12/21/2016,5,11377,756,2423,1701,0,27,16284
12/21/2016,6,11377,912,2490,2320,0,55,17154
12/21/2016,7,11383,999,3377,2226,0,86,18071
12/21/2016,8,11388,995,3995,2158,0,79,18615
12/21/2016,9,11389,989,4017,2197,13,77,18682
12/21/2016,10,11408,994,4327,1842,34,86,18691
12/21/2016,11,11439,1117,4454,1518,45,135,18708
12/21/2016,12,11440,1323,4307,1241,68,196,18575
12/21/2016,13,11468,1576,4248,905,100,203,18500
12/21/2016,14,11460,1653,3881,900,99,181,18174
12/21/2016,15,11483,1373,4168,946,56,189,18215
12/21/2016,16,11591,1348,4263,1010,14,147,18373
12/21/2016,17,11585,1523,5281,1110,0,185,19684
12/21/2016,18,11594,1773,5485,1146,0,206,20204
12/21/2016,19,11589,1710,5332,1350,0,200,20181
12/21/2016,20,11596,1454,4966,1551,0,153,19720
12/21/2016,21,11590,1412,4680,1582,0,151,19415
12/21/2016,22,11595,1027,4165,1773,0,168,18728
12/21/2016,23,11603,908,3136,2235,0,91,17973
12/21/2016,24,11603,807,2671,2189,0,36,17306
12/22/2016,1,11609,644,2347,2244,0,20,16864
12/22/2016,2,11631,619,2267,2194,0,18,16729
12/22/2016,3,11641,618,2303,1800,0,16,16378
12/22/2016,4,11644,618,2263,1827,0,16,16368
12/22/2016,5,11645,617,2278,1844,0,19,16403
12/22/2016,6,11649,618,2314,2210,0,24,16815
12/22/2016,7,11649,620,3016,2409,0,45,17739
12/22/2016,8,11655,631,4125,2267,0,90,18768
12/22/2016,9,11649,764,4640,2230,0,154,19437
12/22/2016,10,11651,851,4335,2312,0,172,19321
12/22/2016,11,11660,944,3998,2446,2,113,19163
12/22/2016,12,11626,1095,3671,2408,5,59,18864
12/22/2016,13,11657,1371,3770,2332,12,58,19200
12/22/2016,14,11666,1596,3655,2144,16,51,19128
12/22/2016,15,11659,1711,3998,1651,30,51,19100
12/22/2016,16,11657,1906,4303,1224,21,96,19207
12/22/2016,17,11661,1879,4633,1295,1,124,19593
12/22/2016,18,11659,2027,5272,1292,0,151,20401
12/22/2016,19,11654,2025,5068,1454,0,129,20330
12/22/2016,20,11646,2006,4662,2021,0,90,20425
12/22/2016,21,11641,1199,4734,2298,0,53,19925
12/22/2016,22,11636,710,4147,2556,0,49,19098
12/22/2016,23,11649,626,3386,2489,0,12,18162
12/22/2016,24,11655,624,2720,2285,0,0,17284
12/23/2016,1,11660,622,2284,2310,0,0,16876
12/23/2016,2,11657,623,2253,1569,0,0,16102
12/23/2016,3,11661,621,2259,1323,0,0,15864
12/23/2016,4,11655,622,2280,1425,0,0,15982
12/23/2016,5,11665,622,2328,1421,0,0,16036
12/23/2016,6,11657,622,2366,1841,0,0,16486
12/23/2016,7,11659,626,2822,2317,0,0,17424
12/23/2016,8,11659,629,3588,2754,1,0,18631
12/23/2016,9,11659,630,3588,2817,16,0,18710
12/23/2016,10,11661,628,3433,2514,60,0,18296
12/23/2016,11,11658,625,3513,2329,87,0,18212
12/23/2016,12,11660,623,3483,2495,97,0,18358
12/23/2016,13,11659,623,3469,2126,98,0,17975
12/23/2016,14,11580,622,3654,1860,82,0,17798
12/23/2016,15,11652,620,3639,1925,67,5,17908
12/23/2016,16,11657,617,3801,1997,27,5,18104
12/23/2016,17,11661,619,4345,1904,2,18,18549
12/23/2016,18,11657,620,4764,2018,0,25,19084
12/23/2016,19,11653,622,5089,1871,0,18,19253
12/23/2016,20,11655,699,5109,1909,0,16,19388
12/23/2016,21,11640,669,5061,1812,0,16,19198
12/23/2016,22,11639,640,4667,1581,0,16,18543
12/23/2016,23,11623,626,3277,1567,0,17,17110
12/23/2016,24,11661,389,2729,1779,0,3,16561
12/24/2016,1,11658,340,2359,1878,0,0,16235
12/24/2016,2,11666,260,2298,1707,0,2,15933
12/24/2016,3,11664,252,2365,1271,0,2,15554
12/24/2016,4,11662,257,2369,1095,0,0,15383
12/24/2016,5,11654,257,2312,1077,0,0,15300
12/24/2016,6,11652,276,2379,1046,0,0,15353
12/24/2016,7,11652,281,2485,1275,0,0,15693
12/24/2016,8,11656,280,2519,1997,1,0,16453
12/24/2016,9,11662,279,2936,2134,2,0,17013
12/24/2016,10,11648,322,3951,1864,8,0,17793
12/24/2016,11,11626,429,4434,1541,36,0,18066
12/24/2016,12,11610,409,3774,1466,40,0,17299
12/24/2016,13,11605,276,3854,1498,28,0,17261
12/24/2016,14,11597,278,3647,1464,32,0,17018
12/24/2016,15,11602,281,4056,1201,22,0,17162
12/24/2016,16,11551,404,4185,1184,8,0,17332
12/24/2016,17,11600,283,4133,1082,0,0,17098
12/24/2016,18,11604,277,4239,1117,0,0,17237
12/24/2016,19,11596,277,4465,1111,0,0,17449
12/24/2016,20,11588,279,4401,1005,0,0,17273
12/24/2016,21,11586,281,4017,1004,0,0,16888
12/24/2016,22,11593,282,4002,893,0,0,16770
12/24/2016,23,11595,315,3980,622,0,1,16513
12/24/2016,24,11604,356,3522,555,0,5,16042
12/25/2016,1,11610,293,2621,572,0,2,15098
12/25/2016,2,11613,285,2346,461,0,2,14707
12/25/2016,3,11413,282,2339,611,0,9,14654
12/25/2016,4,11043,282,2685,524,0,6,14540
12/25/2016,5,11022,283,2900,371,0,0,14576
12/25/2016,6,11039,285,3032,335,0,0,14691
12/25/2016,7,11368,284,2797,375,0,0,14824
12/25/2016,8,11623,285,3173,579,1,0,15661
12/25/2016,9,11615,284,3620,800,14,0,16333
12/25/2016,10,11621,284,3780,864,54,0,16603
12/25/2016,11,11623,284,3400,893,101,0,16301
12/25/2016,12,11624,284,3550,948,123,0,16529
12/25/2016,13,11618,285,3646,979,127,0,16655
12/25/2016,14,11628,285,3545,1080,113,0,16651
12/25/2016,15,11631,285,3779,1117,73,0,16885
12/25/2016,16,11631,283,3866,1193,30,0,17003
12/25/2016,17,11634,283,3958,1646,2,0,17523
12/25/2016,18,11621,283,3830,2240,1,0,17975
12/25/2016,19,11613,282,3599,2686,1,0,18181
12/25/2016,20,11629,281,3559,2634,0,0,18103
12/25/2016,21,11622,283,3238,2669,0,0,17812
12/25/2016,22,11603,283,2906,2890,0,0,17682
12/25/2016,23,11588,279,2454,2819,0,0,17140
12/25/2016,24,11583,282,2339,2416,0,0,16620
12/26/2016,1,11576,282,2302,1594,0,0,15754
12/26/2016,2,11576,284,2272,1323,0,0,15455
12/26/2016,3,11572,287,2340,962,0,0,15161
12/26/2016,4,11567,295,2427,503,0,0,14792
12/26/2016,5,11590,312,2325,757,0,0,14984
12/26/2016,6,11606,310,2341,1078,0,0,15335
12/26/2016,7,11605,308,2424,1698,0,0,16035
12/26/2016,8,11602,308,2539,2269,0,0,16718
12/26/2016,9,11604,306,2561,2728,2,0,17201
12/26/2016,10,11594,309,2920,2801,8,0,17632
12/26/2016,11,11574,309,3072,2820,20,0,17795
12/26/2016,12,11572,309,3137,3425,23,0,18466
12/26/2016,13,11590,309,3370,2890,31,0,18190
12/26/2016,14,11597,310,3348,2944,11,0,18210
12/26/2016,15,11606,307,3329,2711,8,0,17961
12/26/2016,16,11613,307,3294,2828,2,0,18044
12/26/2016,17,11619,310,3369,3110,0,0,18408
12/26/2016,18,11618,308,3636,3255,0,0,18817
12/26/2016,19,11621,308,3575,2988,0,0,18492
12/26/2016,20,11619,308,3581,2812,0,0,18320
12/26/2016,21,11618,309,3387,2480,0,0,17794
12/26/2016,22,11607,280,2950,2484,0,0,17321
12/26/2016,23,11610,280,2531,1960,0,0,16381
12/26/2016,24,11580,280,2405,1437,0,0,15702
12/27/2016,1,11582,280,2313,890,0,0,15065
12/27/2016,2,11582,281,2295,650,0,0,14808
12/27/2016,3,11321,281,2320,477,0,0,14399
12/27/2016,4,10979,282,2361,743,0,0,14365
12/27/2016,5,10993,281,2343,710,0,0,14327
12/27/2016,6,10986,281,2726,890,0,0,14883
12/27/2016,7,10991,281,2800,1288,0,0,15360
12/27/2016,8,11132,281,2930,1314,1,0,15658
12/27/2016,9,11486,280,2562,1577,2,0,15907
12/27/2016,10,11590,289,3053,1754,11,0,16697
12/27/2016,11,11585,301,2999,2227,18,0,17130
12/27/2016,12,11585,303,3001,2561,22,0,17472
12/27/2016,13,11579,304,3006,2369,21,0,17279
12/27/2016,14,11579,306,3050,2300,16,0,17251
12/27/2016,15,11579,327,3056,2188,10,0,17160
12/27/2016,16,11579,356,3050,2372,4,0,17361
12/27/2016,17,11570,362,3535,2575,1,0,18043
12/27/2016,18,11567,442,4149,2849,0,0,19007
12/27/2016,19,11572,478,4106,2544,0,0,18700
12/27/2016,20,11577,584,3883,2618,0,0,18662
12/27/2016,21,11578,580,3693,2721,0,0,18572
12/27/2016,22,11570,311,3301,2765,0,0,17947
12/27/2016,23,11569,286,3035,2465,0,0,17355
12/27/2016,24,11559,285,2951,2222,0,0,17017
12/28/2016,1,11537,285,2487,1881,0,5,16195
12/28/2016,2,11554,287,2309,1597,0,17,15764
12/28/2016,3,11557,287,2309,1370,0,27,15550
12/28/2016,4,11561,286,2338,1280,0,18,15483
12/28/2016,5,11567,363,2328,1278,0,25,15561
12/28/2016,6,11562,386,2529,1203,0,25,15705
12/28/2016,7,11573,437,3497,913,0,27,16447
12/28/2016,8,11582,646,4119,657,1,27,17032
12/28/2016,9,11562,653,4674,420,9,27,17345
12/28/2016,10,11570,622,4242,491,48,27,17000
12/28/2016,11,11581,628,3925,592,98,27,16851
12/28/2016,12,11586,630,3815,716,97,30,16874
12/28/2016,13,11586,628,4210,870,53,30,17377
12/28/2016,14,11435,633,4400,915,50,27,17460
12/28/2016,15,11528,634,4504,943,26,27,17662
12/28/2016,16,11589,641,4871,1105,11,27,18244
12/28/2016,17,11588,644,4707,1336,1,27,18303
12/28/2016,18,11587,654,4868,1660,0,27,18796
12/28/2016,19,11586,654,4572,2243,0,23,19078
12/28/2016,20,11585,630,4314,2788,0,18,19335
12/28/2016,21,11578,626,4088,3068,0,26,19386
12/28/2016,22,11568,627,3371,2905,0,26,18497
12/28/2016,23,11568,625,2625,2748,0,25,17591
12/28/2016,24,11575,621,2307,2468,0,15,16986
12/29/2016,1,11568,618,2279,1926,0,13,16404
12/29/2016,2,11573,615,2247,1559,0,13,16007
12/29/2016,3,11573,614,2329,1297,0,12,15825
12/29/2016,4,11573,617,2309,1428,0,12,15939
12/29/2016,5,11564,612,2361,1346,0,14,15897
12/29/2016,6,11560,613,2512,1943,0,16,16644
12/29/2016,7,11562,613,2887,2215,0,20,17297
12/29/2016,8,11568,626,3317,2453,0,34,17998
12/29/2016,9,11565,637,3353,2664,0,40,18259
12/29/2016,10,11566,647,3414,2674,2,41,18344
12/29/2016,11,11563,645,3685,2741,3,31,18668
12/29/2016,12,11564,648,3485,3018,3,28,18746
12/29/2016,13,11560,649,3645,2786,4,28,18672
12/29/2016,14,11555,648,3737,2505,4,28,18477
12/29/2016,15,11558,647,3735,2421,2,28,18391
12/29/2016,16,11559,650,3801,2316,1,28,18355
12/29/2016,17,11609,650,4178,2532,0,28,18997
12/29/2016,18,11600,660,4485,2981,0,28,19754
12/29/2016,19,11601,655,4248,3129,0,28,19661
12/29/2016,20,11600,652,4099,3048,0,26,19425
12/29/2016,21,11591,655,3859,3025,0,26,19156
12/29/2016,22,11593,651,3317,3069,0,26,18656
12/29/2016,23,11594,653,2687,2768,0,26,17728
12/29/2016,24,11602,647,2499,2413,0,12,17173
12/30/2016,1,11602,648,2462,2040,0,10,16762
12/30/2016,2,11603,650,2464,1392,0,10,16119
12/30/2016,3,11597,647,2517,1154,0,11,15926
12/30/2016,4,11596,644,2482,897,0,11,15630
12/30/2016,5,11605,647,2532,931,0,11,15726
12/30/2016,6,11597,650,2589,1268,0,12,16116
12/30/2016,7,11602,650,2669,2000,0,20,16941
12/30/2016,8,11598,659,3143,1422,1,27,16850
12/30/2016,9,11596,660,3437,1716,3,27,17439
12/30/2016,10,11607,661,3420,2120,8,27,17843
12/30/2016,11,11606,660,3352,2458,15,27,18118
12/30/2016,12,11609,658,3278,2539,22,27,18133
12/30/2016,13,11611,657,3306,2512,21,27,18134
12/30/2016,14,11613,649,3402,2262,24,26,17976
12/30/2016,15,11603,622,3435,2380,13,26,18079
12/30/2016,16,11608,627,3477,2604,5,24,18345
12/30/2016,17,11601,629,4286,2521,1,27,19065
12/30/2016,18,11599,629,5388,2264,0,27,19907
12/30/2016,19,11602,629,5741,1915,0,27,19914
12/30/2016,20,11600,627,5503,1895,0,27,19652
12/30/2016,21,11589,629,5269,1885,0,25,19397
12/30/2016,22,11595,627,4823,1472,0,24,18541
12/30/2016,23,11592,626,4199,1347,0,26,17790
12/30/2016,24,11594,441,4091,1279,0,18,17423
12/31/2016,1,11589,416,3849,1275,0,11,17140
12/31/2016,2,11597,394,3313,1369,0,1,16674
12/31/2016,3,11594,334,2926,1687,0,3,16544
12/31/2016,4,11589,336,2456,1964,0,7,16352
12/31/2016,5,11593,333,2457,1996,0,9,16388
12/31/2016,6,11595,347,2519,2008,0,20,16489
12/31/2016,7,11603,362,2607,1786,0,21,16379
12/31/2016,8,11600,362,2605,2639,1,20,17227
12/31/2016,9,11608,362,2656,3090,7,12,17735
12/31/2016,10,11612,363,3162,2959,12,12,18120
12/31/2016,11,11609,361,3122,3384,16,11,18503
12/31/2016,12,11605,359,3177,3390,28,0,18559
12/31/2016,13,11595,362,3150,3520,29,15,18671
12/31/2016,14,11602,360,3235,3217,24,9,18447
12/31/2016,15,11564,362,3196,3308,20,8,18458
12/31/2016,16,11598,362,3314,3302,8,3,18587
12/31/2016,17,11598,362,4176,3333,2,1,19472
12/31/2016,18,11601,363,4784,3466,0,1,20215
12/31/2016,19,11608,363,4181,3575,0,1,19728
12/31/2016,20,11607,364,3796,3444,0,7,19218
12/31/2016,21,11598,362,3721,2932,0,4,18617
12/31/2016,22,11591,334,3360,2612,0,1,17898
12/31/2016,23,11593,332,2569,2986,0,1,17481
12/31/2016,24,11594,304,2464,2679,0,1,17042
