Date,Hour,NUCLEAR,GAS,HYDRO,WIND,SOLAR,BIOFUEL,Total Output
1/1/2018,1,11671,1583,4152,992,0,3,18401
1/1/2018,2,11672,1192,4093,1124,0,1,18082
1/1/2018,3,11672,1040,4231,1265,0,0,18208
1/1/2018,4,11669,1041,3895,1369,0,0,17974
1/1/2018,5,11674,1004,3271,1848,0,0,17797
1/1/2018,6,11682,1048,3292,2022,0,0,18044
1/1/2018,7,11682,966,3977,2378,0,1,19004
1/1/2018,8,11682,741,4311,2542,0,4,19280
1/1/2018,9,11678,650,4058,2719,2,2,19109
1/1/2018,10,11682,556,4644,2687,13,2,19584
1/1/2018,11,11679,636,4171,2805,36,3,19330
1/1/2018,12,11688,847,3819,2806,47,3,19210
1/1/2018,13,11682,1059,3790,2859,62,2,19454
1/1/2018,14,11681,1288,3592,2655,65,1,19282
1/1/2018,15,11681,1623,3703,2267,49,0,19323
1/1/2018,16,11680,2031,3802,2681,25,0,20219
1/1/2018,17,11669,2280,4779,2772,5,0,21505
1/1/2018,18,11668,2690,5670,2721,0,0,22749
1/1/2018,19,11678,2582,5170,2921,0,0,22351
1/1/2018,20,11677,2490,5073,2974,0,0,22214
1/1/2018,21,11679,2315,5162,2855,0,0,22011
1/1/2018,22,11674,1767,4946,2658,0,0,21045
1/1/2018,23,11674,1017,4158,2572,0,0,19421
1/1/2018,24,11679,937,3809,2722,0,5,19152
1/2/2018,1,11663,948,3564,2871,0,12,19058
1/2/2018,2,11663,621,3164,2538,0,16,18002
1/2/2018,3,11660,551,3161,2646,0,14,18032
1/2/2018,4,11657,607,3153,2284,0,13,17714
1/2/2018,5,11658,859,3051,2646,0,4,18218
1/2/2018,6,11663,1113,3276,2858,0,2,18912
1/2/2018,7,11671,1225,3818,3375,0,4,20093
1/2/2018,8,11674,1367,4801,3611,0,4,21457
1/2/2018,9,11671,1500,5153,3550,5,5,21884
1/2/2018,10,11671,1552,5235,3659,16,13,22146
1/2/2018,11,11648,1439,5384,3781,35,18,22305
1/2/2018,12,11606,1657,4973,3854,60,28,22178
1/2/2018,13,11603,1602,4631,3902,76,27,21841
1/2/2018,14,11604,1607,4250,3892,76,30,21459
1/2/2018,15,11600,1791,4019,3846,55,33,21344
1/2/2018,16,11643,2163,4258,3438,21,35,21558
1/2/2018,17,11663,2616,4737,3413,4,34,22467
1/2/2018,18,11668,2658,5211,3754,0,46,23337
1/2/2018,19,11658,2677,5026,3782,0,45,23188
1/2/2018,20,11656,2317,5028,3713,0,44,22758
1/2/2018,21,11641,2126,5379,3775,0,45,22966
1/2/2018,22,11630,1339,4937,3445,0,35,21386
1/2/2018,23,11653,476,4489,3204,0,33,19855
1/2/2018,24,11642,369,3966,3368,0,21,19366
1/3/2018,1,10824,364,3747,3374,0,15,18324
1/3/2018,2,10817,372,3732,3308,0,16,18245
1/3/2018,3,10816,377,3853,3004,0,17,18067
1/3/2018,4,10816,450,3840,2881,0,18,18005
1/3/2018,5,10825,886,3727,2876,0,18,18332
1/3/2018,6,10831,1273,3747,2604,0,19,18474
1/3/2018,7,10831,1557,3774,3187,0,27,19376
1/3/2018,8,10825,1768,4720,3299,0,33,20645
1/3/2018,9,10823,2007,5185,3190,3,35,21243
1/3/2018,10,10818,2203,5279,3283,11,35,21629
1/3/2018,11,10820,2194,4832,3279,39,34,21198
1/3/2018,12,10827,2188,4986,3083,62,35,21181
1/3/2018,13,10828,2216,5066,2956,54,35,21155
1/3/2018,14,10830,2264,4752,3026,35,34,20941
1/3/2018,15,10823,2571,4405,2988,33,50,20870
1/3/2018,16,10816,2998,4891,2761,16,86,21568
1/3/2018,17,10760,3419,5378,2582,3,129,22271
1/3/2018,18,10754,4186,5528,2382,0,141,22991
1/3/2018,19,10753,3941,5454,2305,0,147,22600
1/3/2018,20,10755,3430,5195,2234,0,101,21715
1/3/2018,21,10774,3402,5097,2009,0,77,21359
1/3/2018,22,10784,2818,5058,1837,0,108,20605
1/3/2018,23,10721,2472,4556,1906,0,110,19765
1/3/2018,24,10757,1547,4044,1892,0,62,18302
1/4/2018,1,10821,940,3558,1961,0,46,17326
1/4/2018,2,10840,871,3514,1800,0,10,17035
1/4/2018,3,10855,891,3603,1877,0,10,17236
1/4/2018,4,10867,1147,3694,1690,0,10,17408
1/4/2018,5,10863,1924,3599,1204,0,11,17601
1/4/2018,6,10863,2637,3888,1099,0,15,18502
1/4/2018,7,10868,2869,4008,1825,0,19,19589
1/4/2018,8,10833,2880,4222,2571,0,25,20531
1/4/2018,9,10782,2855,4715,2647,2,26,21027
1/4/2018,10,10786,2850,4640,2529,17,26,20848
1/4/2018,11,10795,2742,4445,2616,41,26,20665
1/4/2018,12,10798,2476,4350,2478,65,26,20193
1/4/2018,13,10798,2414,4303,2321,94,26,19956
1/4/2018,14,10797,2471,4670,2053,100,26,20117
1/4/2018,15,10795,2623,4769,1779,86,30,20082
1/4/2018,16,10803,2706,4840,1810,44,29,20232
1/4/2018,17,10860,2739,5007,1784,10,35,20435
1/4/2018,18,10855,2870,5018,2810,0,37,21590
1/4/2018,19,10864,2895,5103,2586,0,38,21486
1/4/2018,20,10864,2458,5159,3156,0,33,21670
1/4/2018,21,10856,2510,4904,3001,0,33,21304
1/4/2018,22,10855,2127,4885,3050,0,20,20937
1/4/2018,23,10723,1886,5155,3010,0,24,20798
1/4/2018,24,10689,1603,4999,2823,0,36,20150
1/5/2018,1,10661,665,4706,2581,0,67,18680
1/5/2018,2,10668,431,3732,2759,0,60,17650
1/5/2018,3,10669,442,3761,2613,0,57,17542
1/5/2018,4,10678,703,3873,2377,0,60,17691
1/5/2018,5,10676,1434,3963,2168,0,63,18304
1/5/2018,6,10698,1739,3855,2306,0,64,18662
1/5/2018,7,10887,1912,4549,2316,0,72,19736
1/5/2018,8,10881,2070,5213,2306,0,126,20596
1/5/2018,9,10866,2207,5321,2370,9,197,20970
1/5/2018,10,10862,2407,5236,2276,48,204,21033
1/5/2018,11,10872,2650,5281,2196,93,203,21295
1/5/2018,12,11064,2290,5386,2280,117,201,21338
1/5/2018,13,11232,1876,5242,2540,124,189,21203
1/5/2018,14,11338,1774,5009,2703,116,147,21087
1/5/2018,15,11089,1906,5018,2794,98,149,21054
1/5/2018,16,11132,2313,5132,2988,51,207,21823
1/5/2018,17,11277,2650,5447,3089,12,213,22688
1/5/2018,18,11370,3438,5445,3000,0,197,23450
1/5/2018,19,11375,3696,5485,2988,0,148,23692
1/5/2018,20,11380,2925,5484,3033,0,192,23014
1/5/2018,21,11378,3244,5311,3016,0,205,23154
1/5/2018,22,11381,2907,4721,3213,0,215,22437
1/5/2018,23,11376,2166,4111,3135,0,174,20962
1/5/2018,24,11375,1434,4279,2929,0,94,20111
1/6/2018,1,11377,1010,3948,2785,0,69,19189
1/6/2018,2,11415,866,3409,2765,0,15,18470
1/6/2018,3,11461,980,3528,2447,0,3,18419
1/6/2018,4,11531,1250,3676,2525,0,13,18995
1/6/2018,5,11546,1507,3654,2442,0,21,19170
1/6/2018,6,11556,1895,3534,2459,0,14,19458
1/6/2018,7,11559,2148,3778,2331,0,0,19816
1/6/2018,8,11561,2362,4684,2215,0,0,20822
1/6/2018,9,11556,3680,4442,2005,9,0,21692
1/6/2018,10,11558,3759,4955,1694,36,0,22002
1/6/2018,11,11549,3695,5375,1339,78,0,22036
1/6/2018,12,11550,4367,5392,1058,101,20,22488
1/6/2018,13,11562,4019,5354,1045,120,54,22154
1/6/2018,14,11558,3876,5206,1082,119,86,21927
1/6/2018,15,11526,3908,4962,1109,99,112,21716
1/6/2018,16,11564,4392,4916,994,52,149,22067
1/6/2018,17,11572,4650,5224,874,13,168,22501
1/6/2018,18,11585,4962,5719,884,0,185,23335
1/6/2018,19,11585,4072,5742,846,0,174,22419
1/6/2018,20,11580,3987,5853,782,0,142,22344
1/6/2018,21,11579,4480,5695,734,0,161,22649
1/6/2018,22,11576,5022,5278,682,0,171,22729
1/6/2018,23,11576,4014,4956,679,0,171,21396
1/6/2018,24,11576,2851,4674,770,0,174,20045
1/7/2018,1,11581,2016,4811,846,0,171,19425
1/7/2018,2,11583,1459,4712,1027,0,161,18942
1/7/2018,3,11590,1010,4392,1453,0,111,18556
1/7/2018,4,11586,601,4313,1955,0,71,18526
1/7/2018,5,11589,366,3835,2327,0,55,18172
1/7/2018,6,11600,336,3848,2593,0,12,18389
1/7/2018,7,11601,338,3808,2998,0,0,18745
1/7/2018,8,11596,422,3863,3303,0,1,19185
1/7/2018,9,11589,626,4145,3654,6,1,20021
1/7/2018,10,11579,820,4237,3716,22,0,20374
1/7/2018,11,11611,955,4551,3793,51,0,20961
1/7/2018,12,11589,1010,5103,3709,52,1,21464
1/7/2018,13,11579,1158,4978,3723,38,0,21476
1/7/2018,14,11584,1312,4164,3766,27,0,20853
1/7/2018,15,11587,1350,4308,3754,21,19,21039
1/7/2018,16,11549,1448,4830,3735,13,59,21634
1/7/2018,17,11578,1678,5221,3732,4,143,22356
1/7/2018,18,11588,2130,5540,3707,0,178,23143
1/7/2018,19,11591,2056,5487,3646,0,178,22958
1/7/2018,20,11593,1645,4821,3719,0,125,21903
1/7/2018,21,11591,1205,4658,3662,0,56,21172
1/7/2018,22,11584,670,4166,3445,0,51,19916
1/7/2018,23,11579,550,4117,3372,0,25,19643
1/7/2018,24,11586,377,3584,3336,0,12,18895
1/8/2018,1,11599,337,3338,2702,0,13,17989
1/8/2018,2,11602,337,3330,2428,0,13,17710
1/8/2018,3,11599,336,3369,1999,0,12,17315
1/8/2018,4,11593,335,3269,2032,0,12,17241
1/8/2018,5,11600,329,3235,1968,0,13,17145
1/8/2018,6,11605,345,3335,2512,0,14,17811
1/8/2018,7,11606,411,3430,2790,0,21,18258
1/8/2018,8,11598,524,3958,3300,0,26,19406
1/8/2018,9,11593,526,4354,3333,0,16,19822
1/8/2018,10,11586,527,4422,3308,6,19,19868
1/8/2018,11,11586,531,4568,3369,12,21,20087
1/8/2018,12,11584,642,4163,3382,20,27,19818
1/8/2018,13,11588,698,4468,3357,19,29,20159
1/8/2018,14,11478,855,4100,3305,20,33,19791
1/8/2018,15,11448,1011,4085,3344,27,29,19944
1/8/2018,16,11578,1346,4212,3146,22,30,20334
1/8/2018,17,11580,1307,4579,3325,4,27,20822
1/8/2018,18,11584,1140,4935,3359,0,34,21052
1/8/2018,19,11586,1103,4855,3237,0,34,20815
1/8/2018,20,11587,963,4909,3076,0,34,20569
1/8/2018,21,11627,762,4818,3200,0,34,20441
1/8/2018,22,11477,566,4256,3183,0,34,19516
1/8/2018,23,11520,499,3734,2516,0,34,18303
1/8/2018,24,11585,327,3371,2314,0,25,17622
1/9/2018,1,10806,292,3100,2586,0,18,16802
1/9/2018,2,10766,291,3100,2163,0,18,16338
1/9/2018,3,10793,303,3155,1922,0,18,16191
1/9/2018,4,10794,328,3154,1779,0,18,16073
1/9/2018,5,10798,508,3193,1782,0,21,16302
1/9/2018,6,10806,873,3248,1142,0,25,16094
1/9/2018,7,10812,1419,3658,1192,0,29,17110
1/9/2018,8,10818,1855,4739,1398,0,35,18845
1/9/2018,9,10817,1880,4486,1227,17,35,18462
1/9/2018,10,10817,1996,4508,850,54,35,18260
1/9/2018,11,10809,2121,4680,702,76,35,18423
1/9/2018,12,10809,2272,4529,553,107,35,18305
1/9/2018,13,10813,2302,4777,510,101,35,18538
1/9/2018,14,10817,2751,4776,398,82,35,18859
1/9/2018,15,10809,2484,4628,280,69,35,18305
1/9/2018,16,10813,2771,4676,179,37,36,18512
1/9/2018,17,10813,3170,5144,117,10,35,19289
1/9/2018,18,10812,3784,5548,178,0,37,20359
1/9/2018,19,10819,3564,5559,282,0,39,20263
1/9/2018,20,10823,3221,5512,360,0,42,19958
1/9/2018,21,10818,2658,5516,484,0,34,19510
1/9/2018,22,10809,2346,5180,629,0,34,18998
1/9/2018,23,10807,1970,4572,748,0,34,18131
1/9/2018,24,10804,1151,3855,1065,0,26,16901
1/10/2018,1,10812,466,3382,1484,0,19,16163
1/10/2018,2,10816,305,3271,1773,0,18,16183
1/10/2018,3,10816,305,3258,1748,0,18,16145
1/10/2018,4,10818,333,3213,1896,0,18,16278
1/10/2018,5,10829,366,3131,1818,0,20,16164
1/10/2018,6,10820,575,3348,1756,0,21,16520
1/10/2018,7,10827,729,3900,1877,0,28,17361
1/10/2018,8,10830,892,4402,2706,0,33,18863
1/10/2018,9,10829,891,4491,2814,17,32,19074
1/10/2018,10,10826,888,4757,2762,80,33,19346
1/10/2018,11,10794,888,4753,2675,158,33,19301
1/10/2018,12,10827,733,4406,2323,192,33,18514
1/10/2018,13,10822,780,4448,2218,141,35,18444
1/10/2018,14,10663,636,4770,2673,86,31,18859
1/10/2018,15,10765,510,4621,3013,52,26,18987
1/10/2018,16,10820,596,4506,2826,19,26,18793
1/10/2018,17,10817,880,4760,2744,3,26,19230
1/10/2018,18,10817,892,5186,3511,0,27,20433
1/10/2018,19,10822,887,5094,3679,0,33,20515
1/10/2018,20,10817,726,4727,3585,0,33,19888
1/10/2018,21,10813,565,4577,3495,0,33,19483
1/10/2018,22,10803,508,4294,3353,0,34,18992
1/10/2018,23,10802,347,3746,3254,0,34,18183
1/10/2018,24,10804,267,3271,3111,0,23,17476
1/11/2018,1,10811,268,3181,3048,0,19,17327
1/11/2018,2,10805,268,3128,2620,0,19,16840
1/11/2018,3,10803,268,3278,2230,0,19,16598
1/11/2018,4,10814,267,3257,1872,0,19,16229
1/11/2018,5,10811,267,3202,2215,0,20,16515
1/11/2018,6,10810,275,3449,2391,0,23,16948
1/11/2018,7,10813,275,3782,2982,0,29,17881
1/11/2018,8,10815,270,3944,3562,0,35,18626
1/11/2018,9,10747,277,4293,3375,5,34,18731
1/11/2018,10,10739,303,4401,3092,18,34,18587
1/11/2018,11,10740,361,4404,2854,43,33,18435
1/11/2018,12,10729,360,4416,3001,66,34,18606
1/11/2018,13,10730,275,4411,3115,108,34,18673
1/11/2018,14,10733,270,4598,3218,87,30,18936
1/11/2018,15,10815,275,4477,3346,37,25,18975
1/11/2018,16,10823,297,4490,3514,16,26,19166
1/11/2018,17,10823,294,4823,3573,1,21,19535
1/11/2018,18,10814,267,4938,3603,0,26,19648
1/11/2018,19,10804,264,4776,3503,0,27,19374
1/11/2018,20,10807,270,4838,3696,0,27,19638
1/11/2018,21,10803,279,4779,3769,0,22,19652
1/11/2018,22,10789,266,4102,3761,0,26,18944
1/11/2018,23,10773,268,3588,3569,0,24,18222
1/11/2018,24,10775,269,3440,2343,0,17,16844
1/12/2018,1,10771,268,2900,2599,0,11,16549
1/12/2018,2,10777,271,2973,1942,0,8,15971
1/12/2018,3,10788,269,3020,1627,0,7,15711
1/12/2018,4,10803,269,2981,1635,0,8,15696
1/12/2018,5,10801,265,2947,1800,0,9,15822
1/12/2018,6,10800,265,3216,1870,0,12,16163
1/12/2018,7,10802,269,3865,1789,0,16,16741
1/12/2018,8,10802,268,4063,2506,0,24,17663
1/12/2018,9,10802,278,4427,2602,0,27,18136
1/12/2018,10,10794,386,4692,2519,7,26,18424
1/12/2018,11,10795,369,4312,2474,12,27,17989
1/12/2018,12,10792,493,4697,2487,16,27,18512
1/12/2018,13,10779,675,4715,2607,19,27,18822
1/12/2018,14,10778,763,4505,2232,14,27,18319
1/12/2018,15,10775,777,4694,2328,14,27,18615
1/12/2018,16,10776,917,4596,2455,6,27,18777
1/12/2018,17,10781,1087,4745,2050,0,27,18690
1/12/2018,18,10778,1304,5030,2515,0,27,19654
1/12/2018,19,10780,1335,4776,2585,0,27,19503
1/12/2018,20,10779,1332,4675,2656,0,27,19469
1/12/2018,21,10759,1338,4610,2789,0,27,19523
1/12/2018,22,10762,848,4490,2785,0,27,18912
1/12/2018,23,10777,707,3726,2569,0,27,17806
1/12/2018,24,10774,449,3530,2307,0,19,17079
1/13/2018,1,10771,313,3359,2621,0,10,17074
1/13/2018,2,10719,310,3446,2822,0,1,17298
1/13/2018,3,10655,310,3844,2783,0,0,17592
1/13/2018,4,10662,344,3549,2587,0,0,17142
1/13/2018,5,10667,364,3485,2319,0,0,16835
1/13/2018,6,10664,399,3754,2456,0,0,17273
1/13/2018,7,10666,539,3963,2155,0,0,17323
1/13/2018,8,10670,624,4257,2152,0,0,17703
1/13/2018,9,10666,822,4768,1967,4,0,18227
1/13/2018,10,10662,1061,4755,1927,32,0,18437
1/13/2018,11,10658,1244,4449,1783,68,0,18202
1/13/2018,12,10657,1401,4408,1419,90,0,17975
1/13/2018,13,10655,1602,4620,1560,104,0,18541
1/13/2018,14,10653,1899,4503,1475,100,0,18630
1/13/2018,15,10647,2242,4538,1107,65,0,18599
1/13/2018,16,10642,2501,4700,1125,41,0,19009
1/13/2018,17,10647,2729,5282,992,9,0,19659
1/13/2018,18,10647,3787,5520,1045,0,0,20999
1/13/2018,19,10655,3565,5436,1047,0,0,20703
1/13/2018,20,10655,3381,5522,956,0,0,20514
1/13/2018,21,10645,3762,5110,734,0,0,20251
1/13/2018,22,10644,3831,4796,594,0,0,19865
1/13/2018,23,10644,3323,4674,392,0,0,19033
1/13/2018,24,10650,2712,4223,313,0,0,17898
1/14/2018,1,10645,3188,3882,282,0,0,17997
1/14/2018,2,10650,2978,3646,312,0,0,17586
1/14/2018,3,10639,2439,3695,344,0,0,17117
1/14/2018,4,10616,1980,3768,376,0,0,16740
1/14/2018,5,10627,2213,3748,361,0,0,16949
1/14/2018,6,10630,2362,3906,370,0,0,17268
1/14/2018,7,10627,2617,4112,368,0,0,17724
1/14/2018,8,10625,3436,4710,394,0,0,19165
1/14/2018,9,10612,3840,4942,427,17,7,19845
1/14/2018,10,10616,3536,4661,360,46,12,19231
1/14/2018,11,10619,3464,4599,330,89,3,19104
1/14/2018,12,10625,3617,4542,331,121,5,19241
1/14/2018,13,10628,3696,4585,369,157,0,19435
1/14/2018,14,10633,3244,4564,418,137,0,18996
1/14/2018,15,10607,3232,4489,436,73,0,18837
1/14/2018,16,10646,3747,4902,481,32,2,19810
1/14/2018,17,10640,4194,5078,550,15,3,20480
1/14/2018,18,10637,4804,5295,672,0,15,21423
1/14/2018,19,10640,4669,5288,971,0,12,21580
1/14/2018,20,10637,4507,5172,1154,0,3,21473
1/14/2018,21,10631,5062,4673,1321,0,0,21687
1/14/2018,22,10629,4877,4202,1493,0,0,21201
1/14/2018,23,10642,3685,3685,1831,0,1,19844
1/14/2018,24,10649,2480,3335,1683,0,1,18148
1/15/2018,1,10646,2405,3601,1566,0,0,18218
1/15/2018,2,10645,2798,3661,1462,0,8,18574
1/15/2018,3,10657,2301,3620,1550,0,18,18146
1/15/2018,4,10655,2172,3806,1647,0,18,18298
1/15/2018,5,10660,2021,3804,1780,0,18,18283
1/15/2018,6,10652,2284,4253,1940,0,20,19149
1/15/2018,7,10652,3422,4771,1985,0,26,20856
1/15/2018,8,10659,4118,4914,1956,0,32,21679
1/15/2018,9,10651,4716,4996,1846,16,33,22258
1/15/2018,10,10670,4788,4868,1983,41,32,22382
1/15/2018,11,10669,4636,4962,1975,65,25,22332
1/15/2018,12,10671,4630,5003,1733,86,30,22153
1/15/2018,13,10672,4068,5077,1654,83,24,21578
1/15/2018,14,10674,3981,4974,1692,52,26,21399
1/15/2018,15,10669,4363,4969,1620,44,35,21700
1/15/2018,16,10676,4226,5026,1489,25,46,21488
1/15/2018,17,10671,4195,5178,1336,5,47,21432
1/15/2018,18,10672,4441,5114,1057,0,89,21373
1/15/2018,19,10670,4748,5203,1000,0,97,21718
1/15/2018,20,10667,4355,5400,1051,0,150,21623
1/15/2018,21,10659,5065,5309,915,0,199,22147
1/15/2018,22,10654,4919,4961,789,0,177,21500
1/15/2018,23,10652,4334,4733,665,0,90,20474
1/15/2018,24,10667,3238,4301,620,0,33,18859
1/16/2018,1,10669,3250,3671,617,0,13,18220
1/16/2018,2,10676,2768,3627,579,0,12,17662
1/16/2018,3,10680,2512,3698,566,0,12,17468
1/16/2018,4,10671,2458,3552,672,0,12,17365
1/16/2018,5,10652,2577,3814,706,0,12,17761
1/16/2018,6,10670,2865,3961,598,0,14,18108
1/16/2018,7,10662,4322,4342,608,0,43,19977
1/16/2018,8,10663,4759,4612,791,0,81,20906
1/16/2018,9,10658,4469,4886,834,2,107,20956
1/16/2018,10,10660,4703,4867,744,12,116,21102
1/16/2018,11,10668,4735,4837,703,30,115,21088
1/16/2018,12,10681,4263,4856,636,42,114,20592
1/16/2018,13,10688,3583,4821,640,46,114,19892
1/16/2018,14,10688,3510,4677,614,43,115,19647
1/16/2018,15,10692,3281,4618,503,39,106,19239
1/16/2018,16,10691,3310,4824,490,26,113,19454
1/16/2018,17,10701,3949,5131,568,6,184,20539
1/16/2018,18,10715,4211,5607,692,0,196,21421
1/16/2018,19,10715,4256,5624,881,0,193,21669
1/16/2018,20,10712,4238,5697,988,0,196,21831
1/16/2018,21,10702,4768,5151,1008,0,203,21832
1/16/2018,22,10704,3698,4911,1058,0,167,20538
1/16/2018,23,10706,3135,4351,1138,0,83,19413
1/16/2018,24,10706,1883,4423,1206,0,70,18288
1/17/2018,1,10702,791,4360,1226,0,64,17143
1/17/2018,2,10717,480,4313,1209,0,62,16781
1/17/2018,3,10720,409,4306,1265,0,20,16720
1/17/2018,4,10717,461,4268,1289,0,9,16744
1/17/2018,5,10716,850,4419,1315,0,10,17310
1/17/2018,6,10715,1588,4075,1369,0,13,17760
1/17/2018,7,10711,2206,4591,1420,0,28,18956
1/17/2018,8,10710,3139,5284,1451,0,69,20653
1/17/2018,9,10711,2964,5428,1632,3,108,20846
1/17/2018,10,10707,2755,5260,1524,26,76,20348
1/17/2018,11,10717,2454,4947,1634,63,81,19896
1/17/2018,12,10712,2394,4782,1888,71,86,19933
1/17/2018,13,10717,1878,4298,2171,114,86,19264
1/17/2018,14,10719,1719,4517,2397,132,86,19570
1/17/2018,15,10708,1784,4556,2694,110,86,19938
1/17/2018,16,10697,1653,4503,2889,67,86,19895
1/17/2018,17,10685,1659,4784,2898,19,86,20131
1/17/2018,18,10682,1810,5192,3757,0,86,21527
1/17/2018,19,10707,1828,5261,3865,0,85,21746
1/17/2018,20,10703,1819,5198,3949,0,83,21752
1/17/2018,21,10692,1333,5023,3969,0,83,21100
1/17/2018,22,10686,917,5005,3963,0,85,20656
1/17/2018,23,10683,501,4436,3933,0,37,19590
1/17/2018,24,10683,412,3755,3633,0,16,18499
1/18/2018,1,10682,411,3635,3527,0,16,18271
1/18/2018,2,10688,415,3670,3394,0,16,18183
1/18/2018,3,10707,424,3615,3051,0,16,17813
1/18/2018,4,10704,445,3630,3148,0,13,17940
1/18/2018,5,10698,532,3653,2827,0,15,17725
1/18/2018,6,10699,765,3776,3012,0,15,18267
1/18/2018,7,10704,1314,4226,2965,0,23,19232
1/18/2018,8,10703,1659,4695,3207,0,38,20302
1/18/2018,9,10702,1767,4662,3077,5,41,20254
1/18/2018,10,10701,1876,4561,2893,29,41,20101
1/18/2018,11,10685,1862,4757,2451,60,43,19858
1/18/2018,12,10718,1829,4706,2453,74,46,19826
1/18/2018,13,10704,1734,4546,2630,76,51,19741
1/18/2018,14,10703,1694,4656,2434,72,42,19601
1/18/2018,15,10656,1596,4672,2762,56,41,19783
1/18/2018,16,10695,1299,4898,2487,27,68,19474
1/18/2018,17,10701,1134,5036,3103,12,96,20082
1/18/2018,18,10705,1225,5550,3252,1,150,20883
1/18/2018,19,10733,1169,5511,3286,0,129,20828
1/18/2018,20,10739,1053,5295,3398,0,79,20564
1/18/2018,21,10742,1040,4790,3429,0,79,20080
1/18/2018,22,10739,673,4541,3381,0,86,19420
1/18/2018,23,10731,337,3957,3063,0,77,18165
1/18/2018,24,10725,291,3956,2737,0,15,17724
1/19/2018,1,10725,291,3687,2962,0,12,17677
1/19/2018,2,10725,290,3497,2795,0,14,17321
1/19/2018,3,10725,295,3494,2766,0,13,17293
1/19/2018,4,10726,303,3538,2728,0,11,17306
1/19/2018,5,10737,393,3523,2378,0,12,17043
1/19/2018,6,10741,745,3559,2393,0,11,17449
1/19/2018,7,10751,773,4090,2182,0,16,17812
1/19/2018,8,10748,935,4416,2791,0,27,18917
1/19/2018,9,10750,1181,4767,2718,18,28,19462
1/19/2018,10,10747,1291,4813,3068,74,26,20019
1/19/2018,11,10748,1235,4769,2588,129,27,19496
1/19/2018,12,10748,1155,4746,2226,151,27,19053
1/19/2018,13,10747,1136,4763,2282,151,28,19107
1/19/2018,14,10747,1127,4775,2165,153,27,18994
1/19/2018,15,10747,1113,4782,2204,135,27,19008
1/19/2018,16,10746,995,4792,2920,79,27,19559
1/19/2018,17,10762,1160,4840,2858,21,27,19668
1/19/2018,18,10781,982,5038,3385,0,27,20213
1/19/2018,19,10781,898,4967,3555,0,27,20228
1/19/2018,20,10780,895,4740,3437,0,26,19878
1/19/2018,21,10780,725,4602,3728,0,27,19862
1/19/2018,22,10775,549,4391,3797,0,27,19539
1/19/2018,23,10776,341,3950,3580,0,27,18674
1/19/2018,24,10775,319,3583,3326,0,9,18012
1/20/2018,1,9973,317,3330,3503,0,0,17123
1/20/2018,2,9829,316,3310,3196,0,0,16651
1/20/2018,3,9823,315,3378,2746,0,0,16262
1/20/2018,4,9825,320,3468,2543,0,0,16156
1/20/2018,5,9834,320,3396,2595,0,1,16146
1/20/2018,6,9837,320,3442,2717,0,1,16317
1/20/2018,7,9840,321,3712,2740,0,0,16613
1/20/2018,8,9837,321,3803,2975,0,0,16936
1/20/2018,9,9823,402,3942,3197,28,0,17392
1/20/2018,10,9818,389,4098,2907,73,0,17285
1/20/2018,11,9820,512,4234,2675,151,1,17393
1/20/2018,12,9814,759,4463,2121,182,6,17345
1/20/2018,13,9817,991,4393,978,230,5,16414
1/20/2018,14,9841,1251,4406,738,245,11,16492
1/20/2018,15,9838,1409,4570,590,93,13,16513
1/20/2018,16,9812,1460,4563,769,101,11,16716
1/20/2018,17,9846,1519,4842,897,21,1,17126
1/20/2018,18,9854,1520,5129,1592,1,0,18096
1/20/2018,19,9857,1381,5036,1816,0,0,18090
1/20/2018,20,9865,1165,4883,1739,0,0,17652
1/20/2018,21,9862,820,4832,1530,0,0,17044
1/20/2018,22,9858,524,4566,1503,0,0,16451
1/20/2018,23,9855,364,4252,1455,0,0,15926
1/20/2018,24,9861,278,3853,1234,0,0,15226
1/21/2018,1,9861,278,3744,1026,0,0,14909
1/21/2018,2,9857,278,3805,899,0,0,14839
1/21/2018,3,9858,278,3968,713,0,0,14817
1/21/2018,4,9829,277,3899,521,0,0,14526
1/21/2018,5,9857,278,3778,411,0,0,14324
1/21/2018,6,9871,279,3968,311,0,0,14429
1/21/2018,7,9886,354,4193,347,0,0,14780
1/21/2018,8,9881,375,4293,390,0,0,14939
1/21/2018,9,9882,605,4705,337,12,0,15541
1/21/2018,10,9859,940,4656,390,61,0,15906
1/21/2018,11,9857,1063,4507,449,87,0,15963
1/21/2018,12,9865,1040,4780,366,104,0,16155
1/21/2018,13,9866,1057,5013,406,116,0,16458
1/21/2018,14,9865,1412,5265,171,82,0,16795
1/21/2018,15,9863,1556,5273,63,63,0,16818
1/21/2018,16,9867,1623,5132,37,21,0,16680
1/21/2018,17,9872,1679,5072,56,2,0,16681
1/21/2018,18,9864,2092,5501,91,0,0,17548
1/21/2018,19,9869,2242,5507,124,0,0,17742
1/21/2018,20,9872,1835,5352,95,0,0,17154
1/21/2018,21,9867,1494,5323,75,0,0,16759
1/21/2018,22,9869,1314,4867,105,0,0,16155
1/21/2018,23,9857,710,4609,115,0,0,15291
1/21/2018,24,9856,515,4485,96,0,0,14952
1/22/2018,1,9875,404,4331,134,0,0,14744
1/22/2018,2,9877,429,4013,257,0,5,14581
1/22/2018,3,9891,365,3865,333,0,7,14461
1/22/2018,4,9876,413,3684,502,0,7,14482
1/22/2018,5,9889,638,3459,457,0,11,14454
1/22/2018,6,9911,882,3786,354,0,14,14947
1/22/2018,7,9912,1047,4076,700,0,19,15754
1/22/2018,8,9920,1171,4552,1436,0,27,17106
1/22/2018,9,9919,1171,4507,2077,3,27,17704
1/22/2018,10,9913,1143,4960,2249,14,27,18306
1/22/2018,11,9904,1149,5034,2421,23,27,18558
1/22/2018,12,9901,1149,4841,2584,39,26,18540
1/22/2018,13,9905,1147,4908,2586,52,27,18625
1/22/2018,14,9895,979,5012,2663,41,27,18617
1/22/2018,15,9905,513,4815,2689,26,27,17975
1/22/2018,16,9909,411,4981,2824,18,27,18170
1/22/2018,17,9914,615,4917,2795,6,27,18274
1/22/2018,18,9912,764,5219,2771,0,27,18693
1/22/2018,19,9918,776,5203,2726,0,27,18650
1/22/2018,20,9923,775,5245,2696,0,26,18665
1/22/2018,21,9916,780,5254,2693,0,26,18669
1/22/2018,22,9907,777,4930,2561,0,26,18201
1/22/2018,23,9914,532,4628,2352,0,26,17452
1/22/2018,24,9914,316,4386,2309,0,17,16942
1/23/2018,1,9916,293,4328,2056,0,11,16604
1/23/2018,2,9920,295,3655,2241,0,10,16121
1/23/2018,3,9932,294,3160,2536,0,9,15931
1/23/2018,4,9940,293,3168,2079,0,9,15489
1/23/2018,5,9936,294,3228,2132,0,10,15600
1/23/2018,6,9932,306,3742,2057,0,15,16052
1/23/2018,7,9931,317,4174,2245,0,22,16689
1/23/2018,8,9937,320,4679,3074,0,28,18038
1/23/2018,9,9941,396,4757,3266,16,27,18403
1/23/2018,10,9938,425,4631,3330,43,27,18394
1/23/2018,11,9937,465,4700,3316,63,27,18508
1/23/2018,12,9938,561,4554,3393,62,27,18535
1/23/2018,13,9942,798,4583,3248,59,26,18656
1/23/2018,14,9943,1018,4465,3029,41,27,18523
1/23/2018,15,9941,1156,4530,2850,44,26,18547
1/23/2018,16,9944,1164,4703,3239,21,26,19097
1/23/2018,17,9944,1226,4695,3333,5,27,19230
1/23/2018,18,9955,1476,5046,3575,0,27,20079
1/23/2018,19,9954,1495,5332,3308,0,27,20116
1/23/2018,20,9952,1347,5279,3162,0,27,19767
1/23/2018,21,9939,981,5106,3125,0,27,19178
1/23/2018,22,9939,843,4927,2988,0,27,18724
1/23/2018,23,9931,455,4327,2575,0,26,17314
1/23/2018,24,9933,319,4064,2582,0,21,16919
1/24/2018,1,9932,295,3850,2486,0,11,16574
1/24/2018,2,9937,321,3805,2392,0,10,16465
1/24/2018,3,9934,366,3949,2285,0,10,16544
1/24/2018,4,9931,508,3781,1851,0,10,16081
1/24/2018,5,9935,673,3957,1490,0,11,16066
1/24/2018,6,9933,944,4261,1134,0,16,16288
1/24/2018,7,9932,1529,4822,1017,0,29,17329
1/24/2018,8,9929,2394,5116,960,0,58,18457
1/24/2018,9,9929,2316,4815,831,18,103,18012
1/24/2018,10,9930,2078,4796,633,69,158,17664
1/24/2018,11,9932,1829,4862,440,104,106,17273
1/24/2018,12,9933,2008,4720,325,157,85,17228
1/24/2018,13,9924,2300,4485,278,200,87,17274
1/24/2018,14,9932,2357,4519,307,181,81,17377
1/24/2018,15,9929,2735,4415,349,138,80,17646
1/24/2018,16,9933,2896,4287,248,75,86,17525
1/24/2018,17,9934,3135,4674,345,28,97,18213
1/24/2018,18,9933,3836,5493,297,0,164,19723
1/24/2018,19,9935,3776,5634,282,0,187,19814
1/24/2018,20,9935,3416,5707,303,0,192,19553
1/24/2018,21,9931,3419,5592,329,0,203,19474
1/24/2018,22,9925,2734,5349,310,0,161,18479
1/24/2018,23,9921,1780,5032,362,0,80,17175
1/24/2018,24,9925,1067,5107,313,0,33,16445
1/25/2018,1,9923,1081,4850,213,0,16,16083
1/25/2018,2,9922,880,4629,184,0,17,15632
1/25/2018,3,9917,859,4660,136,0,16,15588
1/25/2018,4,9922,919,4606,165,0,15,15627
1/25/2018,5,9929,1108,4576,178,0,15,15806
1/25/2018,6,9927,1605,4420,184,0,21,16157
1/25/2018,7,9939,1913,4588,205,0,50,16695
1/25/2018,8,9938,2584,5428,258,2,85,18295
1/25/2018,9,9939,2696,5364,308,53,136,18496
1/25/2018,10,9940,2363,5464,323,96,154,18340
1/25/2018,11,9947,2620,5054,410,154,114,18299
1/25/2018,12,9979,2440,4907,543,187,93,18149
1/25/2018,13,9937,2318,5313,680,193,99,18540
1/25/2018,14,9934,2414,5401,736,185,92,18762
1/25/2018,15,9932,2545,5212,759,100,71,18619
1/25/2018,16,9935,2543,4939,739,47,26,18229
1/25/2018,17,9931,2987,5507,545,14,26,19010
1/25/2018,18,9933,3750,5592,363,1,30,19669
1/25/2018,19,9939,3861,5581,406,0,27,19814
1/25/2018,20,9937,3001,5499,551,0,29,19017
1/25/2018,21,9933,2600,5520,736,0,28,18817
1/25/2018,22,9929,1866,5220,925,0,27,17967
1/25/2018,23,9928,591,5056,1091,0,27,16693
1/25/2018,24,9934,313,4797,1289,0,17,16350
1/26/2018,1,9940,301,4376,1515,0,13,16145
1/26/2018,2,9945,301,4097,1796,0,13,16152
1/26/2018,3,9942,303,4006,1918,0,13,16182
1/26/2018,4,9944,373,4082,2137,0,13,16549
1/26/2018,5,9949,598,3972,2174,0,13,16706
1/26/2018,6,9942,813,4103,1716,0,14,16588
1/26/2018,7,9948,950,4762,2418,0,22,18100
1/26/2018,8,9943,1158,5277,2636,1,27,19042
1/26/2018,9,9945,1006,5206,2673,45,27,18902
1/26/2018,10,9947,969,4969,2466,144,27,18522
1/26/2018,11,10000,1127,4814,2265,216,27,18449
1/26/2018,12,10165,1140,4688,2207,270,27,18497
1/26/2018,13,10287,975,4565,1722,291,26,17866
1/26/2018,14,10431,929,4615,1274,272,27,17548
1/26/2018,15,10605,471,4600,1833,227,27,17763
1/26/2018,16,10660,325,4462,2028,150,27,17652
1/26/2018,17,10667,327,4481,2915,49,27,18466
1/26/2018,18,10664,327,4799,3461,2,27,19280
1/26/2018,19,10671,326,4966,3729,0,26,19718
1/26/2018,20,10679,323,5041,3751,0,18,19812
1/26/2018,21,10675,325,4605,3682,0,21,19308
1/26/2018,22,10613,325,4485,3257,0,25,18705
1/26/2018,23,10629,326,4024,3159,0,23,18161
1/26/2018,24,10742,326,3941,2317,0,22,17348
1/27/2018,1,10765,326,3641,1965,0,0,16697
1/27/2018,2,10764,324,3652,1414,0,0,16154
1/27/2018,3,10765,322,3477,1252,0,0,15816
1/27/2018,4,10762,312,3448,965,0,0,15487
1/27/2018,5,10763,315,3462,924,0,0,15464
1/27/2018,6,10759,319,3482,1182,0,0,15742
1/27/2018,7,10760,318,3651,1578,0,0,16307
1/27/2018,8,10764,297,3730,2181,0,0,16972
1/27/2018,9,10768,266,3858,2923,7,0,17822
1/27/2018,10,10762,267,3915,3184,23,0,18151
1/27/2018,11,10753,266,3836,3462,39,0,18356
1/27/2018,12,10755,265,3739,3518,48,0,18325
1/27/2018,13,10754,265,3865,3485,43,0,18412
1/27/2018,14,10591,268,3911,3536,38,0,18344
1/27/2018,15,10648,266,4220,2879,29,0,18042
1/27/2018,16,10779,267,4176,2894,26,0,18142
1/27/2018,17,10782,267,4507,2439,9,0,18004
1/27/2018,18,10785,268,4503,2401,1,0,17958
1/27/2018,19,10788,265,4591,2306,0,3,17953
1/27/2018,20,10789,295,4544,2202,0,4,17834
1/27/2018,21,10780,295,4330,2542,0,0,17947
1/27/2018,22,10776,297,4167,2375,0,0,17615
1/27/2018,23,10788,293,4060,2170,0,0,17311
1/27/2018,24,10779,293,3999,1631,0,0,16702
1/28/2018,1,10781,295,3362,1403,0,0,15841
1/28/2018,2,10781,295,3285,1269,0,0,15630
1/28/2018,3,10783,296,3326,1013,0,0,15418
1/28/2018,4,10789,298,3405,756,0,0,15248
1/28/2018,5,10787,297,3364,787,0,0,15235
1/28/2018,6,10781,298,3372,1055,0,0,15506
1/28/2018,7,10781,298,3537,998,0,0,15614
1/28/2018,8,10777,297,3959,952,0,0,15985
1/28/2018,9,10776,298,3946,673,52,0,15745
1/28/2018,10,10763,298,3953,250,128,0,15392
1/28/2018,11,10757,305,3957,186,171,0,15376
1/28/2018,12,10762,329,4114,368,188,0,15761
1/28/2018,13,10765,393,4429,296,188,0,16071
1/28/2018,14,10759,416,4366,386,194,0,16121
1/28/2018,15,10758,538,4429,260,156,0,16141
1/28/2018,16,10760,794,4702,162,24,0,16442
1/28/2018,17,10770,880,5200,425,30,0,17305
1/28/2018,18,10773,879,5743,688,2,0,18085
1/28/2018,19,10775,916,5753,972,0,0,18416
1/28/2018,20,10778,858,5607,943,0,0,18186
1/28/2018,21,10770,861,5206,916,0,0,17753
1/28/2018,22,10771,743,4693,990,0,0,17197
1/28/2018,23,10768,712,4342,643,0,0,16465
1/28/2018,24,10762,711,4191,481,0,0,16145
1/29/2018,1,10770,406,4021,635,0,5,15837
1/29/2018,2,10759,308,4025,575,0,15,15682
1/29/2018,3,10772,372,3970,669,0,18,15801
1/29/2018,4,10760,383,3694,744,0,24,15605
1/29/2018,5,10762,460,3658,165,0,25,15070
1/29/2018,6,10760,693,4076,320,0,25,15874
1/29/2018,7,10763,920,4794,544,0,36,17057
1/29/2018,8,10765,1316,5334,671,1,39,18126
1/29/2018,9,10770,1063,5126,753,15,37,17764
1/29/2018,10,10769,1099,4895,957,43,36,17799
1/29/2018,11,10773,1182,4772,1198,72,36,18033
1/29/2018,12,10771,1200,4721,1404,90,36,18222
1/29/2018,13,10775,932,4953,1664,86,35,18445
1/29/2018,14,10767,906,5306,2022,116,35,19152
1/29/2018,15,10773,958,4728,2229,115,31,18834
1/29/2018,16,10777,981,4837,2600,69,27,19291
1/29/2018,17,10781,1110,4920,2631,20,27,19489
1/29/2018,18,10782,1116,5213,2890,0,27,20028
1/29/2018,19,10786,1120,5339,2915,0,27,20187
1/29/2018,20,10788,1120,5163,2895,0,27,19993
1/29/2018,21,10783,1120,4842,2896,0,27,19668
1/29/2018,22,10779,960,4784,2863,0,27,19413
1/29/2018,23,10775,410,4643,2847,0,27,18702
1/29/2018,24,10780,308,4277,2337,0,17,17719
1/30/2018,1,10778,310,3741,2460,0,11,17300
1/30/2018,2,10776,312,3763,2271,0,10,17132
1/30/2018,3,10781,339,3793,2044,0,10,16967
1/30/2018,4,10778,427,3848,1983,0,10,17046
1/30/2018,5,10780,771,3859,1668,0,10,17088
1/30/2018,6,10777,1290,4061,1585,0,13,17726
1/30/2018,7,10770,1593,4386,2205,0,22,18976
1/30/2018,8,10780,1783,4903,2576,0,27,20069
1/30/2018,9,10775,1791,5194,2197,5,27,19989
1/30/2018,10,10753,2110,5178,1998,18,27,20084
1/30/2018,11,10762,1795,4932,1907,35,27,19458
1/30/2018,12,10771,1838,4815,1584,68,27,19103
1/30/2018,13,10768,2020,5142,1427,94,27,19478
1/30/2018,14,10766,2135,4971,1470,112,28,19482
1/30/2018,15,10774,2272,4945,1270,108,44,19413
1/30/2018,16,10732,2346,4886,959,79,80,19082
1/30/2018,17,10724,2663,5426,763,26,145,19747
1/30/2018,18,10728,3670,5526,652,2,201,20779
1/30/2018,19,10728,4061,5485,577,0,204,21055
1/30/2018,20,10725,3990,5361,552,0,200,20828
1/30/2018,21,10725,3489,5290,543,0,198,20245
1/30/2018,22,10724,2862,5153,606,0,198,19543
1/30/2018,23,10730,1605,5012,951,0,196,18494
1/30/2018,24,10728,1028,4382,1388,0,113,17639
1/31/2018,1,10725,634,3956,1822,0,71,17208
1/31/2018,2,10732,363,3857,2048,0,23,17023
1/31/2018,3,10733,334,3535,2218,0,10,16830
1/31/2018,4,10747,346,3459,2231,0,10,16793
1/31/2018,5,10750,416,3318,2371,0,10,16865
1/31/2018,6,10753,593,3629,2742,0,12,17729
1/31/2018,7,10760,955,4103,3393,0,23,19234
1/31/2018,8,10757,1270,4684,3557,0,27,20295
1/31/2018,9,10754,1379,4827,3579,9,27,20575
1/31/2018,10,10761,1377,5033,3545,20,27,20763
1/31/2018,11,10753,1366,5007,3475,38,27,20666
1/31/2018,12,10761,1393,5087,3462,46,27,20776
1/31/2018,13,10750,1205,4537,3363,65,27,19947
1/31/2018,14,10754,1047,4685,3367,81,28,19962
1/31/2018,15,10748,1125,4415,2798,78,27,19191
1/31/2018,16,10590,1428,4579,2806,71,27,19501
1/31/2018,17,10557,1710,4791,3282,20,27,20387
1/31/2018,18,10553,1784,5164,3423,1,27,20952
1/31/2018,19,10563,1932,5324,3387,0,27,21233
1/31/2018,20,9966,2331,5463,3388,0,27,21175
1/31/2018,21,9963,2326,5178,3281,0,27,20775
1/31/2018,22,9959,1367,4536,3314,0,27,19203
1/31/2018,23,9954,756,4146,3170,0,27,18053
1/31/2018,24,9957,511,4034,2643,0,20,17165
2/1/2018,1,9961,319,4203,2384,0,12,16879
2/1/2018,2,9967,291,3816,2251,0,12,16337
2/1/2018,3,9964,300,3631,2186,0,12,16093
2/1/2018,4,9959,391,3516,2328,0,12,16206
2/1/2018,5,9963,591,3603,2429,0,12,16598
2/1/2018,6,9959,886,3670,1966,0,16,16497
2/1/2018,7,9964,1128,4139,2122,0,25,17378
2/1/2018,8,9963,1108,4411,3084,1,28,18595
2/1/2018,9,9960,1140,4476,2652,19,27,18274
2/1/2018,10,9957,1147,4480,2880,66,30,18560
2/1/2018,11,9956,1171,4620,2751,144,51,18693
2/1/2018,12,9955,1194,4621,2667,148,34,18619
2/1/2018,13,9949,1278,4611,2771,153,27,18789
2/1/2018,14,9940,1434,4599,2773,125,28,18899
2/1/2018,15,9937,1373,4712,2621,134,28,18805
2/1/2018,16,9935,1656,4687,2687,66,28,19059
2/1/2018,17,9931,1945,4707,2851,24,27,19485
2/1/2018,18,9914,1925,5202,2920,2,27,19990
2/1/2018,19,9913,1872,5304,2990,0,27,20106
2/1/2018,20,9914,1882,4812,2868,0,27,19503
2/1/2018,21,9910,1715,5239,3109,0,27,20000
2/1/2018,22,9908,1177,4845,3197,0,27,19154
2/1/2018,23,9909,555,4687,3177,0,27,18355
2/1/2018,24,9919,318,3975,3129,0,20,17361
2/2/2018,1,9928,303,3802,2868,0,13,16914
2/2/2018,2,9922,312,3801,2827,0,12,16874
2/2/2018,3,9914,334,3776,2709,0,18,16751
2/2/2018,4,9900,493,3714,2656,0,35,16798
2/2/2018,5,9900,891,3676,2634,0,40,17141
2/2/2018,6,9898,1358,3898,2604,0,51,17809
2/2/2018,7,9904,1598,4376,2419,0,91,18388
2/2/2018,8,9904,1798,5242,2283,2,172,19401
2/2/2018,9,9899,1792,5261,2112,60,198,19322
2/2/2018,10,9891,1722,5093,2028,169,121,19024
2/2/2018,11,9892,1427,4999,1990,243,90,18641
2/2/2018,12,9893,1036,5349,1877,247,89,18491
2/2/2018,13,9889,1001,5341,1645,242,89,18207
2/2/2018,14,9889,1173,5037,1515,240,91,17945
2/2/2018,15,9888,1452,5087,1381,243,88,18139
2/2/2018,16,9888,1630,5214,1259,168,99,18258
2/2/2018,17,9882,2192,5428,1179,49,149,18879
2/2/2018,18,9885,2818,5463,1366,1,216,19749
2/2/2018,19,9881,2724,5255,1553,0,194,19607
2/2/2018,20,9877,2419,5355,1836,0,141,19628
2/2/2018,21,9874,2074,5090,2204,0,133,19375
2/2/2018,22,9869,1529,5067,2350,0,90,18905
2/2/2018,23,9856,1429,4507,2268,0,76,18136
2/2/2018,24,9866,967,4556,2289,0,102,17780
2/3/2018,1,9865,447,3934,2659,0,64,16969
2/3/2018,2,9860,312,4248,2467,0,51,16938
2/3/2018,3,9859,563,4737,2139,0,85,17383
2/3/2018,4,9837,769,4448,2161,0,100,17315
2/3/2018,5,9833,669,4142,1810,0,141,16595
2/3/2018,6,9831,579,4207,1869,0,174,16660
2/3/2018,7,9839,720,4522,1762,0,163,17006
2/3/2018,8,9838,798,4546,1966,0,136,17284
2/3/2018,9,9835,965,4851,2058,16,149,17874
2/3/2018,10,9828,1139,5089,2339,50,169,18614
2/3/2018,11,9830,904,4462,2099,58,169,17522
2/3/2018,12,9834,895,4430,2441,84,175,17859
2/3/2018,13,9835,576,4426,2450,108,175,17570
2/3/2018,14,9830,666,4520,2563,106,175,17860
2/3/2018,15,9827,809,4924,2472,108,175,18315
2/3/2018,16,9826,1411,4933,2727,46,175,19118
2/3/2018,17,9807,1586,4330,2699,13,175,18610
2/3/2018,18,9788,1554,4519,2671,0,175,18707
2/3/2018,19,9778,1543,4437,3155,0,175,19088
2/3/2018,20,9775,1472,4201,3342,0,176,18966
2/3/2018,21,9771,1191,4176,2746,0,176,18060
2/3/2018,22,9757,1139,4113,2948,0,156,18113
2/3/2018,23,9763,910,3791,3329,0,71,17864
2/3/2018,24,9761,710,3684,3433,0,46,17634
2/4/2018,1,9745,733,3482,3219,0,0,17179
2/4/2018,2,9761,562,3258,3150,0,0,16731
2/4/2018,3,9766,506,3023,3310,0,0,16605
2/4/2018,4,9768,505,3143,2961,0,0,16377
2/4/2018,5,9812,505,3162,3039,0,0,16518
2/4/2018,6,9806,519,3281,2909,0,0,16515
2/4/2018,7,9810,582,3383,2477,0,0,16252
2/4/2018,8,9810,764,3638,2253,0,0,16465
2/4/2018,9,9805,894,4027,1843,5,0,16574
2/4/2018,10,9801,1096,4653,2045,17,0,17612
2/4/2018,11,9800,1157,4773,1646,35,0,17411
2/4/2018,12,9796,1327,5017,1372,48,0,17560
2/4/2018,13,9809,1703,4995,1203,54,0,17764
2/4/2018,14,9812,1456,4899,1429,53,0,17649
2/4/2018,15,9807,1437,4485,1904,49,0,17682
2/4/2018,16,9769,1272,4287,2545,37,0,17910
2/4/2018,17,9808,1335,4406,2543,14,0,18106
2/4/2018,18,9811,1187,4875,2843,1,0,18717
2/4/2018,19,9806,1179,5311,2638,0,0,18934
2/4/2018,20,9809,944,5153,2557,0,0,18463
2/4/2018,21,9809,596,4544,2679,0,0,17628
2/4/2018,22,9802,528,4293,3084,0,0,17707
2/4/2018,23,9802,400,3773,3198,0,0,17173
2/4/2018,24,9813,306,3567,2975,0,0,16661
2/5/2018,1,9806,305,3688,2733,0,4,16536
2/5/2018,2,9801,313,3571,2528,0,14,16227
2/5/2018,3,9801,395,3706,2354,0,11,16267
2/5/2018,4,9797,665,3706,2260,0,11,16439
2/5/2018,5,9801,1100,3591,1625,0,11,16128
2/5/2018,6,9806,1606,3853,1144,0,13,16422
2/5/2018,7,9805,1958,4494,1134,0,21,17412
2/5/2018,8,9800,2197,5070,1259,0,31,18357
2/5/2018,9,9807,2160,4980,1493,16,32,18488
2/5/2018,10,9812,2174,5181,1701,59,47,18974
2/5/2018,11,9817,2018,4794,1994,100,45,18768
2/5/2018,12,9821,1769,4676,2107,130,53,18556
2/5/2018,13,9839,1731,4597,2199,132,49,18547
2/5/2018,14,9849,1723,4575,2286,132,47,18612
2/5/2018,15,9852,1836,4563,2068,109,64,18492
2/5/2018,16,9849,1785,4623,2113,66,93,18529
2/5/2018,17,9835,1716,4702,2473,24,93,18843
2/5/2018,18,9828,1747,5314,2603,2,113,19607
2/5/2018,19,9832,2039,5644,2492,0,165,20172
2/5/2018,20,9835,2037,5648,2269,0,113,19902
2/5/2018,21,9833,1864,5232,2349,0,82,19360
2/5/2018,22,9820,1650,5185,2353,0,81,19089
2/5/2018,23,9824,1097,4927,1998,0,37,17883
2/5/2018,24,9823,1016,4939,1826,0,17,17621
2/6/2018,1,9829,783,4575,1558,0,11,16756
2/6/2018,2,9825,841,4429,1463,0,11,16569
2/6/2018,3,9823,834,4369,1326,0,12,16364
2/6/2018,4,9823,879,4321,1151,0,12,16186
2/6/2018,5,9828,1218,4480,1065,0,15,16606
2/6/2018,6,9827,1890,4092,952,0,15,16776
2/6/2018,7,9827,2255,4468,886,0,21,17457
2/6/2018,8,9829,2562,5083,961,0,27,18462
2/6/2018,9,9828,2972,5227,1000,13,27,19067
2/6/2018,10,9828,2751,5149,1005,54,26,18813
2/6/2018,11,9829,2305,4912,1009,98,27,18180
2/6/2018,12,9832,2280,4778,902,145,27,17964
2/6/2018,13,9833,2157,5060,800,149,28,18027
2/6/2018,14,9834,2265,5100,705,170,27,18101
2/6/2018,15,9830,2388,4992,626,167,28,18031
2/6/2018,16,9836,2665,4770,421,137,43,17872
2/6/2018,17,9834,3022,5312,211,53,72,18504
2/6/2018,18,9833,3251,5779,151,3,118,19135
2/6/2018,19,9833,3881,5836,193,0,185,19928
2/6/2018,20,9832,3460,5859,250,0,185,19586
2/6/2018,21,9828,3381,5713,313,0,189,19424
2/6/2018,22,9826,2889,5636,253,0,194,18798
2/6/2018,23,9826,2298,5139,288,0,168,17719
2/6/2018,24,9826,1976,4641,416,0,61,16920
2/7/2018,1,9829,1886,4004,490,0,14,16223
2/7/2018,2,9827,1654,4000,420,0,14,15915
2/7/2018,3,9824,1635,4157,446,0,14,16076
2/7/2018,4,9820,1779,4231,472,0,13,16315
2/7/2018,5,9818,2065,4238,534,0,14,16669
2/7/2018,6,9821,2346,3935,489,0,16,16607
2/7/2018,7,9825,2594,4889,393,0,22,17723
2/7/2018,8,9822,3437,5325,401,0,27,19012
2/7/2018,9,9823,3552,5338,367,1,27,19108
2/7/2018,10,9828,3619,5076,371,4,27,18925
2/7/2018,11,9791,3726,5163,412,15,27,19134
2/7/2018,12,9846,3457,5104,463,17,26,18913
2/7/2018,13,9873,2465,5065,618,33,29,18083
2/7/2018,14,9881,2409,4838,755,30,56,17969
2/7/2018,15,9879,2514,4817,1128,26,76,18440
2/7/2018,16,9874,2496,4912,1259,12,78,18631
2/7/2018,17,9867,2762,5265,1109,9,96,19108
2/7/2018,18,9867,3172,5266,1061,1,188,19555
2/7/2018,19,9865,3240,5482,1246,0,204,20037
2/7/2018,20,9870,2832,5616,1171,0,163,19652
2/7/2018,21,9858,2512,5536,1140,0,139,19185
2/7/2018,22,9857,2221,4987,1163,0,114,18342
2/7/2018,23,9867,1745,4278,1335,0,85,17310
2/7/2018,24,9866,1062,3907,1158,0,32,16025
2/8/2018,1,9871,759,4107,1022,0,9,15768
2/8/2018,2,9875,706,4044,1036,0,9,15670
2/8/2018,3,9875,719,3982,930,0,9,15515
2/8/2018,4,9867,863,4139,804,0,11,15684
2/8/2018,5,9873,1296,4112,631,0,13,15925
2/8/2018,6,9867,1577,4148,611,0,16,16219
2/8/2018,7,9874,2022,4618,823,0,22,17359
2/8/2018,8,9844,2498,5084,1002,0,26,18454
2/8/2018,9,9806,2483,5058,1114,1,27,18489
2/8/2018,10,9813,2912,5153,840,6,27,18751
2/8/2018,11,9811,2939,5154,652,13,26,18595
2/8/2018,12,9806,2157,4968,1031,22,27,18011
2/8/2018,13,9803,1805,4588,1514,29,28,17767
2/8/2018,14,9812,1559,4568,2092,28,26,18085
2/8/2018,15,9847,2057,4532,2020,25,27,18508
2/8/2018,16,9876,2213,4553,2414,14,26,19096
2/8/2018,17,9872,2250,4666,2416,4,27,19235
2/8/2018,18,9868,2505,4909,2611,1,32,19926
2/8/2018,19,9869,2784,4933,2751,0,38,20375
2/8/2018,20,9869,2490,4846,2714,0,39,19958
2/8/2018,21,9857,2402,4916,2801,0,27,20003
2/8/2018,22,9843,1891,4579,2584,0,27,18924
2/8/2018,23,9867,1682,4200,2087,0,35,17871
2/8/2018,24,9863,1198,4380,1750,0,28,17219
2/9/2018,1,9864,1120,4418,1472,0,14,16888
2/9/2018,2,9864,930,3774,1261,0,12,15841
2/9/2018,3,9869,1021,4156,883,0,12,15941
2/9/2018,4,9867,1376,4339,625,0,12,16219
2/9/2018,5,9884,2161,3473,459,0,13,15990
2/9/2018,6,9881,2402,3841,233,0,16,16373
2/9/2018,7,9881,2696,4598,388,0,23,17586
2/9/2018,8,9884,2990,5064,709,0,26,18673
2/9/2018,9,9886,2893,4919,916,5,27,18646
2/9/2018,10,9878,2788,5234,806,14,29,18749
2/9/2018,11,9871,2755,5218,821,24,27,18716
2/9/2018,12,9880,2635,5145,835,31,29,18555
2/9/2018,13,9880,2471,5085,935,36,45,18452
2/9/2018,14,9884,2453,5139,864,39,78,18457
2/9/2018,15,9889,2688,5200,533,38,124,18472
2/9/2018,16,9893,2791,5119,359,32,124,18318
2/9/2018,17,9886,2821,4960,297,16,97,18077
2/9/2018,18,9871,3165,5369,292,1,133,18831
2/9/2018,19,9878,3540,5627,220,0,187,19452
2/9/2018,20,9883,3210,5549,160,0,136,18938
2/9/2018,21,9878,2657,5397,161,0,118,18211
2/9/2018,22,9862,2092,5029,157,0,182,17322
2/9/2018,23,9832,1489,4766,165,0,152,16404
2/9/2018,24,9803,1034,4504,178,0,107,15626
2/10/2018,1,9819,756,3961,212,0,20,14768
2/10/2018,2,9841,697,3802,322,0,2,14664
2/10/2018,3,9844,721,4043,329,0,0,14937
2/10/2018,4,9845,697,3897,327,0,0,14766
2/10/2018,5,9866,769,3992,293,0,0,14920
2/10/2018,6,9898,946,4110,213,0,0,15167
2/10/2018,7,9894,1162,4425,240,0,0,15721
2/10/2018,8,9900,1399,4366,212,1,0,15878
2/10/2018,9,9890,1690,4948,250,2,0,16780
2/10/2018,10,9889,1913,5253,183,11,1,17250
2/10/2018,11,9894,2242,5147,161,34,1,17479
2/10/2018,12,9891,2028,5121,253,39,0,17332
2/10/2018,13,9893,1562,5036,496,36,0,17023
2/10/2018,14,9892,1397,4706,799,32,0,16826
2/10/2018,15,9881,1139,4601,936,34,0,16591
2/10/2018,16,9884,1049,4634,893,28,0,16488
2/10/2018,17,9896,908,4959,804,17,0,16584
2/10/2018,18,9900,1106,5394,607,1,0,17008
2/10/2018,19,9897,1284,5484,489,0,0,17154
2/10/2018,20,9899,1116,5359,501,0,0,16875
2/10/2018,21,9888,1100,5304,486,0,0,16778
2/10/2018,22,9890,1104,4878,546,0,1,16419
2/10/2018,23,9893,468,4423,637,0,0,15421
2/10/2018,24,9900,297,4232,739,0,0,15168
2/11/2018,1,9903,301,4185,876,0,0,15265
2/11/2018,2,9906,317,4162,1058,0,0,15443
2/11/2018,3,9910,298,3725,1280,0,0,15213
2/11/2018,4,9948,303,3508,1415,0,0,15174
2/11/2018,5,10145,383,3364,1520,0,0,15412
2/11/2018,6,10155,547,3615,1394,0,0,15711
2/11/2018,7,10119,654,3631,1627,0,0,16031
2/11/2018,8,10105,734,3820,1343,0,0,16002
2/11/2018,9,10097,844,4403,1384,2,0,16730
2/11/2018,10,10095,1070,4980,1171,6,0,17322
2/11/2018,11,10096,1384,5274,858,9,0,17621
2/11/2018,12,10209,1729,5416,437,11,1,17803
2/11/2018,13,10293,1829,5470,201,13,1,17807
2/11/2018,14,10297,1729,5154,172,12,0,17364
2/11/2018,15,10242,1392,4844,370,8,0,16856
2/11/2018,16,10379,1305,4463,769,3,0,16919
2/11/2018,17,10470,1318,4369,1012,1,0,17170
2/11/2018,18,10476,1360,5222,1042,0,0,18100
2/11/2018,19,10489,1407,5335,1145,0,0,18376
2/11/2018,20,10491,790,5293,1357,0,0,17931
2/11/2018,21,10491,773,5302,1564,0,0,18130
2/11/2018,22,10491,419,5139,1700,0,0,17749
2/11/2018,23,10501,325,4275,1804,0,0,16905
2/11/2018,24,10488,295,3996,1816,0,8,16603
2/12/2018,1,10483,295,3373,1610,0,10,15771
2/12/2018,2,10500,295,3564,1875,0,10,16244
2/12/2018,3,10498,330,3980,1725,0,11,16544
2/12/2018,4,10495,383,3647,1657,0,11,16193
2/12/2018,5,10580,613,3607,1806,0,10,16616
2/12/2018,6,10607,801,3558,1539,0,14,16519
2/12/2018,7,10608,1139,3828,1577,0,20,17172
2/12/2018,8,10604,1166,4451,1608,1,26,17856
2/12/2018,9,10605,1321,4803,1396,11,27,18163
2/12/2018,10,10603,1493,4812,1179,29,27,18143
2/12/2018,11,10600,1317,4814,884,43,27,17685
2/12/2018,12,10596,1405,5247,729,54,27,18058
2/12/2018,13,10616,1047,4922,750,61,27,17423
2/12/2018,14,10640,1329,4246,745,75,28,17063
2/12/2018,15,10641,1595,4243,772,78,42,17371
2/12/2018,16,10635,2056,4399,703,66,69,17928
2/12/2018,17,10639,2510,4485,265,20,75,17994
2/12/2018,18,10642,2847,4860,406,2,75,18832
2/12/2018,19,10642,2524,5615,566,0,78,19425
2/12/2018,20,10651,2147,5660,583,0,113,19154
2/12/2018,21,10642,2008,5560,583,0,163,18956
2/12/2018,22,10635,1918,5126,511,0,195,18385
2/12/2018,23,10632,1231,4498,522,0,134,17017
2/12/2018,24,10642,755,4430,564,0,72,16463
2/13/2018,1,10644,694,4028,638,0,63,16067
2/13/2018,2,10650,700,3831,623,0,21,15825
2/13/2018,3,10648,712,3791,554,0,12,15717
2/13/2018,4,10658,880,3922,501,0,12,15973
2/13/2018,5,10650,1222,3992,560,0,13,16437
2/13/2018,6,10653,1726,3986,586,0,16,16967
2/13/2018,7,10647,2104,4281,595,0,23,17650
2/13/2018,8,10640,2159,5076,897,1,26,18799
2/13/2018,9,10645,2130,4775,1311,24,21,18906
2/13/2018,10,10645,2025,4504,1308,54,27,18563
2/13/2018,11,10644,1681,4577,1207,63,26,18198
2/13/2018,12,10642,1502,5174,988,70,26,18402
2/13/2018,13,10651,1830,5058,750,66,27,18382
2/13/2018,14,10654,1698,4785,662,71,27,17897
2/13/2018,15,10660,1637,4826,696,57,30,17906
2/13/2018,16,10656,1623,4669,711,31,56,17746
2/13/2018,17,10655,1630,4918,749,13,83,18048
2/13/2018,18,10658,1727,5392,802,3,154,18736
2/13/2018,19,10657,1698,5379,1047,0,172,18953
2/13/2018,20,10648,1699,5280,1245,0,112,18984
2/13/2018,21,10645,1545,5390,1263,0,90,18933
2/13/2018,22,10638,919,5152,1329,0,164,18202
2/13/2018,23,10640,733,4657,1485,0,169,17684
2/13/2018,24,9842,499,4429,1670,0,76,16516
2/14/2018,1,9392,352,3937,2273,0,24,15978
2/14/2018,2,9318,316,3541,2885,0,13,16073
2/14/2018,3,9318,295,3403,2700,0,14,15730
2/14/2018,4,9325,381,3371,3150,0,15,16242
2/14/2018,5,9333,399,3311,3064,0,14,16121
2/14/2018,6,9339,437,3479,2783,0,16,16054
2/14/2018,7,9332,529,3752,2932,0,21,16566
2/14/2018,8,9332,522,4150,3007,2,28,17041
2/14/2018,9,9327,527,4857,2868,21,28,17628
2/14/2018,10,9329,608,4688,2845,54,27,17551
2/14/2018,11,9293,636,4434,2764,141,27,17295
2/14/2018,12,9306,817,4538,2581,242,27,17511
2/14/2018,13,9333,1091,4464,2609,278,27,17802
2/14/2018,14,9186,1119,4438,2479,284,27,17533
2/14/2018,15,9170,1180,4383,2269,268,27,17297
2/14/2018,16,9322,1290,4542,1937,202,27,17320
2/14/2018,17,9330,1553,4598,2130,97,27,17735
2/14/2018,18,9326,1568,4623,2521,12,27,18077
2/14/2018,19,9329,1586,4718,2597,0,27,18257
2/14/2018,20,9328,1588,4682,2669,0,27,18294
2/14/2018,21,9327,1450,4857,2715,0,27,18376
2/14/2018,22,9318,1030,5244,2738,0,27,18357
2/14/2018,23,9324,395,4619,2906,0,27,17271
2/14/2018,24,9326,288,4108,2457,0,18,16197
2/15/2018,1,9326,287,3516,2722,0,13,15864
2/15/2018,2,9333,316,3460,2853,0,11,15973
2/15/2018,3,9331,319,3438,3046,0,13,16147
2/15/2018,4,9327,318,3474,3009,0,11,16139
2/15/2018,5,9332,317,3476,2898,0,11,16034
2/15/2018,6,9331,320,3599,2669,0,14,15933
2/15/2018,7,9346,320,3739,3146,0,20,16571
2/15/2018,8,9355,320,4438,3588,0,26,17727
2/15/2018,9,9353,319,4492,3612,14,27,17817
2/15/2018,10,9355,395,4561,3497,59,27,17894
2/15/2018,11,9361,409,4643,3483,75,27,17998
2/15/2018,12,9364,472,4328,3302,82,27,17575
2/15/2018,13,9365,553,4793,2927,86,27,17751
2/15/2018,14,9365,553,4409,3025,87,27,17466
2/15/2018,15,9364,679,4334,2909,70,27,17383
2/15/2018,16,9362,934,4509,2500,42,27,17374
2/15/2018,17,9373,1203,4752,1915,22,27,17292
2/15/2018,18,9372,1420,5227,1736,3,27,17785
2/15/2018,19,9374,1548,5377,1407,0,27,17733
2/15/2018,20,9371,1408,5257,1360,0,30,17426
2/15/2018,21,9370,1173,5213,1490,0,30,17276
2/15/2018,22,9368,1040,4640,1840,0,29,16917
2/15/2018,23,9363,664,4364,1624,0,28,16043
2/15/2018,24,9368,359,4005,1555,0,20,15307
2/16/2018,1,9369,283,3973,1431,0,14,15070
2/16/2018,2,9364,285,4103,1240,0,10,15002
2/16/2018,3,9365,359,4232,1083,0,12,15051
2/16/2018,4,9364,321,3931,1283,0,12,14911
2/16/2018,5,9366,353,3496,1440,0,14,14669
2/16/2018,6,9499,421,3900,1580,0,14,15414
2/16/2018,7,9618,503,3890,1996,0,21,16028
2/16/2018,8,9620,504,4536,2432,1,26,17119
2/16/2018,9,9625,505,4626,2723,14,27,17520
2/16/2018,10,9580,508,4825,2831,32,27,17803
2/16/2018,11,9719,506,4790,2923,59,26,18023
2/16/2018,12,9876,520,4255,2813,140,26,17630
2/16/2018,13,10043,377,4047,2740,222,26,17455
2/16/2018,14,10055,473,4007,2403,238,27,17203
2/16/2018,15,10056,653,4117,2574,247,33,17680
2/16/2018,16,10053,1048,4138,1705,151,59,17154
2/16/2018,17,10051,1651,4514,982,101,74,17373
2/16/2018,18,10055,1913,5013,900,15,86,17982
2/16/2018,19,10054,2846,5479,427,0,172,18978
2/16/2018,20,10056,2820,5333,296,0,201,18706
2/16/2018,21,10056,2271,5337,435,0,201,18300
2/16/2018,22,10050,1727,4616,666,0,154,17213
2/16/2018,23,10058,1058,4645,943,0,88,16792
2/16/2018,24,10143,745,4059,1129,0,26,16102
2/17/2018,1,10149,357,3870,1340,0,12,15728
2/17/2018,2,10157,294,3779,1374,0,1,15605
2/17/2018,3,10156,296,3577,1436,0,0,15465
2/17/2018,4,10164,295,3732,1245,0,0,15436
2/17/2018,5,10169,368,3894,1273,0,0,15704
2/17/2018,6,10179,451,3536,1522,0,0,15688
2/17/2018,7,10180,532,3721,1771,0,0,16204
2/17/2018,8,10176,520,3542,2107,13,0,16358
2/17/2018,9,10171,559,3893,2156,46,0,16825
2/17/2018,10,10184,596,4406,2101,91,0,17378
2/17/2018,11,10178,707,4933,1962,115,0,17895
2/17/2018,12,10207,849,4519,2036,125,0,17736
2/17/2018,13,10185,769,4220,1880,141,0,17195
2/17/2018,14,10181,702,4494,1685,126,0,17188
2/17/2018,15,10185,710,4638,1588,96,0,17217
2/17/2018,16,10133,710,4494,1503,65,0,16905
2/17/2018,17,10171,766,4370,1455,33,0,16795
2/17/2018,18,10170,777,4870,1202,5,0,17024
2/17/2018,19,10165,849,5258,1120,0,0,17392
2/17/2018,20,10174,830,5218,1078,0,0,17300
2/17/2018,21,10172,864,5152,1225,0,0,17413
2/17/2018,22,10174,796,4393,1338,0,0,16701
2/17/2018,23,10162,485,4667,1303,0,0,16617
2/17/2018,24,10174,318,4476,1486,0,0,16454
2/18/2018,1,10178,294,3205,1617,0,0,15294
2/18/2018,2,10174,293,2969,1778,0,0,15214
2/18/2018,3,10194,293,3041,1903,0,0,15431
2/18/2018,4,10192,293,3118,1987,0,0,15590
2/18/2018,5,10203,292,3112,1733,0,0,15340
2/18/2018,6,10202,293,3280,1552,0,0,15327
2/18/2018,7,10205,294,3255,1412,0,0,15166
2/18/2018,8,10203,293,3520,1004,1,0,15021
2/18/2018,9,10199,293,4231,985,45,0,15753
2/18/2018,10,10201,297,4299,773,118,0,15688
2/18/2018,11,10204,297,4009,864,130,0,15504
2/18/2018,12,10204,296,4294,656,230,0,15680
2/18/2018,13,10192,297,4650,563,254,0,15956
2/18/2018,14,10208,297,3785,660,224,0,15174
2/18/2018,15,10221,399,3772,498,208,0,15098
2/18/2018,16,10221,517,3910,848,140,0,15636
2/18/2018,17,10224,640,4315,962,84,0,16225
2/18/2018,18,10213,668,5109,1308,9,0,17307
2/18/2018,19,10214,676,5309,1633,0,0,17832
2/18/2018,20,10216,643,4740,1941,0,0,17540
2/18/2018,21,10226,643,4392,2451,0,0,17712
2/18/2018,22,10230,641,3835,2427,0,0,17133
2/18/2018,23,10224,436,3599,2529,0,0,16788
2/18/2018,24,10222,294,3389,2195,0,0,16100
2/19/2018,1,10222,292,3152,1960,0,0,15626
2/19/2018,2,10235,291,3151,1928,0,0,15605
2/19/2018,3,10234,294,3154,1644,0,0,15326
2/19/2018,4,10224,293,3142,1720,0,0,15379
2/19/2018,5,10223,294,3089,1714,0,0,15320
2/19/2018,6,10231,293,3037,2253,0,0,15814
2/19/2018,7,10238,292,3111,2408,0,0,16049
2/19/2018,8,10235,293,3280,2370,8,0,16186
2/19/2018,9,10236,291,3413,2394,41,0,16375
2/19/2018,10,10237,294,3624,2215,80,0,16450
2/19/2018,11,10240,294,3798,1980,109,1,16422
2/19/2018,12,10254,431,4121,2170,88,1,17065
2/19/2018,13,10236,536,4645,2217,44,0,17678
2/19/2018,14,10243,667,4408,2198,30,0,17546
2/19/2018,15,10241,695,4238,1821,22,0,17017
2/19/2018,16,10246,761,5085,1316,12,0,17420
2/19/2018,17,10241,827,5029,1230,4,0,17331
2/19/2018,18,10238,828,4793,1514,0,0,17373
2/19/2018,19,10245,829,4767,1734,0,0,17575
2/19/2018,20,10245,825,4580,1794,0,0,17444
2/19/2018,21,10248,632,4414,2135,0,0,17429
2/19/2018,22,10244,478,4370,2142,0,0,17234
2/19/2018,23,10244,315,4313,2075,0,0,16947
2/19/2018,24,10228,295,3605,2161,0,0,16289
2/20/2018,1,10225,302,3432,1909,0,0,15868
2/20/2018,2,10225,326,3312,1678,0,14,15555
2/20/2018,3,10244,324,3284,1512,0,14,15378
2/20/2018,4,10240,326,3440,1256,0,12,15274
2/20/2018,5,10237,323,3276,1821,0,12,15669
2/20/2018,6,10248,318,3299,2040,0,15,15920
2/20/2018,7,10255,326,3912,2183,0,19,16695
2/20/2018,8,10258,325,4159,2625,0,25,17392
2/20/2018,9,10251,325,4351,2421,2,26,17376
2/20/2018,10,10253,328,4959,2517,8,27,18092
2/20/2018,11,10254,328,4542,2431,27,28,17610
2/20/2018,12,10253,328,4292,2445,47,27,17392
2/20/2018,13,10253,342,4178,2158,20,26,16977
2/20/2018,14,10251,385,4368,2482,16,25,17527
2/20/2018,15,10249,508,4234,2583,15,24,17613
2/20/2018,16,10245,509,4377,2219,14,28,17392
2/20/2018,17,10242,511,4659,2698,8,28,18146
2/20/2018,18,10223,510,4673,2695,3,28,18132
2/20/2018,19,10235,511,4603,2686,0,28,18063
2/20/2018,20,10235,510,4700,3059,0,27,18531
2/20/2018,21,10226,359,4525,3080,0,27,18217
2/20/2018,22,10235,324,4169,2748,0,27,17503
2/20/2018,23,10232,296,3780,2149,0,27,16484
2/20/2018,24,10230,296,3559,1509,0,19,15613
2/21/2018,1,10234,294,3662,1231,0,13,15434
2/21/2018,2,10233,295,3380,910,0,12,14830
2/21/2018,3,10231,295,3373,676,0,12,14587
2/21/2018,4,10234,410,3363,713,0,12,14732
2/21/2018,5,10231,504,3389,746,0,12,14882
2/21/2018,6,10226,582,3448,672,0,16,14944
2/21/2018,7,10234,744,3729,1168,0,23,15898
2/21/2018,8,10237,868,4254,1929,2,29,17319
2/21/2018,9,10235,1042,4808,1948,5,30,18068
2/21/2018,10,10228,1188,4816,1748,18,28,18026
2/21/2018,11,10223,1219,4866,1666,39,28,18041
2/21/2018,12,10230,1292,4695,1472,55,27,17771
2/21/2018,13,10236,1174,4661,1360,71,28,17530
2/21/2018,14,10099,1177,4835,1270,75,28,17484
2/21/2018,15,10162,1472,4260,1032,66,27,17019
2/21/2018,16,10227,1650,4205,974,52,28,17136
2/21/2018,17,10225,1843,4773,786,36,26,17689
2/21/2018,18,10237,1921,5399,700,8,27,18292
2/21/2018,19,10250,2181,5613,550,0,27,18621
2/21/2018,20,10256,1919,5728,369,0,27,18299
2/21/2018,21,10252,1671,5594,301,0,27,17845
2/21/2018,22,10239,1427,5192,317,0,27,17202
2/21/2018,23,10265,551,4848,451,0,27,16142
2/21/2018,24,10299,301,4127,589,0,17,15333
2/22/2018,1,10313,301,3885,702,0,11,15212
2/22/2018,2,10318,300,3577,860,0,10,15065
2/22/2018,3,10328,304,3823,908,0,10,15373
2/22/2018,4,10392,307,3723,948,0,10,15380
2/22/2018,5,10463,404,3521,909,0,10,15307
2/22/2018,6,10578,574,3568,682,0,29,15431
2/22/2018,7,10596,715,4576,610,0,75,16572
2/22/2018,8,10594,712,5214,702,2,111,17335
2/22/2018,9,10594,708,5227,727,15,81,17352
2/22/2018,10,10586,712,5326,609,27,94,17354
2/22/2018,11,10585,713,5309,497,47,165,17316
2/22/2018,12,10591,722,5052,544,67,188,17164
2/22/2018,13,10593,413,4578,560,104,187,16435
2/22/2018,14,10590,419,4532,513,155,187,16396
2/22/2018,15,10542,561,4260,543,166,184,16256
2/22/2018,16,10580,827,4197,487,145,174,16410
2/22/2018,17,10620,1025,4458,517,104,177,16901
2/22/2018,18,10627,1140,4907,695,19,185,17573
2/22/2018,19,10622,1157,5576,756,0,191,18302
2/22/2018,20,10573,1208,5609,972,0,202,18564
2/22/2018,21,10570,1062,5499,1177,0,208,18516
2/22/2018,22,10565,865,4664,1542,0,165,17801
2/22/2018,23,10568,707,3916,1959,0,80,17230
2/22/2018,24,10566,386,3693,1654,0,24,16323
2/23/2018,1,10623,298,3251,1761,0,12,15945
2/23/2018,2,10628,299,3139,1975,0,11,16052
2/23/2018,3,10676,302,3113,1824,0,11,15926
2/23/2018,4,10676,310,3102,1667,0,11,15766
2/23/2018,5,10686,410,3199,1657,0,11,15963
2/23/2018,6,10686,568,3228,1793,0,11,16286
2/23/2018,7,10712,712,3860,1965,0,17,17266
2/23/2018,8,10708,707,4110,2234,2,26,17787
2/23/2018,9,10644,712,4475,2196,14,24,18065
2/23/2018,10,10640,710,4694,2270,18,26,18358
2/23/2018,11,10649,710,4681,2260,24,25,18349
2/23/2018,12,10651,711,5118,2050,28,27,18585
2/23/2018,13,10663,390,5168,1922,30,28,18201
2/23/2018,14,10725,295,4801,2422,30,28,18301
2/23/2018,15,10742,295,4133,2547,23,30,17770
2/23/2018,16,10742,294,4046,2534,15,28,17659
2/23/2018,17,10740,293,4105,2603,9,26,17776
2/23/2018,18,10744,293,4590,2320,2,27,17976
2/23/2018,19,10743,296,4842,2241,0,27,18149
2/23/2018,20,10739,295,4716,2505,0,27,18282
2/23/2018,21,10741,296,4321,2433,0,27,17818
2/23/2018,22,10735,296,3710,2269,0,27,17037
2/23/2018,23,10470,296,3711,2256,0,27,16760
2/23/2018,24,10222,272,3798,1953,0,19,16264
2/24/2018,1,10218,268,3152,1661,0,8,15307
2/24/2018,2,10220,269,3138,1590,0,0,15217
2/24/2018,3,10219,269,3266,1561,0,0,15315
2/24/2018,4,10216,268,3348,1173,0,0,15005
2/24/2018,5,10218,269,3336,901,0,0,14724
2/24/2018,6,10222,259,3439,745,0,0,14665
2/24/2018,7,10142,211,3678,570,0,0,14601
2/24/2018,8,10143,212,4827,421,6,0,15609
2/24/2018,9,10138,212,4894,353,28,0,15625
2/24/2018,10,10137,211,4516,352,82,0,15298
2/24/2018,11,10170,268,4712,307,111,0,15568
2/24/2018,12,10215,317,4638,245,119,0,15534
2/24/2018,13,10217,317,4860,243,109,0,15746
2/24/2018,14,10219,317,4927,336,117,0,15916
2/24/2018,15,10169,358,4705,559,129,0,15920
2/24/2018,16,10220,429,4569,754,122,0,16094
2/24/2018,17,10219,428,4711,732,60,0,16150
2/24/2018,18,10209,432,5111,916,9,0,16677
2/24/2018,19,10218,433,5086,1368,0,0,17105
2/24/2018,20,10221,432,4587,1966,0,0,17206
2/24/2018,21,10220,434,4165,2405,0,0,17224
2/24/2018,22,10214,300,4053,2302,0,0,16869
2/24/2018,23,10210,213,3891,2102,0,0,16416
2/24/2018,24,10210,212,3321,1955,0,0,15698
2/25/2018,1,10172,211,3001,1735,0,0,15119
2/25/2018,2,10131,212,3004,1927,0,0,15274
2/25/2018,3,10136,211,3028,1885,0,0,15260
2/25/2018,4,10132,210,3028,1813,0,0,15183
2/25/2018,5,10131,210,3125,1720,0,0,15186
2/25/2018,6,10196,210,3283,1649,0,0,15338
2/25/2018,7,10208,210,3389,1795,0,0,15602
2/25/2018,8,10217,210,3669,1461,1,8,15566
2/25/2018,9,10209,210,3621,2183,10,7,16240
2/25/2018,10,10211,211,3675,2461,54,0,16612
2/25/2018,11,10223,227,3638,2355,118,0,16561
2/25/2018,12,10230,239,3664,2021,137,0,16291
2/25/2018,13,10230,238,3757,1397,175,0,15797
2/25/2018,14,10226,238,3798,1421,187,0,15870
2/25/2018,15,10220,238,3803,1184,215,0,15660
2/25/2018,16,10223,255,3850,1235,74,0,15637
2/25/2018,17,10226,238,3937,1879,121,0,16401
2/25/2018,18,10221,240,3992,3039,29,0,17521
2/25/2018,19,10221,295,4231,3641,0,0,18388
2/25/2018,20,10210,324,4151,3810,0,0,18495
2/25/2018,21,10210,323,3916,3571,0,0,18020
2/25/2018,22,10208,325,3810,3116,0,0,17459
2/25/2018,23,10186,299,3833,2200,0,0,16518
2/25/2018,24,10129,296,3557,1693,0,0,15675
2/26/2018,1,10129,294,3209,1409,0,1,15042
2/26/2018,2,10129,294,3143,1613,0,9,15188
2/26/2018,3,10133,294,3217,1422,0,10,15076
2/26/2018,4,10128,294,3214,1316,0,10,14962
2/26/2018,5,10130,294,3136,1517,0,10,15087
2/26/2018,6,10127,294,3423,1570,0,12,15426
2/26/2018,7,10190,322,4021,1788,0,17,16338
2/26/2018,8,10196,327,4322,1799,28,26,16698
2/26/2018,9,10190,327,4726,1305,124,27,16699
2/26/2018,10,10199,336,4741,867,223,27,16393
2/26/2018,11,10204,358,4807,1190,239,27,16825
2/26/2018,12,10203,381,4617,1327,254,27,16809
2/26/2018,13,10205,398,4484,932,265,27,16311
2/26/2018,14,10208,472,4424,1018,271,27,16420
2/26/2018,15,10213,522,4553,743,222,27,16280
2/26/2018,16,10207,609,4853,574,91,27,16361
2/26/2018,17,10225,689,5184,887,108,27,17120
2/26/2018,18,10227,766,5208,1338,34,26,17599
2/26/2018,19,10232,852,5467,1377,0,27,17955
2/26/2018,20,10232,923,5532,1595,0,27,18309
2/26/2018,21,10229,919,5439,1735,0,27,18349
2/26/2018,22,10223,891,4420,1761,0,27,17322
2/26/2018,23,10221,719,3979,1801,0,27,16747
2/26/2018,24,10226,515,3551,1722,0,17,16031
2/27/2018,1,10221,482,3171,1559,0,13,15446
2/27/2018,2,10226,303,3016,1700,0,8,15253
2/27/2018,3,10222,296,3145,1573,0,7,15243
2/27/2018,4,10225,296,3069,1757,0,6,15353
2/27/2018,5,10227,296,3112,1931,0,8,15574
2/27/2018,6,10232,295,3337,1808,0,13,15685
2/27/2018,7,10229,296,4131,2284,0,20,16960
2/27/2018,8,10233,296,4484,2452,31,33,17529
2/27/2018,9,10232,296,4249,2170,120,42,17109
2/27/2018,10,10233,295,4289,1483,216,90,16606
2/27/2018,11,10225,296,3952,1460,276,111,16320
2/27/2018,12,10229,295,3917,964,302,113,15820
2/27/2018,13,10231,349,3916,840,198,113,15647
2/27/2018,14,10100,399,3893,735,103,111,15341
2/27/2018,15,10068,399,3989,925,186,109,15676
2/27/2018,16,10197,400,4067,816,119,110,15709
2/27/2018,17,10254,435,4183,1348,129,113,16462
2/27/2018,18,10263,511,4479,1990,33,114,17390
2/27/2018,19,10280,510,4813,2436,0,113,18152
2/27/2018,20,10292,514,4751,2566,0,113,18236
2/27/2018,21,10298,515,4636,2407,0,112,17968
2/27/2018,22,10306,517,4201,2282,0,43,17349
2/27/2018,23,10332,515,3753,1778,0,27,16405
2/27/2018,24,10352,384,3550,1421,0,17,15724
2/28/2018,1,10420,296,3290,1192,0,11,15209
2/28/2018,2,10463,297,3317,915,0,8,15000
2/28/2018,3,10480,297,3409,731,0,9,14926
2/28/2018,4,10477,298,3528,1003,0,9,15315
2/28/2018,5,10482,298,3307,1002,0,16,15105
2/28/2018,6,10478,297,3486,1266,0,20,15547
2/28/2018,7,10481,296,3756,2005,0,38,16576
2/28/2018,8,10487,298,3944,2185,17,96,17027
2/28/2018,9,10478,296,4292,1798,75,113,17052
2/28/2018,10,10473,297,4289,1287,184,113,16643
2/28/2018,11,10411,297,4297,1083,261,115,16464
2/28/2018,12,10440,296,4300,891,249,115,16291
2/28/2018,13,10452,301,4315,500,92,114,15774
2/28/2018,14,10300,422,4364,582,132,114,15914
2/28/2018,15,10350,512,4338,826,146,116,16288
2/28/2018,16,10456,635,4331,876,153,116,16567
2/28/2018,17,10472,639,4398,1313,104,117,17043
2/28/2018,18,10478,639,4557,1393,22,115,17204
2/28/2018,19,10476,642,4732,1707,0,114,17671
2/28/2018,20,10478,644,4829,1538,0,115,17604
2/28/2018,21,10621,639,4696,1164,0,113,17233
2/28/2018,22,10731,436,4940,913,0,95,17115
2/28/2018,23,10901,295,4174,978,0,65,16413
2/28/2018,24,10953,294,3660,843,0,17,15767
3/1/2018,1,10983,294,3455,748,0,12,15492
3/1/2018,2,11008,294,3557,743,0,12,15614
3/1/2018,3,11170,295,3389,685,0,12,15551
3/1/2018,4,11068,293,3329,266,0,12,14968
3/1/2018,5,10896,294,3424,634,0,12,15260
3/1/2018,6,10903,376,3734,669,0,20,15702
3/1/2018,7,11128,448,4005,582,0,37,16200
3/1/2018,8,11203,517,4166,1310,8,62,17266
3/1/2018,9,11130,517,4248,1408,49,64,17416
3/1/2018,10,11122,534,4288,827,78,63,16912
3/1/2018,11,11119,545,4373,600,45,65,16747
3/1/2018,12,11071,550,4376,754,103,65,16919
3/1/2018,13,11064,545,4083,1130,157,62,17041
3/1/2018,14,11066,417,4009,1376,134,57,17059
3/1/2018,15,11164,329,4051,1342,126,47,17059
3/1/2018,16,11287,329,4034,1662,75,39,17426
3/1/2018,17,11317,329,4418,1923,35,28,18050
3/1/2018,18,11317,330,4472,2353,6,27,18505
3/1/2018,19,11325,330,4431,2659,0,26,18771
3/1/2018,20,11325,329,4463,2519,0,27,18663
3/1/2018,21,11330,329,4311,2814,0,26,18810
3/1/2018,22,11339,330,3823,2723,0,27,18242
3/1/2018,23,11341,328,3611,2070,0,26,17376
3/1/2018,24,11335,329,3386,1310,0,15,16375
3/2/2018,1,11331,329,3338,1362,0,12,16372
3/2/2018,2,11344,329,3262,1142,0,11,16088
3/2/2018,3,11376,330,3328,995,0,12,16041
3/2/2018,4,11389,328,3343,993,0,11,16064
3/2/2018,5,11356,328,3277,1049,0,12,16022
3/2/2018,6,11324,328,3450,1134,0,14,16250
3/2/2018,7,11372,330,3821,1742,0,20,17285
3/2/2018,8,11402,331,3887,2211,2,27,17860
3/2/2018,9,11396,330,3896,2541,26,27,18216
3/2/2018,10,11394,330,3895,2364,62,30,18075
3/2/2018,11,11401,327,3934,2039,103,28,17832
3/2/2018,12,11413,328,4172,1456,144,27,17540
3/2/2018,13,11406,328,4154,1077,213,27,17205
3/2/2018,14,11407,329,4003,1064,232,27,17062
3/2/2018,15,11315,329,3897,1206,221,27,16995
3/2/2018,16,11352,329,3860,1290,195,27,17053
3/2/2018,17,11369,329,4170,1601,125,27,17621
3/2/2018,18,11370,303,4592,1972,39,27,18303
3/2/2018,19,11422,300,5002,2133,0,27,18884
3/2/2018,20,11490,300,5164,2104,0,27,19085
3/2/2018,21,11492,301,5101,1921,0,27,18842
3/2/2018,22,11490,301,4738,1805,0,27,18361
3/2/2018,23,11486,301,4037,1585,0,27,17436
3/2/2018,24,11475,297,3483,1171,0,10,16436
3/3/2018,1,11480,296,3095,1246,0,0,16117
3/3/2018,2,11471,295,3027,992,0,0,15785
3/3/2018,3,11472,296,3110,831,0,0,15709
3/3/2018,4,11474,294,3115,754,0,0,15637
3/3/2018,5,11474,294,3115,776,0,0,15659
3/3/2018,6,11480,294,3242,878,0,0,15894
3/3/2018,7,11473,295,3378,807,0,0,15953
3/3/2018,8,11477,296,3716,866,29,0,16384
3/3/2018,9,11478,294,3844,735,116,0,16467
3/3/2018,10,11476,294,3854,839,195,0,16658
3/3/2018,11,11476,293,3839,808,234,0,16650
3/3/2018,12,11483,294,3772,540,250,0,16339
3/3/2018,13,11488,294,3605,550,265,0,16202
3/3/2018,14,11491,292,3597,476,253,0,16109
3/3/2018,15,11494,292,3598,395,183,0,15962
3/3/2018,16,11492,292,3737,376,106,0,16003
3/3/2018,17,11507,293,4214,524,92,0,16630
3/3/2018,18,11506,292,4705,903,45,0,17451
3/3/2018,19,11518,294,4809,1690,0,0,18311
3/3/2018,20,11515,295,4885,1715,0,0,18410
3/3/2018,21,11498,294,4577,1731,0,0,18100
3/3/2018,22,11506,294,4429,1449,0,5,17683
3/3/2018,23,11515,294,3959,1286,0,5,17059
3/3/2018,24,11515,294,3491,1090,0,0,16390
3/4/2018,1,11512,293,3231,1124,0,0,16160
3/4/2018,2,11369,300,3102,708,0,0,15479
3/4/2018,3,10752,374,3219,1158,0,0,15503
3/4/2018,4,10750,300,3113,1395,0,0,15558
3/4/2018,5,10755,293,3164,1395,0,0,15607
3/4/2018,6,10751,292,3235,1260,0,0,15538
3/4/2018,7,10751,294,3484,1238,0,0,15767
3/4/2018,8,10752,295,3938,977,52,0,16014
3/4/2018,9,10750,295,3941,701,181,1,15869
3/4/2018,10,10746,295,3830,568,282,0,15721
3/4/2018,11,10742,293,3989,445,302,0,15771
3/4/2018,12,10732,292,3664,769,335,0,15792
3/4/2018,13,10737,293,3751,712,335,0,15828
3/4/2018,14,10740,292,3715,772,335,1,15855
3/4/2018,15,10738,292,3722,732,321,17,15822
3/4/2018,16,10702,292,3967,688,233,49,15931
3/4/2018,17,10741,295,4432,1098,172,51,16789
3/4/2018,18,10750,305,4749,1446,53,70,17373
3/4/2018,19,10750,294,5361,1603,0,148,18156
3/4/2018,20,10750,295,5117,1680,0,171,18013
3/4/2018,21,10751,327,4810,1720,0,171,17779
3/4/2018,22,10756,341,4659,1821,0,125,17702
3/4/2018,23,10753,353,4178,1743,0,18,17045
3/4/2018,24,10747,349,3557,1813,0,1,16467
3/5/2018,1,10748,469,2992,1842,0,4,16055
3/5/2018,2,10745,506,3022,1532,0,12,15817
3/5/2018,3,10750,538,3042,1473,0,11,15814
3/5/2018,4,10744,636,3102,1345,0,11,15838
3/5/2018,5,10752,753,2986,1411,0,11,15913
3/5/2018,6,10751,1004,3403,829,0,32,16019
3/5/2018,7,10749,1299,4042,1307,0,68,17465
3/5/2018,8,10747,1359,5285,909,34,139,18473
3/5/2018,9,10732,1401,5480,448,130,201,18392
3/5/2018,10,10730,1243,5267,240,230,204,17914
3/5/2018,11,10735,1080,5251,176,266,205,17713
3/5/2018,12,10738,1083,5220,134,267,205,17647
3/5/2018,13,10741,825,4885,110,275,205,17041
3/5/2018,14,10743,714,5056,177,270,206,17166
3/5/2018,15,10742,875,5010,273,264,195,17359
3/5/2018,16,10741,1148,4863,362,197,203,17514
3/5/2018,17,10742,1282,4791,406,123,203,17547
3/5/2018,18,10748,1308,5012,456,37,200,17761
3/5/2018,19,10745,1324,5648,508,0,202,18427
3/5/2018,20,10741,1324,5533,663,0,204,18465
3/5/2018,21,10740,1161,5304,687,0,198,18090
3/5/2018,22,10737,1168,5051,857,0,164,17977
3/5/2018,23,10735,522,4609,1127,0,57,17050
3/5/2018,24,10742,298,3472,1130,0,18,15660
3/6/2018,1,10752,296,3298,1190,0,13,15549
3/6/2018,2,10750,293,3102,1408,0,11,15564
3/6/2018,3,10742,295,3212,1222,0,11,15482
3/6/2018,4,10749,379,3164,1519,0,10,15821
3/6/2018,5,10760,453,3162,1578,0,10,15963
3/6/2018,6,10765,523,3244,1369,0,13,15914
3/6/2018,7,10767,546,3701,1998,1,20,17033
3/6/2018,8,10763,566,4402,2405,14,26,18176
3/6/2018,9,10756,648,4662,2536,44,27,18673
3/6/2018,10,10758,672,4625,2308,91,26,18480
3/6/2018,11,10766,791,4368,2238,88,27,18278
3/6/2018,12,10752,800,4635,1975,120,43,18325
3/6/2018,13,10747,786,4912,1599,158,79,18281
3/6/2018,14,10730,763,4355,1222,171,137,17378
3/6/2018,15,10736,872,5113,918,157,198,17994
3/6/2018,16,10738,1047,4972,1147,94,205,18203
3/6/2018,17,10740,1195,5263,1060,55,205,18518
3/6/2018,18,10739,1206,5094,980,15,206,18240
3/6/2018,19,10741,1291,5606,854,0,206,18698
3/6/2018,20,10745,1306,5495,714,0,206,18466
3/6/2018,21,10744,1008,5647,602,0,206,18207
3/6/2018,22,10743,1046,5541,543,0,193,18066
3/6/2018,23,10762,449,4987,573,0,99,16870
3/6/2018,24,10760,291,3749,693,0,31,15524
3/7/2018,1,10761,292,3293,602,0,12,14960
3/7/2018,2,10760,298,3362,586,0,10,15016
3/7/2018,3,10753,300,3226,411,0,10,14700
3/7/2018,4,10750,379,3399,454,0,10,14992
3/7/2018,5,10761,614,3484,490,0,10,15359
3/7/2018,6,10759,787,3342,342,0,15,15245
3/7/2018,7,10762,942,3819,379,0,25,15927
3/7/2018,8,10763,916,4320,657,4,26,16686
3/7/2018,9,10758,916,4655,675,16,27,17047
3/7/2018,10,10764,969,5136,706,30,26,17631
3/7/2018,11,10758,1048,4881,717,33,26,17463
3/7/2018,12,10755,1120,4938,656,70,35,17574
3/7/2018,13,10763,991,4713,755,93,70,17385
3/7/2018,14,10607,906,4471,969,115,114,17182
3/7/2018,15,10596,904,4403,1337,125,191,17556
3/7/2018,16,10590,750,4659,1574,101,205,17879
3/7/2018,17,10724,521,4528,2038,42,206,18059
3/7/2018,18,10755,491,4977,2202,11,205,18641
3/7/2018,19,10754,491,5102,2044,1,203,18595
3/7/2018,20,10755,496,4739,2200,0,199,18389
3/7/2018,21,10749,494,4353,2451,0,200,18247
3/7/2018,22,10739,495,4394,2365,0,170,18163
3/7/2018,23,10271,327,4105,2517,0,64,17284
3/7/2018,24,10243,286,3385,2465,0,18,16397
3/8/2018,1,10244,285,3082,2092,0,15,15718
3/8/2018,2,10242,284,3019,1981,0,13,15539
3/8/2018,3,10236,290,3154,1876,0,13,15569
3/8/2018,4,10231,302,3177,1997,0,13,15720
3/8/2018,5,10210,403,3087,1800,0,14,15514
3/8/2018,6,10224,523,3207,1490,0,34,15478
3/8/2018,7,10235,704,3672,2322,0,80,17013
3/8/2018,8,10234,706,4443,2464,10,169,18026
3/8/2018,9,10235,707,4659,2472,40,206,18319
3/8/2018,10,10231,780,4699,2454,67,207,18438
3/8/2018,11,10218,789,4509,2489,66,204,18275
3/8/2018,12,10221,918,4438,2469,90,204,18340
3/8/2018,13,10223,914,4303,2361,126,202,18129
3/8/2018,14,10220,923,4520,2168,88,177,18096
3/8/2018,15,10225,937,4863,2105,89,174,18393
3/8/2018,16,10235,937,4788,2199,71,162,18392
3/8/2018,17,10240,957,4619,2298,42,158,18314
3/8/2018,18,10241,1098,4692,2005,9,164,18209
3/8/2018,19,10246,1113,5320,1895,0,195,18769
3/8/2018,20,10242,1110,5520,1776,0,199,18847
3/8/2018,21,10244,1274,5683,1593,0,158,18952
3/8/2018,22,10239,829,5326,1523,0,60,17977
3/8/2018,23,10231,349,4876,1568,0,27,17051
3/8/2018,24,10228,286,3726,1751,0,18,16009
3/9/2018,1,10230,286,2993,1752,0,13,15274
3/9/2018,2,10234,287,3011,1545,0,11,15088
3/9/2018,3,10230,294,3067,1676,0,11,15278
3/9/2018,4,10234,328,3044,1989,0,3,15598
3/9/2018,5,10235,431,2992,1420,0,3,15081
3/9/2018,6,10233,575,3003,1800,0,3,15614
3/9/2018,7,10239,755,3613,2286,0,8,16901
3/9/2018,8,10240,824,4178,2653,2,11,17908
3/9/2018,9,10236,955,4486,2660,15,20,18372
3/9/2018,10,10237,970,4748,2544,39,25,18563
3/9/2018,11,10241,1120,4296,2651,83,27,18418
3/9/2018,12,10242,1254,3877,2379,115,27,17894
3/9/2018,13,10236,1169,3810,2148,145,26,17534
3/9/2018,14,10236,1106,3792,2047,136,26,17343
3/9/2018,15,10237,947,3894,2338,99,26,17541
3/9/2018,16,10238,951,4176,2661,73,36,18135
3/9/2018,17,10237,1095,4497,2418,58,39,18344
3/9/2018,18,10236,1217,5077,2047,19,50,18646
3/9/2018,19,10240,1378,5727,1797,0,51,19193
3/9/2018,20,10240,1358,5545,1642,0,53,18838
3/9/2018,21,10240,1226,5118,1542,0,57,18183
3/9/2018,22,10228,848,4834,1465,0,50,17425
3/9/2018,23,10230,588,4697,1446,0,56,17017
3/9/2018,24,10233,545,3717,1407,0,48,15950
3/10/2018,1,10241,348,3102,1337,0,43,15071
3/10/2018,2,10260,287,3090,1290,0,46,14973
3/10/2018,3,10235,288,3284,1050,0,31,14888
3/10/2018,4,10231,293,3255,1014,0,16,14809
3/10/2018,5,10224,387,3271,1081,0,10,14973
3/10/2018,6,10224,551,3305,1073,0,12,15165
3/10/2018,7,10233,699,3268,943,0,13,15156
3/10/2018,8,10228,698,3711,847,10,4,15498
3/10/2018,9,10226,699,4075,784,45,0,15829
3/10/2018,10,10229,782,4599,765,95,0,16470
3/10/2018,11,10177,801,5215,761,146,0,17100
3/10/2018,12,10161,863,4545,815,195,0,16579
3/10/2018,13,10215,561,4112,938,188,0,16014
3/10/2018,14,10213,558,4524,1015,153,0,16463
3/10/2018,15,10223,706,4101,1138,145,0,16313
3/10/2018,16,10223,784,4243,1313,136,0,16699
3/10/2018,17,10223,991,4458,1292,97,0,17061
3/10/2018,18,10229,992,4908,1182,26,0,17337
3/10/2018,19,10231,999,5803,921,0,0,17954
3/10/2018,20,10230,1021,5813,612,0,0,17676
3/10/2018,21,10224,975,5041,532,0,0,16772
3/10/2018,22,10222,806,5032,504,0,0,16564
3/10/2018,23,10210,545,4575,473,0,0,15803
3/10/2018,24,10231,320,4354,455,0,0,15360
3/11/2018,1,10227,289,3451,525,0,0,14492
3/11/2018,2,10232,288,3324,500,0,0,14344
3/11/2018,3,10231,288,3271,443,0,0,14233
3/11/2018,4,10230,288,3327,408,0,0,14253
3/11/2018,5,10231,288,3486,366,0,0,14371
3/11/2018,6,10230,287,3779,315,0,0,14611
3/11/2018,7,10234,291,4031,268,1,0,14825
3/11/2018,8,10234,296,4629,184,49,0,15392
3/11/2018,9,10237,371,4801,121,91,0,15621
3/11/2018,10,10185,452,4251,48,111,0,15047
3/11/2018,11,10195,564,4544,107,199,0,15609
3/11/2018,12,10245,691,4378,144,231,0,15689
3/11/2018,13,10248,699,3955,166,227,0,15295
3/11/2018,14,10239,705,4066,295,212,0,15517
3/11/2018,15,10244,715,4095,298,184,0,15536
3/11/2018,16,10257,753,3975,231,124,0,15340
3/11/2018,17,10251,800,4758,244,78,0,16131
3/11/2018,18,10258,874,5089,196,26,0,16443
3/11/2018,19,10257,947,5421,176,1,0,16802
3/11/2018,20,10273,930,5635,131,0,0,16969
3/11/2018,21,10235,681,5604,98,0,0,16618
3/11/2018,22,9551,627,5283,120,0,0,15581
3/11/2018,23,9543,552,4949,115,0,1,15160
3/11/2018,24,9544,523,4564,144,0,0,14775
3/12/2018,1,9544,401,4008,170,0,5,14128
3/12/2018,2,9544,420,3749,157,0,13,13883
3/12/2018,3,9544,785,3550,139,0,15,14033
3/12/2018,4,9551,1287,3409,127,0,29,14403
3/12/2018,5,9542,1805,3115,71,0,30,14563
3/12/2018,6,9546,2070,3963,109,0,35,15723
3/12/2018,7,9544,2194,4968,87,1,40,16834
3/12/2018,8,9547,2108,5121,70,19,42,16907
3/12/2018,9,9543,1989,5216,58,58,41,16905
3/12/2018,10,9547,1956,5256,61,138,43,17001
3/12/2018,11,9551,1797,5223,83,163,40,16857
3/12/2018,12,9552,1788,5121,99,194,39,16793
3/12/2018,13,9554,1710,5135,104,156,37,16696
3/12/2018,14,9553,1832,5020,111,165,43,16724
3/12/2018,15,9556,1813,5049,113,134,41,16706
3/12/2018,16,9550,1924,5128,111,76,42,16831
3/12/2018,17,9554,2212,5125,126,43,42,17102
3/12/2018,18,9557,2196,5194,140,18,38,17143
3/12/2018,19,9559,2411,5595,207,0,31,17803
3/12/2018,20,9556,2234,5676,302,0,28,17796
3/12/2018,21,9553,1989,5394,353,0,27,17316
3/12/2018,22,9544,1443,4915,341,0,27,16270
3/12/2018,23,9536,668,4727,427,0,18,15376
3/12/2018,24,9533,342,4379,519,0,13,14786
3/13/2018,1,9542,369,4110,602,0,10,14633
3/13/2018,2,9539,409,3747,694,0,10,14399
3/13/2018,3,9539,586,3699,855,0,10,14689
3/13/2018,4,9549,994,3849,748,0,10,15150
3/13/2018,5,9549,1587,3308,744,0,12,15200
3/13/2018,6,9551,1769,3950,760,0,19,16049
3/13/2018,7,9550,1878,4668,808,0,26,16930
3/13/2018,8,9542,1816,4787,948,10,26,17129
3/13/2018,9,9543,1655,4813,997,44,27,17079
3/13/2018,10,9546,1562,4844,1172,109,26,17259
3/13/2018,11,9534,1261,4853,1241,113,26,17028
3/13/2018,12,9537,1038,4743,1376,116,27,16837
3/13/2018,13,9544,813,4696,1610,133,30,16826
3/13/2018,14,9548,791,4458,2024,145,46,17012
3/13/2018,15,9551,412,4041,2282,123,82,16491
3/13/2018,16,9550,331,4462,2565,79,135,17122
3/13/2018,17,9548,386,4392,2618,46,135,17125
3/13/2018,18,9543,482,4410,2647,13,136,17231
3/13/2018,19,9547,476,4750,2480,1,136,17390
3/13/2018,20,9545,476,5069,2532,0,139,17761
3/13/2018,21,9546,475,4872,2544,0,140,17577
3/13/2018,22,9543,475,4411,2610,0,142,17181
3/13/2018,23,9535,475,3389,2238,0,118,15755
3/13/2018,24,9534,312,3231,2334,0,32,15443
3/14/2018,1,9541,303,3103,2566,0,10,15523
3/14/2018,2,9552,312,2908,2283,0,10,15065
3/14/2018,3,9556,393,2845,2735,0,10,15539
3/14/2018,4,9550,558,2810,2430,0,11,15359
3/14/2018,5,9552,696,2912,2363,0,14,15537
3/14/2018,6,9555,696,3381,2957,0,25,16614
3/14/2018,7,9556,698,3887,3067,0,32,17240
3/14/2018,8,9549,738,4752,3114,13,52,18218
3/14/2018,9,9549,783,4748,3106,40,91,18317
3/14/2018,10,9549,750,4806,3077,83,138,18403
3/14/2018,11,9545,493,4593,3018,104,141,17894
3/14/2018,12,9546,496,4339,2886,131,145,17543
3/14/2018,13,9549,699,4642,2501,144,143,17678
3/14/2018,14,9548,831,4523,2534,124,145,17705
3/14/2018,15,9546,1062,4271,2319,135,105,17438
3/14/2018,16,9543,1321,4446,2088,108,114,17620
3/14/2018,17,9545,1493,4646,1750,64,128,17626
3/14/2018,18,9543,1514,5321,1433,23,51,17885
3/14/2018,19,9540,1851,5567,1115,2,27,18102
3/14/2018,20,9539,1727,5474,1026,0,27,17793
3/14/2018,21,9534,1488,5161,1329,0,27,17539
3/14/2018,22,9539,1135,4063,1716,0,27,16480
3/14/2018,23,9543,423,3496,1897,0,18,15377
3/14/2018,24,9544,292,3670,1779,0,14,15299
3/15/2018,1,9547,347,4053,1671,0,9,15627
3/15/2018,2,9543,331,3630,1583,0,9,15096
3/15/2018,3,9538,404,3720,1349,0,9,15020
3/15/2018,4,9538,611,3808,1053,0,11,15021
3/15/2018,5,9539,701,3699,962,0,15,14916
3/15/2018,6,9544,699,4215,1098,0,22,15578
3/15/2018,7,9547,700,4945,1335,0,27,16554
3/15/2018,8,9547,699,5003,1543,22,27,16841
3/15/2018,9,9550,709,4543,1843,81,27,16753
3/15/2018,10,9543,728,4283,1873,170,27,16624
3/15/2018,11,9504,407,4316,1452,238,27,15944
3/15/2018,12,9546,355,4828,1574,256,27,16586
3/15/2018,13,9541,407,4628,2019,210,29,16834
3/15/2018,14,9543,554,4204,2309,175,29,16814
3/15/2018,15,9546,821,4263,2387,161,27,17205
3/15/2018,16,9549,909,4471,2395,124,27,17475
3/15/2018,17,9548,896,4857,2202,95,27,17625
3/15/2018,18,9544,893,5143,2384,37,27,18028
3/15/2018,19,9547,892,5028,2421,0,27,17915
3/15/2018,20,9538,891,4478,2631,0,27,17565
3/15/2018,21,9538,892,4193,2851,0,27,17501
3/15/2018,22,9541,732,4010,2988,0,27,17298
3/15/2018,23,9543,710,3718,2743,0,18,16732
3/15/2018,24,9547,372,3026,3128,0,12,16085
3/16/2018,1,9542,328,2672,2636,0,9,15187
3/16/2018,2,9545,349,2702,2550,0,9,15155
3/16/2018,3,9543,446,2686,2680,0,9,15364
3/16/2018,4,9548,578,2697,2699,0,11,15533
3/16/2018,5,9546,700,2836,2790,0,13,15885
3/16/2018,6,9548,703,3218,2998,0,21,16488
3/16/2018,7,9548,771,4846,3001,2,26,18194
3/16/2018,8,9544,744,5056,2805,56,26,18231
3/16/2018,9,9548,710,4949,2679,169,26,18081
3/16/2018,10,9544,706,4952,2355,256,26,17839
3/16/2018,11,9542,381,5114,1892,282,26,17237
3/16/2018,12,9539,403,5182,1588,307,27,17046
3/16/2018,13,9535,410,4798,1515,307,27,16592
3/16/2018,14,9535,587,4591,1598,306,26,16643
3/16/2018,15,9540,833,4185,1643,307,26,16534
3/16/2018,16,9539,904,4193,1157,283,26,16102
3/16/2018,17,9543,891,4381,1565,189,26,16595
3/16/2018,18,9541,889,5118,1543,63,36,17190
3/16/2018,19,9538,1049,5662,1431,3,37,17720
3/16/2018,20,9533,950,5470,1393,0,35,17381
3/16/2018,21,9532,746,5215,1380,0,27,16900
3/16/2018,22,9538,705,4343,1467,0,27,16080
3/16/2018,23,9534,708,3700,1658,0,21,15621
3/16/2018,24,9522,386,3064,1770,0,12,14754
3/17/2018,1,9522,289,2791,1663,0,7,14272
3/17/2018,2,9530,290,3013,1723,0,0,14556
3/17/2018,3,9531,289,3079,1538,0,0,14437
3/17/2018,4,9529,290,2853,1472,0,2,14146
3/17/2018,5,9530,289,2991,1352,0,7,14169
3/17/2018,6,9530,290,3485,1204,0,14,14523
3/17/2018,7,9530,286,3786,1194,4,9,14809
3/17/2018,8,9528,278,4411,1071,79,3,15370
3/17/2018,9,9533,336,4263,802,202,0,15136
3/17/2018,10,9535,468,4064,707,291,0,15065
3/17/2018,11,9529,537,3820,529,322,0,14737
3/17/2018,12,9533,547,3845,573,333,0,14831
3/17/2018,13,9538,707,3521,565,334,0,14665
3/17/2018,14,9535,830,3699,398,329,0,14791
3/17/2018,15,9503,896,3710,353,317,0,14779
3/17/2018,16,9530,724,3825,322,276,0,14677
3/17/2018,17,9528,697,4061,698,192,0,15176
3/17/2018,18,9522,765,5022,684,66,0,16059
3/17/2018,19,9522,1193,5464,617,4,0,16800
3/17/2018,20,9516,1058,5360,510,0,0,16444
3/17/2018,21,9519,1012,5371,369,0,0,16271
3/17/2018,22,9525,981,4879,263,0,0,15648
3/17/2018,23,9513,571,4724,216,0,0,15024
3/17/2018,24,9520,488,4559,184,0,0,14751
3/18/2018,1,9516,372,4214,117,0,0,14219
3/18/2018,2,9520,291,3994,121,0,0,13926
3/18/2018,3,9521,360,3897,196,0,0,13974
3/18/2018,4,9522,405,3899,322,0,0,14148
3/18/2018,5,9525,400,3892,580,0,0,14397
3/18/2018,6,9527,331,3678,1006,0,0,14542
3/18/2018,7,9529,290,3320,1452,8,0,14599
3/18/2018,8,9528,290,3658,1693,73,3,15245
3/18/2018,9,9528,290,3505,1474,171,2,14970
3/18/2018,10,9530,291,3937,1175,251,0,15184
3/18/2018,11,9531,290,3565,1152,305,0,14843
3/18/2018,12,9532,346,3388,928,325,0,14519
3/18/2018,13,9528,383,3341,861,334,0,14447
3/18/2018,14,9537,517,3334,902,335,0,14625
3/18/2018,15,9529,648,3345,1055,330,0,14907
3/18/2018,16,9524,728,3508,529,241,0,14530
3/18/2018,17,9526,768,3943,826,185,0,15248
3/18/2018,18,9532,906,5012,792,67,0,16309
3/18/2018,19,9522,983,5385,787,3,0,16680
3/18/2018,20,9526,947,5456,813,0,0,16742
3/18/2018,21,9521,888,5058,1175,0,0,16642
3/18/2018,22,9530,889,3848,1459,0,0,15726
3/18/2018,23,9529,923,3629,1443,0,0,15524
3/18/2018,24,9527,428,3207,1160,0,0,14322
3/19/2018,1,9527,386,2765,1323,0,0,14001
3/19/2018,2,9523,399,2752,1332,0,11,14017
3/19/2018,3,9530,506,2918,1217,0,11,14182
3/19/2018,4,9500,820,2798,1186,0,11,14315
3/19/2018,5,9527,1251,3334,1231,0,14,15357
3/19/2018,6,9528,2003,4133,1156,0,22,16842
3/19/2018,7,9529,3024,4801,1104,6,41,18505
3/19/2018,8,9524,2433,4991,979,76,42,18045
3/19/2018,9,9524,1953,4643,1022,199,45,17386
3/19/2018,10,9523,1873,4027,740,300,49,16512
3/19/2018,11,9526,1870,3959,522,332,49,16258
3/19/2018,12,9524,1242,4127,710,335,49,15987
3/19/2018,13,9528,1076,4084,706,335,55,15784
3/19/2018,14,9529,966,4530,759,335,94,16213
3/19/2018,15,9529,1125,4186,864,333,181,16218
3/19/2018,16,9532,1469,3977,828,291,190,16287
3/19/2018,17,9534,1327,4044,980,185,181,16251
3/19/2018,18,9541,1420,4157,1190,61,204,16573
3/19/2018,19,9538,1562,5028,1193,4,204,17529
3/19/2018,20,9531,1463,5122,1435,0,202,17753
3/19/2018,21,9529,1267,4573,1695,0,202,17266
3/19/2018,22,9521,602,4334,1823,0,185,16465
3/19/2018,23,9515,482,4079,1735,0,123,15934
3/19/2018,24,9516,371,4271,1664,0,29,15851
3/20/2018,1,9516,308,3678,1786,0,12,15300
3/20/2018,2,9518,321,3453,2056,0,12,15360
3/20/2018,3,9522,438,3289,2281,0,11,15541
3/20/2018,4,9517,778,2719,2438,0,12,15464
3/20/2018,5,9517,1232,2581,2367,0,14,15711
3/20/2018,6,9525,1243,2952,2740,1,19,16480
3/20/2018,7,9526,1242,4125,2892,8,27,17820
3/20/2018,8,9527,1254,4414,2608,84,27,17914
3/20/2018,9,9371,1262,4312,2550,207,27,17729
3/20/2018,10,9354,1332,3973,2297,296,27,17279
3/20/2018,11,9397,621,3684,2261,332,27,16322
3/20/2018,12,9519,518,3451,2473,334,27,16322
3/20/2018,13,9518,690,3434,2418,333,27,16420
3/20/2018,14,9513,793,3364,2349,331,27,16377
3/20/2018,15,9518,867,3385,2420,331,27,16548
3/20/2018,16,9521,1142,3367,2103,284,28,16445
3/20/2018,17,9521,1139,3872,2510,182,32,17256
3/20/2018,18,9524,1145,4249,2365,62,26,17371
3/20/2018,19,9520,1112,4721,2639,4,26,18022
3/20/2018,20,9516,1228,5022,2702,0,26,18494
3/20/2018,21,9511,1080,4442,2684,0,26,17743
3/20/2018,22,9514,434,4122,2715,0,26,16811
3/20/2018,23,9518,291,3139,2676,0,18,15642
3/20/2018,24,9515,277,2951,2755,0,15,15513
3/21/2018,1,9520,264,2864,2872,0,13,15533
3/21/2018,2,9524,289,2925,2902,0,13,15653
3/21/2018,3,9523,468,2685,2392,0,13,15081
3/21/2018,4,9525,861,2657,2545,0,13,15601
3/21/2018,5,9528,1434,2605,2432,0,14,16013
3/21/2018,6,9523,1641,3231,2204,0,20,16619
3/21/2018,7,9525,1789,4381,2361,6,27,18089
3/21/2018,8,9524,1887,4609,2276,62,27,18385
3/21/2018,9,9526,1729,3964,2005,139,27,17390
3/21/2018,10,9523,1599,3972,1424,231,27,16776
3/21/2018,11,9530,878,3949,1731,280,27,16395
3/21/2018,12,9534,752,3750,1885,306,26,16253
3/21/2018,13,9536,751,3563,1932,310,27,16119
3/21/2018,14,9536,761,3524,2275,289,27,16412
3/21/2018,15,9532,525,3703,2630,262,27,16679
3/21/2018,16,9530,772,3920,2589,199,27,17037
3/21/2018,17,9535,940,4217,2418,128,29,17267
3/21/2018,18,9534,1029,4262,2156,49,27,17057
3/21/2018,19,9532,1044,4857,1895,4,27,17359
3/21/2018,20,9525,1051,5064,1953,0,27,17620
3/21/2018,21,9520,1019,4529,2052,0,27,17147
3/21/2018,22,9520,706,3847,2114,0,27,16214
3/21/2018,23,9524,582,3347,2021,0,16,15490
3/21/2018,24,9527,318,3332,1851,0,11,15039
3/22/2018,1,9529,382,2995,1753,0,11,14670
3/22/2018,2,9527,377,2906,1659,0,11,14480
3/22/2018,3,9531,671,3273,1504,0,10,14989
3/22/2018,4,9532,1188,3270,1459,0,10,15459
3/22/2018,5,9535,1433,3034,1372,0,14,15388
3/22/2018,6,9533,1608,3813,1121,0,37,16112
3/22/2018,7,9534,1960,4737,1113,7,86,17437
3/22/2018,8,9534,1709,4753,895,75,161,17127
3/22/2018,9,9536,1642,4665,829,166,201,17039
3/22/2018,10,9538,1222,3971,1138,256,202,16327
3/22/2018,11,9537,836,3797,1313,322,189,15994
3/22/2018,12,9529,667,3810,1736,332,197,16271
3/22/2018,13,9530,669,3560,1749,330,195,16033
3/22/2018,14,9516,680,3487,1770,325,183,15961
3/22/2018,15,9518,793,3506,1566,308,142,15833
3/22/2018,16,9534,844,3780,1962,263,181,16564
3/22/2018,17,9541,940,4424,1925,182,195,17207
3/22/2018,18,9539,1118,4913,1422,66,208,17266
3/22/2018,19,9542,1452,5257,1030,4,207,17492
3/22/2018,20,9535,1678,5176,831,0,213,17433
3/22/2018,21,9528,1516,4947,768,0,203,16962
3/22/2018,22,9529,1259,4387,668,0,173,16016
3/22/2018,23,9534,779,3843,716,0,75,14947
3/22/2018,24,9538,493,3357,792,0,21,14201
3/23/2018,1,9536,513,3151,712,0,11,13923
3/23/2018,2,9692,624,2983,811,0,9,14119
3/23/2018,3,9804,968,2725,869,0,10,14376
3/23/2018,4,9963,1524,2919,878,0,11,15295
3/23/2018,5,9973,1777,3016,712,0,13,15491
3/23/2018,6,9966,1882,3486,649,0,18,16001
3/23/2018,7,10100,2114,3913,1017,9,27,17180
3/23/2018,8,10097,2154,3907,895,87,32,17172
3/23/2018,9,10105,1864,3723,839,188,30,16749
3/23/2018,10,10099,1525,3710,786,264,27,16411
3/23/2018,11,10102,1207,3395,898,318,27,15947
3/23/2018,12,10102,1007,3354,1128,309,27,15927
3/23/2018,13,10100,808,3340,1410,297,27,15982
3/23/2018,14,10105,759,3287,1335,296,27,15809
3/23/2018,15,10111,775,3308,1231,282,27,15734
3/23/2018,16,10086,460,3345,1700,253,27,15871
3/23/2018,17,10102,389,3641,1855,179,27,16193
3/23/2018,18,10123,398,3964,1417,70,27,15999
3/23/2018,19,10121,592,4423,1609,5,27,16777
3/23/2018,20,10218,644,5151,1340,0,27,17380
3/23/2018,21,10252,522,5003,1303,0,27,17107
3/23/2018,22,10261,446,3978,1409,0,27,16121
3/23/2018,23,10264,447,3580,1424,0,18,15733
3/23/2018,24,10264,446,3249,1377,0,5,15341
3/24/2018,1,10270,329,2552,1087,0,0,14238
3/24/2018,2,10264,260,2510,1092,0,0,14126
3/24/2018,3,10264,259,2489,1029,0,0,14041
3/24/2018,4,10261,261,2524,877,0,0,13923
3/24/2018,5,10290,262,2939,1368,0,0,14859
3/24/2018,6,10300,326,3708,1493,0,0,15827
3/24/2018,7,10307,308,4177,1524,9,0,16325
3/24/2018,8,10303,272,4306,1458,94,0,16433
3/24/2018,9,10305,298,4414,1223,222,0,16462
3/24/2018,10,10305,298,4541,844,311,0,16299
3/24/2018,11,10307,271,4180,900,335,0,15993
3/24/2018,12,10309,265,3695,977,336,0,15582
3/24/2018,13,10195,260,3170,1173,336,0,15134
3/24/2018,14,10112,259,2960,1163,335,0,14829
3/24/2018,15,10237,257,3010,1342,325,0,15171
3/24/2018,16,10323,255,3037,907,285,0,14807
3/24/2018,17,10327,255,3073,1232,187,0,15074
3/24/2018,18,10329,258,3433,1561,70,0,15651
3/24/2018,19,10327,260,3654,2222,4,0,16467
3/24/2018,20,10326,259,3979,2595,0,0,17159
3/24/2018,21,10325,260,3696,2340,0,0,16621
3/24/2018,22,10336,261,3063,2133,0,0,15793
3/24/2018,23,10337,261,2775,2263,0,0,15636
3/24/2018,24,10328,267,2591,1845,0,0,15031
3/25/2018,1,10331,264,2510,1960,0,0,15065
3/25/2018,2,10333,263,2499,2065,0,0,15160
3/25/2018,3,10331,263,2436,2053,0,0,15083
3/25/2018,4,10329,264,2507,2037,0,0,15137
3/25/2018,5,10326,264,2717,1947,0,0,15254
3/25/2018,6,10320,262,2859,1887,0,0,15328
3/25/2018,7,10324,262,3625,1826,8,0,16045
3/25/2018,8,10322,262,3780,1575,77,0,16016
3/25/2018,9,10328,262,3572,1198,190,1,15551
3/25/2018,10,10330,261,3284,755,255,0,14885
3/25/2018,11,10335,262,3054,1029,326,0,15006
3/25/2018,12,10333,262,2947,841,302,0,14685
3/25/2018,13,10175,261,2965,1125,332,1,14859
3/25/2018,14,10230,259,2968,1037,328,1,14823
3/25/2018,15,10341,257,2899,1051,311,0,14859
3/25/2018,16,10331,253,3057,1046,265,0,14952
3/25/2018,17,10332,251,3563,1097,179,0,15422
3/25/2018,18,10326,249,3777,1475,73,0,15900
3/25/2018,19,10331,249,4621,1640,5,0,16846
3/25/2018,20,10319,251,4772,1909,0,0,17251
3/25/2018,21,10321,252,4331,2517,0,0,17421
3/25/2018,22,10321,250,3570,2484,0,0,16625
3/25/2018,23,10323,250,3026,2574,0,0,16173
3/25/2018,24,10327,252,2747,2432,0,1,15759
3/26/2018,1,10331,263,2556,2216,0,8,15374
3/26/2018,2,10328,282,2649,2019,0,11,15289
3/26/2018,3,10329,288,2608,2071,0,10,15306
3/26/2018,4,10330,325,2646,2095,0,11,15407
3/26/2018,5,10333,436,2668,1826,0,13,15276
3/26/2018,6,10326,443,3038,2481,0,21,16309
3/26/2018,7,10328,527,4017,2721,14,26,17633
3/26/2018,8,10323,482,4060,2424,95,26,17410
3/26/2018,9,10335,439,4089,2105,213,27,17208
3/26/2018,10,10333,440,3795,1808,305,26,16707
3/26/2018,11,10335,274,3353,1956,331,27,16276
3/26/2018,12,10331,251,3224,2414,333,26,16579
3/26/2018,13,10333,252,3265,2199,334,27,16410
3/26/2018,14,10326,249,3222,2033,334,27,16191
3/26/2018,15,10324,248,3172,2075,327,0,16146
3/26/2018,16,10327,248,3184,2391,268,0,16418
3/26/2018,17,10330,248,3763,2767,154,0,17262
3/26/2018,18,10334,249,3974,2496,50,0,17103
3/26/2018,19,10337,249,3940,2753,4,0,17283
3/26/2018,20,10331,251,3970,2912,0,0,17464
3/26/2018,21,10321,252,3641,3022,0,0,17236
3/26/2018,22,10316,251,3196,2839,0,27,16629
3/26/2018,23,10316,251,2857,2697,0,21,16142
3/26/2018,24,10312,251,2672,2402,0,13,15650
3/27/2018,1,10316,251,2578,1854,0,11,15010
3/27/2018,2,10305,250,2589,1704,0,11,14859
3/27/2018,3,10309,252,2573,1647,0,11,14792
3/27/2018,4,10311,279,2584,1531,0,10,14715
3/27/2018,5,10310,280,2723,1973,0,8,15294
3/27/2018,6,10319,297,2940,2413,0,8,15977
3/27/2018,7,10322,364,4133,2907,4,12,17742
3/27/2018,8,10322,397,4334,2997,29,25,18104
3/27/2018,9,10322,415,3928,3005,49,26,17745
3/27/2018,10,10321,433,3974,3015,52,26,17821
3/27/2018,11,10315,556,4113,3131,52,27,18194
3/27/2018,12,10318,774,3890,3069,52,27,18130
3/27/2018,13,10321,855,3920,3135,66,27,18324
3/27/2018,14,10319,868,3910,2970,47,28,18142
3/27/2018,15,10316,719,3688,3038,32,27,17820
3/27/2018,16,10317,920,3910,3033,20,27,18227
3/27/2018,17,10322,932,3842,2816,12,26,17950
3/27/2018,18,10332,1051,4356,2427,3,27,18196
3/27/2018,19,10326,977,4737,2392,0,27,18459
3/27/2018,20,10313,718,4181,2237,0,27,17476
3/27/2018,21,10322,663,4031,2196,0,27,17239
3/27/2018,22,10315,686,3819,2305,0,27,17152
3/27/2018,23,10315,578,3005,2023,0,20,15941
3/27/2018,24,10318,306,2786,1881,0,12,15303
3/28/2018,1,10322,307,2669,1322,0,11,14631
3/28/2018,2,10323,342,2651,1366,0,10,14692
3/28/2018,3,10324,441,2560,864,0,10,14199
3/28/2018,4,10322,1072,2583,426,0,10,14413
3/28/2018,5,10320,1355,2877,416,0,13,14981
3/28/2018,6,10320,1740,3411,474,0,36,15981
3/28/2018,7,10327,2117,4231,381,2,75,17133
3/28/2018,8,10321,1766,4655,231,22,151,17146
3/28/2018,9,10320,1527,4705,242,40,191,17025
3/28/2018,10,10166,1276,4645,268,85,202,16642
3/28/2018,11,10310,1204,4328,227,119,202,16390
3/28/2018,12,10318,1536,4256,249,123,202,16684
3/28/2018,13,10323,1483,3892,277,135,204,16314
3/28/2018,14,10330,1334,3384,236,148,196,15628
3/28/2018,15,10325,1488,3262,182,132,180,15569
3/28/2018,16,10331,1495,3762,174,110,190,16062
3/28/2018,17,10335,1544,4342,122,81,201,16625
3/28/2018,18,10319,1461,4286,112,34,126,16338
3/28/2018,19,10333,1449,4737,182,3,107,16811
3/28/2018,20,10320,1424,4992,274,0,181,17191
3/28/2018,21,10317,1187,4668,347,0,164,16683
3/28/2018,22,10319,843,4074,384,0,63,15683
3/28/2018,23,10328,693,3411,415,0,28,14875
3/28/2018,24,10323,345,3046,462,0,23,14199
3/29/2018,1,10325,275,2873,366,0,25,13864
3/29/2018,2,10334,302,2929,313,0,23,13901
3/29/2018,3,10335,443,2780,237,0,13,13808
3/29/2018,4,10337,743,2836,221,0,16,14153
3/29/2018,5,10335,938,2800,198,0,34,14305
3/29/2018,6,10336,1301,3676,208,0,60,15581
3/29/2018,7,10344,1335,4602,327,4,68,16680
3/29/2018,8,10335,1398,4686,296,16,62,16793
3/29/2018,9,10331,1367,4624,313,34,59,16728
3/29/2018,10,10334,1338,4645,385,39,61,16802
3/29/2018,11,10330,1076,5025,329,70,64,16894
3/29/2018,12,10338,757,4800,579,64,69,16607
3/29/2018,13,10334,535,3954,1282,50,68,16223
3/29/2018,14,10328,473,3543,1469,46,70,15929
3/29/2018,15,10332,451,3801,1575,38,65,16262
3/29/2018,16,10329,494,3929,1840,31,68,16691
3/29/2018,17,10331,691,3640,1885,17,63,16627
3/29/2018,18,10329,785,3738,1620,9,64,16545
3/29/2018,19,10329,725,3975,1858,1,63,16951
3/29/2018,20,10321,651,4017,1954,0,60,17003
3/29/2018,21,9786,657,4160,1956,0,47,16606
3/29/2018,22,9450,861,3901,2037,0,48,16297
3/29/2018,23,9449,433,3073,1946,0,38,14939
3/29/2018,24,9454,408,2909,1711,0,24,14506
3/30/2018,1,9458,248,2548,1696,0,5,13955
3/30/2018,2,9456,203,2523,1685,0,9,13876
3/30/2018,3,9462,203,2468,1858,0,9,14000
3/30/2018,4,9477,203,2482,1847,0,0,14009
3/30/2018,5,9473,203,2639,2007,0,0,14322
3/30/2018,6,9468,204,2679,2328,0,0,14679
3/30/2018,7,9470,202,3096,2295,5,0,15068
3/30/2018,8,9464,202,3218,2183,41,0,15108
3/30/2018,9,9464,201,3193,1788,116,0,14762
3/30/2018,10,9459,201,3512,1770,153,0,15095
3/30/2018,11,9461,164,3472,1570,190,0,14857
3/30/2018,12,9461,200,3290,1359,199,0,14509
3/30/2018,13,9455,201,3368,1233,236,0,14493
3/30/2018,14,9459,200,2927,1109,228,0,13923
3/30/2018,15,9451,201,2956,941,201,0,13750
3/30/2018,16,9458,201,3419,819,181,0,14078
3/30/2018,17,9460,200,3774,681,131,3,14249
3/30/2018,18,9462,199,4334,506,59,3,14563
3/30/2018,19,9462,200,4591,391,6,7,14657
3/30/2018,20,9463,201,5047,388,0,8,15107
3/30/2018,21,9456,224,4707,533,0,6,14926
3/30/2018,22,9455,203,4319,798,0,7,14782
3/30/2018,23,9456,202,3647,1066,0,10,14381
3/30/2018,24,9461,202,3373,1394,0,12,14442
3/31/2018,1,9463,201,2885,1354,0,6,13909
3/31/2018,2,9462,201,2939,1588,0,5,14195
3/31/2018,3,9465,201,3001,2001,0,7,14675
3/31/2018,4,9469,226,2773,2058,0,5,14531
3/31/2018,5,9472,230,2838,2118,0,0,14658
3/31/2018,6,9476,231,2891,1927,0,0,14525
3/31/2018,7,9471,231,3275,1977,10,0,14964
3/31/2018,8,9466,231,3357,2031,80,0,15165
3/31/2018,9,9471,247,3613,2134,174,0,15639
3/31/2018,10,9469,257,3615,1804,274,0,15419
3/31/2018,11,9470,287,3651,1820,275,0,15503
3/31/2018,12,9469,272,3186,2252,279,0,15458
3/31/2018,13,9472,254,3096,2332,243,0,15397
3/31/2018,14,9464,248,3123,2485,200,0,15520
3/31/2018,15,9464,246,3009,3277,122,0,16118
3/31/2018,16,9459,246,3249,3757,50,0,16761
3/31/2018,17,9457,249,3556,3936,24,0,17222
3/31/2018,18,9468,247,3393,3840,7,0,16955
3/31/2018,19,9467,246,3698,3705,1,0,17117
3/31/2018,20,9461,246,3824,3515,0,0,17046
3/31/2018,21,9455,246,3387,3291,0,0,16379
3/31/2018,22,9461,218,3203,2808,0,0,15690
3/31/2018,23,9463,216,2740,2661,0,1,15081
3/31/2018,24,9452,216,2631,2067,0,1,14367
4/1/2018,1,9460,216,2480,1834,0,7,13997
4/1/2018,2,9458,217,2474,1617,0,9,13775
4/1/2018,3,9457,217,2532,1609,0,10,13825
4/1/2018,4,9454,217,2585,1969,0,8,14233
4/1/2018,5,9450,217,2832,1940,0,8,14447
4/1/2018,6,9449,216,3329,1609,0,0,14603
4/1/2018,7,9453,216,3048,1572,11,0,14300
4/1/2018,8,9451,216,3207,1339,83,0,14296
4/1/2018,9,9446,216,3238,1207,175,0,14282
4/1/2018,10,9453,216,3342,1054,227,0,14292
4/1/2018,11,9457,216,3860,1339,259,0,15131
4/1/2018,12,9457,217,3428,1255,260,1,14618
4/1/2018,13,9455,217,3254,1250,261,1,14438
4/1/2018,14,9458,217,3105,1193,262,0,14235
4/1/2018,15,9413,216,3471,1243,231,0,14574
4/1/2018,16,9437,216,3581,1209,167,0,14610
4/1/2018,17,9456,216,4155,1017,103,0,14947
4/1/2018,18,9454,217,4285,892,46,0,14894
4/1/2018,19,9456,242,4854,606,6,2,15166
4/1/2018,20,9452,507,5231,485,0,7,15682
4/1/2018,21,9454,515,4515,406,0,4,14894
4/1/2018,22,9453,345,4499,440,0,0,14737
4/1/2018,23,9454,218,4049,545,0,0,14266
4/1/2018,24,9455,230,3865,700,0,0,14250
4/2/2018,1,9425,315,3077,924,0,0,13741
4/2/2018,2,9456,341,3179,1003,0,7,13986
4/2/2018,3,9454,454,3307,883,0,14,14112
4/2/2018,4,9459,691,3107,701,0,14,13972
4/2/2018,5,9458,1172,3175,497,0,15,14317
4/2/2018,6,9471,1544,4021,365,0,25,15426
4/2/2018,7,9470,1532,4731,289,17,30,16069
4/2/2018,8,9472,1685,4817,231,89,31,16325
4/2/2018,9,9474,1504,4321,239,192,31,15761
4/2/2018,10,9470,1293,4385,365,278,30,15821
4/2/2018,11,9470,1090,4590,478,263,30,15921
4/2/2018,12,9465,1202,4443,571,278,31,15990
4/2/2018,13,9471,1166,4257,733,284,31,15942
4/2/2018,14,9474,1269,3871,751,286,30,15681
4/2/2018,15,9466,1356,3697,849,271,31,15670
4/2/2018,16,9468,1518,3550,735,240,31,15542
4/2/2018,17,9470,1656,4194,491,160,31,16002
4/2/2018,18,9469,1817,4159,308,57,31,15841
4/2/2018,19,9467,1876,5034,203,7,26,16613
4/2/2018,20,9461,2029,5400,180,0,22,17092
4/2/2018,21,9457,1572,4964,346,0,31,16370
4/2/2018,22,9455,1331,4097,411,0,31,15325
4/2/2018,23,9457,910,3417,327,0,22,14133
4/2/2018,24,9459,331,3375,431,0,17,13613
4/3/2018,1,9467,285,3265,406,0,17,13440
4/3/2018,2,9463,280,2897,641,0,16,13297
4/3/2018,3,9460,395,2798,678,0,17,13348
4/3/2018,4,9464,644,2684,808,0,16,13616
4/3/2018,5,9464,1086,2551,1052,0,19,14172
4/3/2018,6,9469,1265,3547,1290,0,29,15600
4/3/2018,7,9470,1540,4496,1149,8,33,16696
4/3/2018,8,9471,1775,4844,921,35,41,17087
4/3/2018,9,9470,1596,4672,1116,83,40,16977
4/3/2018,10,9470,1288,4356,1311,111,41,16577
4/3/2018,11,9469,1096,3833,1664,108,38,16208
4/3/2018,12,9469,1048,3692,1753,117,31,16110
4/3/2018,13,9468,895,4122,1611,109,31,16236
4/3/2018,14,9465,1153,4340,1546,86,31,16621
4/3/2018,15,9465,997,4138,1767,69,31,16467
4/3/2018,16,9466,1026,4035,2299,59,31,16916
4/3/2018,17,9463,1045,4086,2546,32,31,17203
4/3/2018,18,9462,1060,4549,2451,11,31,17564
4/3/2018,19,9452,1194,4953,2238,1,31,17869
4/3/2018,20,9434,1276,4999,1756,0,31,17496
4/3/2018,21,9420,1429,4579,1303,0,31,16762
4/3/2018,22,9418,873,4123,1240,0,31,15685
4/3/2018,23,9422,855,3746,1204,0,21,15248
4/3/2018,24,9427,362,3094,1698,0,16,14597
4/4/2018,1,9429,304,2932,1426,0,15,14106
4/4/2018,2,9448,305,2724,1881,0,15,14373
4/4/2018,3,9465,307,2414,1809,0,15,14010
4/4/2018,4,9461,306,2568,1734,0,17,14086
4/4/2018,5,9462,306,2485,2402,0,21,14676
4/4/2018,6,9463,305,2976,2669,0,41,15454
4/4/2018,7,9468,374,3645,3444,1,41,16973
4/4/2018,8,9467,348,3916,3614,20,45,17410
4/4/2018,9,9463,307,4252,3584,47,42,17695
4/4/2018,10,9457,307,3891,3673,88,47,17463
4/4/2018,11,9453,307,3762,3681,119,50,17372
4/4/2018,12,9455,308,3759,3423,171,50,17166
4/4/2018,13,9449,318,3880,2841,182,52,16722
4/4/2018,14,9452,354,3858,2908,159,48,16779
4/4/2018,15,9450,445,3795,3226,136,45,17097
4/4/2018,16,9452,659,3856,3507,120,50,17644
4/4/2018,17,9457,982,3965,3448,89,48,17989
4/4/2018,18,9457,997,4012,3002,44,46,17558
4/4/2018,19,9456,987,4259,3469,6,37,18214
4/4/2018,20,9449,994,4499,3686,0,31,18659
4/4/2018,21,9441,989,4202,3719,0,31,18382
4/4/2018,22,9439,907,4089,3478,0,30,17943
4/4/2018,23,9440,397,3492,3225,0,22,16576
4/4/2018,24,9448,293,2988,2816,0,17,15562
4/5/2018,1,9450,316,2879,2554,0,18,15217
4/5/2018,2,9454,355,3164,2133,0,16,15122
4/5/2018,3,9460,699,3442,1852,0,16,15469
4/5/2018,4,9463,1210,3071,1467,0,16,15227
4/5/2018,5,9449,1664,3612,1138,0,19,15882
4/5/2018,6,9462,2381,4491,1017,0,43,17394
4/5/2018,7,9464,3029,4618,971,19,90,18191
4/5/2018,8,9466,2599,4295,925,107,173,17565
4/5/2018,9,9465,2173,3884,1179,184,149,17034
4/5/2018,10,9466,1826,3669,1538,241,90,16830
4/5/2018,11,9469,1313,3537,1665,241,115,16340
4/5/2018,12,9471,1060,3760,1625,279,195,16390
4/5/2018,13,9471,1211,3743,1424,298,202,16349
4/5/2018,14,9464,1205,3858,1208,285,202,16222
4/5/2018,15,9459,1321,3450,1166,266,203,15865
4/5/2018,16,9457,1739,3411,1354,200,202,16363
4/5/2018,17,9457,1775,3679,1378,122,196,16607
4/5/2018,18,9457,1930,3814,1301,45,110,16657
4/5/2018,19,9456,2004,4595,996,6,116,17173
4/5/2018,20,9447,2661,4705,923,0,194,17930
4/5/2018,21,9445,2239,4326,1037,0,204,17251
4/5/2018,22,9445,1433,4303,950,0,196,16327
4/5/2018,23,9450,1056,3937,1018,0,180,15641
4/5/2018,24,9451,739,3263,1307,0,98,14858
4/6/2018,1,9459,623,2931,1429,0,68,14510
4/6/2018,2,9461,543,3253,1216,0,67,14540
4/6/2018,3,9460,609,3130,1060,0,68,14327
4/6/2018,4,9459,806,3269,855,0,71,14460
4/6/2018,5,9456,1038,3202,811,0,70,14577
4/6/2018,6,9454,1623,4051,787,0,79,15994
4/6/2018,7,9457,2077,4482,1001,12,102,17131
4/6/2018,8,9453,2122,4618,1066,40,109,17408
4/6/2018,9,9454,2180,4545,1262,76,146,17663
4/6/2018,10,9454,1692,4327,1779,101,163,17516
4/6/2018,11,9452,1374,4119,2159,95,97,17296
4/6/2018,12,9455,979,4024,2752,103,99,17412
4/6/2018,13,9449,809,4034,3234,138,135,17799
4/6/2018,14,9447,715,3375,3606,141,87,17371
4/6/2018,15,9452,669,3401,3682,109,44,17357
4/6/2018,16,9453,515,3457,3717,64,31,17237
4/6/2018,17,9455,523,3520,3653,50,31,17232
4/6/2018,18,9453,523,3631,3703,29,31,17370
4/6/2018,19,9451,563,3674,3597,5,31,17321
4/6/2018,20,9444,696,4171,3758,0,31,18100
4/6/2018,21,9450,703,3830,3651,0,31,17665
4/6/2018,22,9448,540,3481,3453,0,31,16953
4/6/2018,23,9457,494,2759,3105,0,18,15833
4/6/2018,24,9448,352,2643,2885,0,0,15328
4/7/2018,1,9458,277,2538,2980,0,0,15253
4/7/2018,2,9461,276,2590,2861,0,0,15188
4/7/2018,3,9469,277,2651,2468,0,0,14865
4/7/2018,4,9461,280,2773,2262,0,0,14776
4/7/2018,5,9457,351,3697,2037,0,0,15542
4/7/2018,6,9459,479,3785,1686,0,0,15409
4/7/2018,7,9461,510,3553,1553,18,0,15095
4/7/2018,8,9460,495,3621,1439,83,0,15098
4/7/2018,9,9460,491,3826,1504,162,0,15443
4/7/2018,10,9454,511,3767,1300,225,0,15257
4/7/2018,11,9460,583,4236,1143,240,0,15662
4/7/2018,12,9461,537,3824,1132,229,0,15183
4/7/2018,13,9462,393,3596,1232,229,0,14912
4/7/2018,14,9455,386,3383,1346,219,0,14789
4/7/2018,15,9453,435,3828,1392,199,0,15307
4/7/2018,16,9453,541,3991,1447,151,0,15583
4/7/2018,17,9456,808,4288,1369,93,0,16014
4/7/2018,18,9455,1293,4622,1195,35,0,16600
4/7/2018,19,9463,1324,4419,1080,6,0,16292
4/7/2018,20,9459,1194,4664,987,0,0,16304
4/7/2018,21,9453,1132,4809,817,0,0,16211
4/7/2018,22,9454,1128,4177,721,0,0,15480
4/7/2018,23,9456,1179,3623,745,0,0,15003
4/7/2018,24,9453,1061,3315,801,0,0,14630
4/8/2018,1,9451,518,2915,824,0,0,13708
4/8/2018,2,9453,388,3314,843,0,0,13998
4/8/2018,3,9452,368,3188,984,0,0,13992
4/8/2018,4,9461,338,2873,1247,0,0,13919
4/8/2018,5,9463,337,2662,1105,0,0,13567
4/8/2018,6,9464,337,3059,1131,0,0,13991
4/8/2018,7,9463,358,3644,943,11,0,14419
4/8/2018,8,9461,459,3889,895,58,0,14762
4/8/2018,9,9461,422,3718,930,182,0,14713
4/8/2018,10,9320,350,3893,806,203,0,14572
4/8/2018,11,9288,423,4026,983,222,1,14943
4/8/2018,12,9297,494,3814,1079,223,1,14908
4/8/2018,13,9443,653,3517,1123,221,0,14957
4/8/2018,14,9417,853,3492,1136,227,0,15125
4/8/2018,15,9457,1083,3422,1004,197,0,15163
4/8/2018,16,9452,1134,3357,773,180,0,14896
4/8/2018,17,9452,1132,3797,667,157,0,15205
4/8/2018,18,9459,1150,4469,506,65,0,15649
4/8/2018,19,9455,1168,4844,397,9,0,15873
4/8/2018,20,9447,1413,5058,394,0,0,16312
4/8/2018,21,9449,1368,4841,327,0,0,15985
4/8/2018,22,9449,1206,4363,266,0,0,15284
4/8/2018,23,9451,1077,4003,279,0,0,14810
4/8/2018,24,9458,1322,3426,336,0,1,14543
4/9/2018,1,9457,1388,3224,325,0,15,14409
4/9/2018,2,9463,1160,3280,277,0,15,14195
4/9/2018,3,9462,1355,3296,170,0,13,14296
4/9/2018,4,9467,1444,3345,116,0,14,14386
4/9/2018,5,9462,1621,3189,110,0,15,14397
4/9/2018,6,9452,1970,3689,117,1,25,15254
4/9/2018,7,9453,2416,4292,103,20,34,16318
4/9/2018,8,9453,2503,4293,76,92,39,16456
4/9/2018,9,9454,2197,4142,67,184,44,16088
4/9/2018,10,9451,1871,4268,33,250,45,15918
4/9/2018,11,9454,1732,4099,17,252,58,15612
4/9/2018,12,9455,1515,3985,32,241,92,15320
4/9/2018,13,9313,1514,3885,41,216,165,15134
4/9/2018,14,9302,1536,3723,71,201,210,15043
4/9/2018,15,9449,1533,3501,142,220,210,15055
4/9/2018,16,9451,1700,3809,135,182,209,15486
4/9/2018,17,9453,1958,4103,113,107,209,15943
4/9/2018,18,9454,1985,4342,71,50,211,16113
4/9/2018,19,9453,1799,5091,67,9,211,16630
4/9/2018,20,9450,1845,5008,66,0,211,16580
4/9/2018,21,9442,1626,4951,56,0,208,16283
4/9/2018,22,9437,1729,4209,72,0,197,15644
4/9/2018,23,9443,1287,3639,131,0,169,14669
4/9/2018,24,9443,1055,3410,169,0,154,14231
4/10/2018,1,9441,939,3268,235,0,104,13987
4/10/2018,2,9449,884,3315,255,0,102,14005
4/10/2018,3,9451,953,3248,250,0,98,14000
4/10/2018,4,9453,1160,3051,276,0,82,14022
4/10/2018,5,9449,1306,3043,310,0,112,14220
4/10/2018,6,9452,1504,3770,328,0,193,15247
4/10/2018,7,9449,2406,4423,310,23,202,16813
4/10/2018,8,9448,2392,4432,203,102,201,16778
4/10/2018,9,9445,2135,4049,124,175,203,16131
4/10/2018,10,9449,1912,3916,184,242,202,15905
4/10/2018,11,9450,1683,3941,283,190,201,15748
4/10/2018,12,9439,1805,3974,419,155,201,15993
4/10/2018,13,9440,1398,3785,537,173,202,15535
4/10/2018,14,9444,1137,3464,694,183,209,15131
4/10/2018,15,9447,1199,3481,736,183,209,15255
4/10/2018,16,9445,1371,3728,749,140,208,15641
4/10/2018,17,9445,1614,3594,884,112,208,15857
4/10/2018,18,9440,1642,3800,1022,59,206,16169
4/10/2018,19,9437,1751,4388,1022,9,212,16819
4/10/2018,20,9432,1770,4591,1259,0,215,17267
4/10/2018,21,9426,1493,3623,1519,0,233,16294
4/10/2018,22,9427,1368,3027,1669,0,167,15658
4/10/2018,23,9417,850,2911,1907,0,49,15134
4/10/2018,24,9421,557,3072,1872,0,26,14948
4/11/2018,1,9424,475,2493,1492,0,29,13913
4/11/2018,2,9429,495,2550,1240,0,31,13745
4/11/2018,3,9426,628,2484,1421,0,31,13990
4/11/2018,4,9425,910,2502,1206,0,30,14073
4/11/2018,5,9388,955,2955,1627,0,44,14969
4/11/2018,6,9362,968,3530,1740,0,54,15654
4/11/2018,7,9359,1244,3897,1933,20,60,16513
4/11/2018,8,9353,1214,3847,2118,85,62,16679
4/11/2018,9,9353,1052,3104,2484,157,65,16215
4/11/2018,10,9356,662,2933,2629,207,65,15852
4/11/2018,11,9359,587,3504,2746,203,62,16461
4/11/2018,12,9358,578,3519,2802,245,58,16560
4/11/2018,13,9361,691,2920,2822,193,53,16040
4/11/2018,14,9354,1008,3224,2623,147,72,16428
4/11/2018,15,9356,1798,3592,2005,112,106,16969
4/11/2018,16,9377,2365,3494,1586,75,132,17029
4/11/2018,17,9384,2007,3693,1308,83,162,16637
4/11/2018,18,9438,1784,3509,1161,36,165,16093
4/11/2018,19,9444,1664,4096,919,8,213,16344
4/11/2018,20,9439,2147,4444,673,0,238,16941
4/11/2018,21,9436,1837,4224,585,0,217,16299
4/11/2018,22,9443,1316,3826,497,0,152,15234
4/11/2018,23,9445,847,3746,611,0,66,14715
4/11/2018,24,9451,522,3495,710,0,43,14221
4/12/2018,1,9451,395,3084,741,0,34,13705
4/12/2018,2,9450,493,2966,841,0,28,13778
4/12/2018,3,9451,560,3134,895,0,28,14068
4/12/2018,4,9445,569,3059,1115,0,28,14216
4/12/2018,5,9455,704,2708,1300,0,32,14199
4/12/2018,6,9447,756,3158,1939,0,37,15337
4/12/2018,7,9453,746,3694,2564,14,43,16514
4/12/2018,8,9453,757,3656,2785,45,41,16737
4/12/2018,9,9451,752,3504,2958,80,35,16780
4/12/2018,10,9459,586,3307,3081,97,29,16559
4/12/2018,11,9454,579,3386,3246,129,27,16821
4/12/2018,12,9450,422,3354,3302,169,27,16724
4/12/2018,13,9447,351,3020,3384,157,27,16386
4/12/2018,14,9443,320,3203,3356,141,27,16490
4/12/2018,15,9450,305,3208,3288,115,27,16393
4/12/2018,16,9448,294,3251,3366,111,27,16497
4/12/2018,17,9450,289,3410,3374,73,27,16623
4/12/2018,18,9449,290,3671,3373,37,27,16847
4/12/2018,19,9450,289,4296,3045,8,27,17115
4/12/2018,20,9449,368,4554,2457,0,27,16855
4/12/2018,21,9444,337,3788,2223,0,27,15819
4/12/2018,22,9449,306,3421,2038,0,27,15241
4/12/2018,23,9449,315,3289,1687,0,20,14760
4/12/2018,24,9454,320,3336,1057,0,13,14180
4/13/2018,1,9445,447,3331,708,0,11,13942
4/13/2018,2,9439,523,3174,477,0,12,13625
4/13/2018,3,9451,537,2909,463,0,12,13372
4/13/2018,4,9456,831,2451,292,0,11,13041
4/13/2018,5,9459,1083,2561,301,0,14,13418
4/13/2018,6,9456,1157,3270,510,1,23,14417
4/13/2018,7,9457,1411,3911,548,12,27,15366
4/13/2018,8,9453,1421,4082,528,38,26,15548
4/13/2018,9,9450,1421,3951,735,80,26,15663
4/13/2018,10,9450,1362,3314,929,171,27,15253
4/13/2018,11,9455,1128,3475,965,176,27,15226
4/13/2018,12,9451,937,3639,1033,162,14,15236
4/13/2018,13,9291,957,3720,1003,161,20,15152
4/13/2018,14,9313,998,3687,1011,108,23,15140
4/13/2018,15,9452,1162,3822,900,67,33,15436
4/13/2018,16,9445,1306,3692,1308,50,36,15837
4/13/2018,17,9442,1216,3501,1523,49,27,15758
4/13/2018,18,9445,1176,3675,1529,20,26,15871
4/13/2018,19,9441,1210,3951,1211,5,26,15844
4/13/2018,20,9434,1215,4023,1220,0,26,15918
4/13/2018,21,9428,1173,3407,1535,0,26,15569
4/13/2018,22,9438,831,3242,1578,0,26,15115
4/13/2018,23,9438,773,3116,1434,0,11,14772
4/13/2018,24,9441,789,2920,1505,0,0,14655
4/14/2018,1,9440,580,2586,1690,0,0,14296
4/14/2018,2,9435,374,2478,2143,0,0,14430
4/14/2018,3,9437,425,2456,1909,0,1,14228
4/14/2018,4,9445,434,2557,1911,0,2,14349
4/14/2018,5,9437,443,2617,2136,0,6,14639
4/14/2018,6,9439,441,2737,2521,0,0,15138
4/14/2018,7,9441,456,2748,2917,5,0,15567
4/14/2018,8,9445,462,2993,3332,24,0,16256
4/14/2018,9,9442,463,3130,3668,45,0,16748
4/14/2018,10,9445,463,3666,3562,71,0,17207
4/14/2018,11,9445,472,3751,3468,99,0,17235
4/14/2018,12,9445,485,3806,3296,100,0,17132
4/14/2018,13,9445,467,3226,3313,86,0,16537
4/14/2018,14,9449,459,3075,3233,83,0,16299
4/14/2018,15,9415,459,3223,3128,67,0,16292
4/14/2018,16,9447,481,3743,3105,59,0,16835
4/14/2018,17,9443,548,3720,2889,43,0,16643
4/14/2018,18,9440,571,4002,2669,18,0,16700
4/14/2018,19,9437,539,3730,2759,4,0,16469
4/14/2018,20,9432,464,4123,2544,0,0,16563
4/14/2018,21,9431,478,4556,2341,0,0,16806
4/14/2018,22,9426,478,3548,2332,0,1,15785
4/14/2018,23,9425,449,3002,2364,0,0,15240
4/14/2018,24,9433,445,2702,2176,0,0,14756
4/15/2018,1,9434,446,2633,2235,0,0,14748
4/15/2018,2,9439,447,2402,2253,0,0,14541
4/15/2018,3,9439,449,2382,2344,0,0,14614
4/15/2018,4,9442,445,2462,1891,0,0,14240
4/15/2018,5,9439,447,2550,1838,0,0,14274
4/15/2018,6,9442,446,3050,1902,0,0,14840
4/15/2018,7,9450,457,3183,2033,8,0,15131
4/15/2018,8,9451,498,3305,2262,30,0,15546
4/15/2018,9,9451,532,3297,2506,49,0,15835
4/15/2018,10,9449,527,3178,2596,64,0,15814
4/15/2018,11,9445,507,3398,2822,84,0,16256
4/15/2018,12,9441,516,3613,3018,81,0,16669
4/15/2018,13,9445,535,3680,3151,68,0,16879
4/15/2018,14,9447,569,3469,3189,59,0,16733
4/15/2018,15,9449,593,3612,3148,51,0,16853
4/15/2018,16,9447,828,4168,2885,41,0,17369
4/15/2018,17,9451,1491,4494,2140,25,0,17601
4/15/2018,18,9464,1627,3892,2145,10,0,17138
4/15/2018,19,9459,1750,4131,2321,1,0,17662
4/15/2018,20,9460,1443,3920,2382,0,4,17209
4/15/2018,21,9426,1203,3684,2376,0,9,16698
4/15/2018,22,9404,945,3711,1891,0,28,15979
4/15/2018,23,9413,1089,3350,1447,0,51,15350
4/15/2018,24,9407,1064,3073,1391,0,51,14986
4/16/2018,1,9408,803,2766,1163,0,51,14191
4/16/2018,2,9405,794,2966,965,0,51,14181
4/16/2018,3,9413,851,2943,762,0,51,14020
4/16/2018,4,9413,1028,3266,755,0,52,14514
4/16/2018,5,9420,1307,2829,846,0,66,14468
4/16/2018,6,9420,1538,2984,813,0,74,14829
4/16/2018,7,9419,1565,3733,1097,1,79,15894
4/16/2018,8,9418,1613,3629,1480,7,78,16225
4/16/2018,9,9422,1947,4260,1512,26,78,17245
4/16/2018,10,9422,2490,4151,1618,42,78,17801
4/16/2018,11,9416,2379,4020,1952,65,78,17910
4/16/2018,12,9421,2136,3763,2087,63,78,17548
4/16/2018,13,9415,2181,3514,2335,54,110,17609
4/16/2018,14,9419,2036,3520,2279,59,130,17443
4/16/2018,15,9429,1849,3359,2359,47,130,17173
4/16/2018,16,9462,1710,3263,2586,41,100,17162
4/16/2018,17,9466,1718,3541,2788,25,125,17663
4/16/2018,18,9467,1630,3818,2796,11,127,17849
4/16/2018,19,9467,1630,4198,2754,2,124,18175
4/16/2018,20,9468,1839,4212,2715,0,127,18361
4/16/2018,21,9453,1606,3697,2820,0,112,17688
4/16/2018,22,9450,810,3148,2951,0,79,16438
4/16/2018,23,9451,526,2581,2521,0,24,15103
4/16/2018,24,9458,384,2656,2267,0,11,14776
4/17/2018,1,9453,359,2425,2762,0,11,15010
4/17/2018,2,9459,354,2461,2531,0,13,14818
4/17/2018,3,9457,315,2498,2536,0,14,14820
4/17/2018,4,9456,397,2449,2458,0,12,14772
4/17/2018,5,9451,640,2561,2480,0,14,15146
4/17/2018,6,9457,880,2831,2530,0,22,15720
4/17/2018,7,9462,1201,4014,2562,10,27,17276
4/17/2018,8,9462,1310,4414,2389,37,27,17639
4/17/2018,9,9460,1260,3872,2645,87,27,17351
4/17/2018,10,9457,1393,3382,2802,74,28,17136
4/17/2018,11,9455,1394,3509,2932,105,50,17445
4/17/2018,12,9459,1242,3397,3035,94,84,17311
4/17/2018,13,9462,1050,3024,2970,150,100,16756
4/17/2018,14,9458,1027,3016,3041,163,105,16810
4/17/2018,15,9453,1029,3078,2923,145,85,16713
4/17/2018,16,9459,1061,3271,3090,122,84,17087
4/17/2018,17,9459,1222,3872,2825,66,84,17528
4/17/2018,18,9462,1544,4051,2584,33,85,17759
4/17/2018,19,9460,1438,4444,2526,4,134,18006
4/17/2018,20,9459,1720,4510,2404,0,197,18290
4/17/2018,21,9454,1385,4184,2396,0,166,17585
4/17/2018,22,9455,974,3374,2224,0,68,16095
4/17/2018,23,9458,490,3114,2080,0,14,15156
4/17/2018,24,9447,294,2952,1820,0,10,14523
4/18/2018,1,9452,252,3181,1639,0,10,14534
4/18/2018,2,9454,296,2901,1697,0,10,14358
4/18/2018,3,9456,434,2587,1631,0,11,14119
4/18/2018,4,9454,892,2655,1451,0,11,14463
4/18/2018,5,9453,1412,2817,1436,0,13,15131
4/18/2018,6,9458,1768,3496,1247,1,20,15990
4/18/2018,7,9451,2669,4144,843,16,26,17149
4/18/2018,8,9450,2730,4300,689,57,26,17252
4/18/2018,9,9452,2290,4079,834,95,26,16776
4/18/2018,10,9446,1726,4232,918,118,27,16467
4/18/2018,11,9297,1584,4276,932,116,27,16232
4/18/2018,12,9429,1555,3918,990,144,26,16062
4/18/2018,13,9444,1366,3860,919,147,26,15762
4/18/2018,14,9455,1264,3932,854,161,26,15692
4/18/2018,15,9452,1361,3994,894,149,27,15877
4/18/2018,16,9449,1715,3976,826,121,27,16114
4/18/2018,17,9451,1724,4085,905,61,27,16253
4/18/2018,18,9458,1631,4153,967,26,27,16262
4/18/2018,19,9457,2010,4395,698,5,27,16592
4/18/2018,20,9456,2534,4382,632,0,27,17031
4/18/2018,21,9452,1920,4051,967,0,27,16417
4/18/2018,22,9450,1618,3367,1085,0,27,15547
4/18/2018,23,9447,794,2993,1171,0,15,14420
4/18/2018,24,9448,333,3070,1275,0,11,14137
4/19/2018,1,9446,289,3018,1255,0,9,14017
4/19/2018,2,9452,279,2935,1333,0,9,14008
4/19/2018,3,9453,294,2951,1518,0,9,14225
4/19/2018,4,9448,306,2601,1557,0,12,13924
4/19/2018,5,9457,403,2895,1632,0,17,14404
4/19/2018,6,9461,697,3211,1816,1,20,15206
4/19/2018,7,9466,950,3854,2054,10,26,16360
4/19/2018,8,9305,785,3804,2405,40,27,16366
4/19/2018,9,9247,711,3993,2482,71,27,16531
4/19/2018,10,9232,751,3904,2723,142,27,16779
4/19/2018,11,9223,784,3757,2731,193,26,16714
4/19/2018,12,9219,767,3305,2693,206,42,16232
4/19/2018,13,9208,611,3748,2576,218,86,16447
4/19/2018,14,9216,666,3551,2540,223,130,16326
4/19/2018,15,9225,731,3154,2640,213,164,16127
4/19/2018,16,9227,735,3354,2699,180,204,16399
4/19/2018,17,9227,796,3572,2752,123,203,16673
4/19/2018,18,9223,1094,3724,2466,64,187,16758
4/19/2018,19,9226,1100,4384,2262,12,194,17178
4/19/2018,20,9223,1348,4956,1895,0,196,17618
4/19/2018,21,9220,1568,4666,1647,0,210,17311
4/19/2018,22,9225,1217,3851,1563,0,209,16065
4/19/2018,23,9226,783,3156,1578,0,195,14938
4/19/2018,24,9229,406,3018,1568,0,139,14360
4/20/2018,1,9228,508,2969,1521,0,53,14279
4/20/2018,2,9227,646,3023,1609,0,9,14514
4/20/2018,3,9209,755,3087,1445,0,8,14504
4/20/2018,4,9222,1109,3185,1239,0,11,14766
4/20/2018,5,9226,1417,3008,1016,0,16,14683
4/20/2018,6,9229,1871,3674,965,1,21,15761
4/20/2018,7,9226,2163,4253,920,20,27,16609
4/20/2018,8,9223,2122,4346,774,65,27,16557
4/20/2018,9,9215,1777,3892,780,125,27,15816
4/20/2018,10,9218,1679,3877,754,241,27,15796
4/20/2018,11,9221,1482,3893,725,303,27,15651
4/20/2018,12,9223,1303,3759,738,326,27,15376
4/20/2018,13,9226,1115,3594,794,326,27,15082
4/20/2018,14,9225,1248,2964,964,322,27,14750
4/20/2018,15,9225,1336,2859,844,321,27,14612
4/20/2018,16,9221,1671,3111,803,293,27,15126
4/20/2018,17,9222,1788,3489,659,205,27,15390
4/20/2018,18,9223,1783,3614,519,99,27,15265
4/20/2018,19,9219,1789,4118,392,25,27,15570
4/20/2018,20,9218,1755,4921,288,21,27,16230
4/20/2018,21,9216,1845,4586,215,22,27,15911
4/20/2018,22,9212,1633,3908,189,22,27,14991
4/20/2018,23,9215,1058,3487,184,42,19,14005
4/20/2018,24,9216,838,3356,203,49,9,13671
4/21/2018,1,9236,621,3199,218,34,2,13310
4/21/2018,2,9273,566,3142,222,23,0,13226
4/21/2018,3,9276,320,3203,180,14,0,12993
4/21/2018,4,9269,380,3178,144,11,0,12982
4/21/2018,5,9275,627,3142,109,10,0,13163
4/21/2018,6,9330,710,3201,135,12,0,13388
4/21/2018,7,9333,806,3814,208,64,0,14225
4/21/2018,8,9333,981,4233,167,139,0,14853
4/21/2018,9,9326,1144,4331,75,203,0,15079
4/21/2018,10,9330,1257,3829,41,272,0,14729
4/21/2018,11,9326,950,3435,60,312,0,14083
4/21/2018,12,9329,771,3311,76,316,0,13803
4/21/2018,13,9326,774,3427,134,316,1,13978
4/21/2018,14,9350,773,3032,149,256,0,13560
4/21/2018,15,9389,700,3013,180,309,0,13591
4/21/2018,16,9391,487,3427,197,271,0,13773
4/21/2018,17,9390,563,3327,241,195,0,13716
4/21/2018,18,9391,536,3667,186,84,0,13864
4/21/2018,19,9395,534,4068,210,47,0,14254
4/21/2018,20,9385,536,4617,211,34,0,14783
4/21/2018,21,9377,557,4513,215,23,0,14685
4/21/2018,22,9380,537,3867,238,15,0,14037
4/21/2018,23,9376,274,3473,234,13,0,13370
4/21/2018,24,9385,163,3114,187,13,0,12862
4/22/2018,1,9391,163,2775,154,4,0,12487
4/22/2018,2,9394,164,2687,137,3,0,12385
4/22/2018,3,9390,164,2727,148,3,0,12432
4/22/2018,4,9390,164,2935,136,3,0,12628
4/22/2018,5,9387,163,3079,127,3,0,12759
4/22/2018,6,9390,164,3083,118,5,0,12760
4/22/2018,7,9390,163,3219,135,97,0,13004
4/22/2018,8,9393,162,3172,140,152,2,13021
4/22/2018,9,9394,162,3309,123,233,2,13223
4/22/2018,10,9393,162,3315,177,277,0,13324
4/22/2018,11,9394,162,3251,297,292,0,13396
4/22/2018,12,9418,162,3330,417,293,0,13620
4/22/2018,13,9421,162,2933,404,293,0,13213
4/22/2018,14,9423,163,2893,432,324,0,13235
4/22/2018,15,9423,162,3032,486,328,0,13431
4/22/2018,16,9428,162,3372,506,298,0,13766
4/22/2018,17,9429,161,3446,487,202,1,13726
4/22/2018,18,9428,162,3734,350,77,3,13754
4/22/2018,19,9426,162,3983,622,45,1,14239
4/22/2018,20,9424,166,4494,833,55,2,14974
4/22/2018,21,9430,169,4126,1158,61,0,14944
4/22/2018,22,9454,161,3601,1033,77,2,14328
4/22/2018,23,9449,161,2973,1163,83,2,13831
4/22/2018,24,9444,162,2504,1594,83,0,13787
4/23/2018,1,9453,163,2499,1539,91,0,13745
4/23/2018,2,9457,163,2491,1475,94,0,13680
4/23/2018,3,9457,165,2471,1407,100,9,13609
4/23/2018,4,9457,166,2477,1741,100,5,13946
4/23/2018,5,9454,213,2641,2141,88,11,14548
4/23/2018,6,9453,255,2904,2187,8,21,14828
4/23/2018,7,9447,349,3388,2069,31,27,15311
4/23/2018,8,9445,503,4050,1479,94,24,15595
4/23/2018,9,9449,599,4049,1230,122,25,15474
4/23/2018,10,9453,617,3818,1211,213,26,15338
4/23/2018,11,9453,613,3780,1062,224,27,15159
4/23/2018,12,9454,627,3551,1167,212,27,15038
4/23/2018,13,9456,716,3259,1257,233,27,14948
4/23/2018,14,9449,763,3054,1043,230,27,14566
4/23/2018,15,9410,892,3088,1167,225,28,14810
4/23/2018,16,9450,996,3107,1010,188,28,14779
4/23/2018,17,9451,996,3401,929,124,27,14928
4/23/2018,18,9451,992,3589,967,54,27,15080
4/23/2018,19,9451,993,3861,1009,12,27,15353
4/23/2018,20,9445,993,4120,1177,0,26,15761
4/23/2018,21,9416,956,3625,1243,0,27,15267
4/23/2018,22,9427,554,3657,1160,0,29,14827
4/23/2018,23,9450,263,3122,1256,0,12,14103
4/23/2018,24,9447,174,3041,1188,0,4,13854
4/24/2018,1,9450,168,2520,817,0,15,12970
4/24/2018,2,9447,171,2471,919,0,16,13024
4/24/2018,3,9451,240,2417,902,0,12,13022
4/24/2018,4,9444,413,2470,946,0,12,13285
4/24/2018,5,9442,554,2535,705,0,13,13249
4/24/2018,6,9458,634,2809,769,2,20,13692
4/24/2018,7,9457,632,3580,1426,29,27,15151
4/24/2018,8,9457,711,3965,1255,82,30,15500
4/24/2018,9,9457,816,4051,1025,140,32,15521
4/24/2018,10,9460,829,3765,697,183,30,14964
4/24/2018,11,9458,854,3644,809,217,31,15013
4/24/2018,12,9460,1014,3714,646,212,31,15077
4/24/2018,13,9464,819,3442,624,159,32,14540
4/24/2018,14,8987,793,3496,763,121,32,14192
4/24/2018,15,9460,688,3324,1089,108,32,14701
4/24/2018,16,9460,653,4009,1022,65,31,15240
4/24/2018,17,9461,732,3995,985,48,34,15255
4/24/2018,18,9460,612,4088,975,29,33,15197
4/24/2018,19,9455,507,4233,1026,7,33,15261
4/24/2018,20,9439,551,4293,1205,0,33,15521
4/24/2018,21,9446,562,3770,1240,0,30,15048
4/24/2018,22,9450,562,3370,1063,0,29,14474
4/24/2018,23,9451,397,2947,1006,0,14,13815
4/24/2018,24,9453,223,2707,856,0,8,13247
4/25/2018,1,9455,169,2542,579,0,15,12760
4/25/2018,2,9458,184,2520,471,0,14,12647
4/25/2018,3,9460,263,2539,422,0,14,12698
4/25/2018,4,9461,529,2536,263,0,16,12805
4/25/2018,5,9462,809,2638,197,0,17,13123
4/25/2018,6,9463,1018,3275,282,0,21,14059
4/25/2018,7,9461,1142,3968,404,10,28,15013
4/25/2018,8,9458,1173,4221,748,32,31,15663
4/25/2018,9,9460,1113,3935,1258,45,33,15844
4/25/2018,10,9457,1044,4098,1179,52,32,15862
4/25/2018,11,9457,1086,4235,1253,85,34,16150
4/25/2018,12,9457,709,3694,1567,114,35,15576
4/25/2018,13,9501,606,3655,1791,123,30,15706
4/25/2018,14,9454,282,3588,1817,122,33,15296
4/25/2018,15,9448,197,3641,2291,116,34,15727
4/25/2018,16,9446,202,3996,2580,100,32,16356
4/25/2018,17,9452,258,4467,2580,64,32,16853
4/25/2018,18,9444,349,4552,2588,36,33,17002
4/25/2018,19,9447,375,4549,2603,11,32,17017
4/25/2018,20,9444,371,4320,2590,0,32,16757
4/25/2018,21,9441,370,4171,2386,0,32,16400
4/25/2018,22,9446,372,4288,1862,0,32,16000
4/25/2018,23,9449,379,3631,1557,0,27,15043
4/25/2018,24,9461,369,3060,1283,0,16,14189
4/26/2018,1,9451,207,2730,1056,0,16,13460
4/26/2018,2,9438,163,2715,1113,0,16,13445
4/26/2018,3,9436,163,2824,924,0,15,13362
4/26/2018,4,9441,163,2989,1039,0,17,13649
4/26/2018,5,9451,164,3691,893,0,20,14219
4/26/2018,6,9457,172,4273,840,2,25,14769
4/26/2018,7,9459,286,4847,619,22,32,15265
4/26/2018,8,9460,289,4663,373,80,32,14897
4/26/2018,9,9457,399,4625,290,144,32,14947
4/26/2018,10,9454,343,4499,365,234,33,14928
4/26/2018,11,9459,283,4048,430,267,32,14519
4/26/2018,12,9458,404,4200,494,284,31,14871
4/26/2018,13,9465,544,4186,792,265,33,15285
4/26/2018,14,9462,720,3902,878,272,31,15265
4/26/2018,15,9461,768,3927,869,292,30,15347
4/26/2018,16,9460,837,3950,706,252,29,15234
4/26/2018,17,9455,855,4313,665,178,29,15495
4/26/2018,18,9459,961,4231,488,73,30,15242
4/26/2018,19,9461,965,4210,455,14,28,15133
4/26/2018,20,9458,965,4765,640,0,28,15856
4/26/2018,21,9449,966,4537,815,0,28,15795
4/26/2018,22,9449,463,4204,826,0,28,14970
4/26/2018,23,9444,292,4135,714,0,18,14603
4/26/2018,24,9455,148,3596,752,0,13,13964
4/27/2018,1,9459,109,3371,755,0,14,13708
4/27/2018,2,9466,109,3357,704,0,14,13650
4/27/2018,3,9461,109,3398,617,0,14,13599
4/27/2018,4,9458,108,3384,621,0,15,13586
4/27/2018,5,9455,108,3748,622,0,16,13949
4/27/2018,6,9464,108,3964,802,5,23,14366
4/27/2018,7,9469,108,4411,857,46,28,14919
4/27/2018,8,9465,108,4666,606,102,28,14975
4/27/2018,9,9469,108,4788,409,150,28,14952
4/27/2018,10,9472,108,4801,429,204,28,15042
4/27/2018,11,9467,108,4647,417,276,28,14943
4/27/2018,12,9466,109,4890,478,311,28,15282
4/27/2018,13,9468,109,4446,250,279,28,14580
4/27/2018,14,9466,109,4755,518,271,28,15147
4/27/2018,15,9461,113,4886,693,219,28,15400
4/27/2018,16,9454,166,4867,692,198,29,15406
4/27/2018,17,9451,245,4761,482,119,29,15087
4/27/2018,18,9451,321,4620,651,64,28,15135
4/27/2018,19,9456,316,4948,867,16,28,15631
4/27/2018,20,9453,316,4882,1565,1,29,16246
4/27/2018,21,9455,319,4599,1513,0,28,15914
4/27/2018,22,9454,319,4495,1194,0,28,15490
4/27/2018,23,9460,318,4004,946,0,18,14746
4/27/2018,24,9464,151,3719,853,0,7,14194
4/28/2018,1,9465,110,3597,652,0,1,13825
4/28/2018,2,9461,108,3545,556,0,1,13671
4/28/2018,3,9457,108,3536,431,0,1,13533
4/28/2018,4,9461,108,3595,411,0,1,13576
4/28/2018,5,9458,108,3552,501,0,1,13620
4/28/2018,6,9457,108,3589,741,1,1,13897
4/28/2018,7,9457,108,3729,1141,14,1,14450
4/28/2018,8,9453,108,3976,1699,59,1,15296
4/28/2018,9,9451,108,4263,1837,118,1,15778
4/28/2018,10,9452,107,4302,2075,115,1,16052
4/28/2018,11,9451,107,4384,2095,166,1,16204
4/28/2018,12,9448,107,4450,2353,128,1,16487
4/28/2018,13,9446,107,4200,2451,91,1,16296
4/28/2018,14,9443,107,3915,2314,127,1,15907
4/28/2018,15,9444,107,4043,2180,111,1,15886
4/28/2018,16,9438,107,4143,2173,90,1,15952
4/28/2018,17,9439,107,4662,2146,75,1,16430
4/28/2018,18,9443,107,4709,2197,38,1,16495
4/28/2018,19,9445,107,4646,2233,9,1,16441
4/28/2018,20,9444,108,4826,2052,0,1,16431
4/28/2018,21,9446,107,4801,1778,0,1,16133
4/28/2018,22,9435,107,4380,1691,0,1,15614
4/28/2018,23,9432,107,3984,1528,0,1,15052
4/28/2018,24,9431,107,3594,1310,0,1,14443
4/29/2018,1,9432,108,3529,962,0,1,14032
4/29/2018,2,9432,108,3572,677,0,1,13790
4/29/2018,3,9436,108,3546,593,0,1,13684
4/29/2018,4,9439,108,3493,610,0,1,13651
4/29/2018,5,9432,108,3682,617,0,1,13840
4/29/2018,6,9435,108,3655,975,2,1,14176
4/29/2018,7,9439,108,3631,1410,31,1,14620
4/29/2018,8,9437,108,3748,1696,94,1,15084
4/29/2018,9,9430,107,3710,1506,211,1,14965
4/29/2018,10,9426,110,3908,1212,290,1,14947
4/29/2018,11,9429,187,3993,1037,316,1,14963
4/29/2018,12,9433,214,3871,1242,283,2,15045
4/29/2018,13,9431,223,3857,1134,272,3,14920
4/29/2018,14,9435,224,3889,843,275,1,14667
4/29/2018,15,9400,239,3929,788,272,1,14629
4/29/2018,16,9413,304,4185,819,229,1,14951
4/29/2018,17,9428,385,4529,796,163,1,15302
4/29/2018,18,9432,509,4475,918,79,1,15414
4/29/2018,19,9433,519,4772,687,14,1,15426
4/29/2018,20,9429,554,5533,594,0,1,16111
4/29/2018,21,9428,591,4985,625,0,1,15630
4/29/2018,22,9444,603,4584,604,0,1,15236
4/29/2018,23,9449,224,4384,613,0,1,14671
4/29/2018,24,9450,107,4025,752,0,1,14335
4/30/2018,1,9451,115,3899,543,0,1,14009
4/30/2018,2,9456,116,3638,639,0,9,13858
4/30/2018,3,9449,141,3627,584,0,10,13811
4/30/2018,4,9449,156,3672,690,0,11,13978
4/30/2018,5,9445,277,3671,927,0,30,14350
4/30/2018,6,9442,496,3963,905,3,67,14876
4/30/2018,7,9442,683,4700,963,35,122,15945
4/30/2018,8,9443,665,4791,544,127,104,15674
4/30/2018,9,9440,710,5089,276,235,123,15873
4/30/2018,10,9445,681,4816,247,314,124,15627
4/30/2018,11,9450,674,4619,310,327,112,15492
4/30/2018,12,9449,691,4676,138,159,124,15237
4/30/2018,13,9451,333,4685,271,293,93,15126
4/30/2018,14,9452,173,4625,597,333,82,15262
4/30/2018,15,9447,308,4613,404,309,85,15166
4/30/2018,16,9443,420,4673,474,236,88,15334
4/30/2018,17,9443,711,4854,548,194,114,15864
4/30/2018,18,9445,726,4720,829,87,194,16001
4/30/2018,19,9447,728,4677,1113,16,202,16183
4/30/2018,20,9445,725,4739,1299,0,209,16417
4/30/2018,21,9429,606,4629,1740,0,186,16590
4/30/2018,22,9426,525,4299,1658,0,148,16056
4/30/2018,23,9427,330,4072,1071,0,114,15014
4/30/2018,24,9412,182,3704,452,0,25,13775
5/1/2018,1,9135,183,3605,255,0,14,13192
5/1/2018,2,8851,183,3671,421,0,14,13140
5/1/2018,3,8848,183,3628,466,0,14,13139
5/1/2018,4,8846,183,3593,341,0,15,12978
5/1/2018,5,8926,183,3623,1013,0,20,13765
5/1/2018,6,9367,184,3911,1269,8,27,14766
5/1/2018,7,9448,192,4109,2258,38,34,16079
5/1/2018,8,9447,192,4382,1971,76,34,16102
5/1/2018,9,9447,191,4457,1627,175,32,15929
5/1/2018,10,9446,190,4471,1409,253,32,15801
5/1/2018,11,9447,189,4366,1343,318,32,15695
5/1/2018,12,9447,188,4167,1301,327,30,15460
5/1/2018,13,9449,187,4013,1374,314,32,15369
5/1/2018,14,9438,186,4116,1128,320,32,15220
5/1/2018,15,9438,184,4045,1593,249,32,15541
5/1/2018,16,9442,184,4045,1851,220,34,15776
5/1/2018,17,9459,185,4049,2254,160,33,16140
5/1/2018,18,9449,185,4166,2448,64,33,16345
5/1/2018,19,9448,186,4189,2911,15,33,16782
5/1/2018,20,9440,186,4532,2952,0,33,17143
5/1/2018,21,9451,188,4464,3083,0,33,17219
5/1/2018,22,9424,187,4179,2247,0,34,16071
5/1/2018,23,9426,188,3671,1233,0,29,14547
5/1/2018,24,9405,190,3615,446,0,17,13673
5/2/2018,1,9051,189,3650,360,0,15,13265
5/2/2018,2,8705,189,3629,328,0,16,12867
5/2/2018,3,8576,221,3582,544,0,16,12939
5/2/2018,4,8567,223,3669,530,0,16,13005
5/2/2018,5,8640,224,3741,833,1,20,13459
5/2/2018,6,9239,225,3846,1096,5,29,14440
5/2/2018,7,9403,226,3921,1903,36,30,15519
5/2/2018,8,9399,226,4093,1311,120,32,15181
5/2/2018,9,9398,226,4148,1531,200,32,15535
5/2/2018,10,9393,226,4196,1844,246,33,15938
5/2/2018,11,9400,224,4124,2212,230,33,16223
5/2/2018,12,9400,226,4315,2182,223,33,16379
5/2/2018,13,9294,226,4309,2647,225,33,16734
5/2/2018,14,9280,226,4279,2846,202,32,16865
5/2/2018,15,9397,226,4315,2740,174,32,16884
5/2/2018,16,9406,225,4438,2947,143,32,17191
5/2/2018,17,9401,225,5026,2692,89,32,17465
5/2/2018,18,9418,226,5020,2535,40,32,17271
5/2/2018,19,9437,225,5238,2009,13,32,16954
5/2/2018,20,9434,205,5580,1952,0,32,17203
5/2/2018,21,9428,198,4855,1909,0,32,16422
5/2/2018,22,9434,194,4326,1867,0,32,15853
5/2/2018,23,9437,194,3812,1632,0,20,15095
5/2/2018,24,9443,194,3813,1151,0,17,14618
5/3/2018,1,9440,257,3604,890,0,16,14207
5/3/2018,2,9435,356,3590,494,0,17,13892
5/3/2018,3,9440,356,3600,347,0,18,13761
5/3/2018,4,9443,401,3570,309,0,17,13740
5/3/2018,5,9450,471,3634,521,1,37,14114
5/3/2018,6,9443,632,4002,857,1,70,15005
5/3/2018,7,9444,654,4522,1425,13,123,16181
5/3/2018,8,9437,692,4939,1709,50,184,17011
5/3/2018,9,9438,728,5116,1559,74,205,17120
5/3/2018,10,9437,868,5505,1036,91,207,17144
5/3/2018,11,9439,942,5654,1125,129,207,17496
5/3/2018,12,9434,650,5270,1042,161,206,16763
5/3/2018,13,9432,613,4966,975,166,159,16311
5/3/2018,14,9432,783,4842,1099,93,115,16364
5/3/2018,15,9437,1025,4847,1165,104,118,16696
5/3/2018,16,9433,1336,4888,1247,105,93,17102
5/3/2018,17,9430,1504,5002,1088,86,84,17194
5/3/2018,18,9437,1511,4847,657,48,88,16588
5/3/2018,19,9438,1552,5007,687,10,146,16840
5/3/2018,20,9429,1417,5144,365,0,201,16556
5/3/2018,21,9426,1383,5542,285,0,203,16839
5/3/2018,22,9439,1052,4929,158,0,178,15756
5/3/2018,23,9444,679,4537,204,0,86,14950
5/3/2018,24,9456,371,4211,267,0,24,14329
5/4/2018,1,9459,178,3999,313,0,19,13968
5/4/2018,2,9458,138,3710,391,0,18,13715
5/4/2018,3,9450,137,3655,377,0,19,13638
5/4/2018,4,9450,138,3726,405,0,18,13737
5/4/2018,5,9451,139,3784,526,0,18,13918
5/4/2018,6,9453,158,3770,1429,2,22,14834
5/4/2018,7,9454,224,3971,2063,10,31,15753
5/4/2018,8,9441,223,4326,2631,40,32,16693
5/4/2018,9,9440,223,4361,2690,84,32,16830
5/4/2018,10,9447,222,4043,3059,110,33,16914
5/4/2018,11,9449,222,4138,3018,131,33,16991
5/4/2018,12,9452,221,4154,2429,162,33,16451
5/4/2018,13,9448,222,4270,2073,197,33,16243
5/4/2018,14,9453,222,4191,1992,215,33,16106
5/4/2018,15,9449,222,4306,1693,206,34,15910
5/4/2018,16,9443,220,4156,1465,166,34,15484
5/4/2018,17,9448,222,4163,982,72,33,14920
5/4/2018,18,9439,221,4178,281,21,23,14163
5/4/2018,19,9434,221,4136,547,9,22,14369
5/4/2018,20,9432,219,4284,1055,1,33,15024
5/4/2018,21,9427,202,4523,1037,0,32,15221
5/4/2018,22,9426,196,4314,710,0,32,14678
5/4/2018,23,9397,168,3906,375,0,22,13868
5/4/2018,24,8819,165,3799,309,0,11,13103
5/5/2018,1,8533,165,3717,463,0,7,12885
5/5/2018,2,8300,139,3713,617,0,1,12770
5/5/2018,3,8293,191,3719,453,0,1,12657
5/5/2018,4,8295,246,3701,620,0,1,12863
5/5/2018,5,8294,266,3752,639,0,1,12952
5/5/2018,6,8301,300,3790,349,4,1,12745
5/5/2018,7,8303,303,3976,593,36,1,13212
5/5/2018,8,8328,304,4218,735,95,1,13681
5/5/2018,9,8599,305,4191,628,186,1,13910
5/5/2018,10,8867,305,4267,436,179,1,14055
5/5/2018,11,8890,307,4206,307,195,1,13906
5/5/2018,12,8887,306,4247,346,213,1,14000
5/5/2018,13,8885,305,4220,310,198,1,13919
5/5/2018,14,8879,306,4289,334,179,1,13988
5/5/2018,15,8882,307,4280,476,205,1,14151
5/5/2018,16,8884,305,4318,655,241,1,14404
5/5/2018,17,9165,304,4399,808,159,1,14836
5/5/2018,18,9421,311,4263,809,79,2,14885
5/5/2018,19,9428,317,4419,837,21,1,15023
5/5/2018,20,9425,317,4719,838,0,1,15300
5/5/2018,21,9418,314,4812,746,0,1,15291
5/5/2018,22,9421,308,4359,487,0,1,14576
5/5/2018,23,9219,201,4047,324,0,1,13792
5/5/2018,24,8818,134,3906,459,0,1,13318
5/6/2018,1,8584,134,3857,642,0,1,13218
5/6/2018,2,8580,134,3757,286,0,1,12758
5/6/2018,3,8326,133,3935,228,0,1,12623
5/6/2018,4,8023,134,4103,364,0,1,12625
5/6/2018,5,7986,133,4307,272,0,1,12699
5/6/2018,6,8140,133,4178,407,6,1,12865
5/6/2018,7,8311,133,4171,557,47,1,13220
5/6/2018,8,8724,134,4590,428,121,1,13998
5/6/2018,9,9098,137,4450,326,191,1,14203
5/6/2018,10,9058,168,4379,338,260,1,14204
5/6/2018,11,8627,204,4631,329,286,1,14078
5/6/2018,12,8620,138,4670,364,292,1,14085
5/6/2018,13,8605,229,4277,288,290,1,13690
5/6/2018,14,8601,165,4384,383,259,1,13793
5/6/2018,15,8610,230,4644,456,172,1,14113
5/6/2018,16,8622,289,4668,1697,135,1,15412
5/6/2018,17,8623,353,4829,1924,114,1,15844
5/6/2018,18,8625,354,4785,2185,44,1,15994
5/6/2018,19,8628,356,4927,1866,5,1,15783
5/6/2018,20,8629,370,5039,1578,0,1,15617
5/6/2018,21,8634,372,5066,1406,0,1,15479
5/6/2018,22,8629,392,5031,1310,0,1,15363
5/6/2018,23,8632,293,4575,1161,0,1,14662
5/6/2018,24,8633,231,4409,990,0,1,14264
5/7/2018,1,8634,348,4001,955,0,1,13939
5/7/2018,2,8634,353,3848,911,0,2,13748
5/7/2018,3,8636,352,3835,870,0,15,13708
5/7/2018,4,8636,354,4140,560,0,16,13706
5/7/2018,5,8636,467,4350,638,0,34,14125
5/7/2018,6,8637,640,4412,749,4,74,14516
5/7/2018,7,8635,831,4806,1139,47,159,15617
5/7/2018,8,8639,851,5256,772,146,199,15863
5/7/2018,9,8634,889,5601,535,250,200,16109
5/7/2018,10,8630,930,5353,459,312,200,15884
5/7/2018,11,8633,972,5518,416,330,200,16069
5/7/2018,12,8634,1049,5014,374,326,200,15597
5/7/2018,13,8631,1034,4705,325,325,200,15220
5/7/2018,14,8632,907,5043,470,321,190,15563
5/7/2018,15,8634,935,5033,531,318,132,15583
5/7/2018,16,8630,987,5008,479,275,114,15493
5/7/2018,17,8635,1057,5395,407,184,123,15801
5/7/2018,18,8630,1201,5810,362,84,178,16265
5/7/2018,19,8630,1247,6001,292,16,171,16357
5/7/2018,20,8630,1296,6024,287,0,169,16406
5/7/2018,21,8627,1494,5944,335,0,167,16567
5/7/2018,22,8625,767,5803,336,0,106,15637
5/7/2018,23,8625,236,5502,425,0,15,14803
5/7/2018,24,8618,160,4722,557,0,1,14058
5/8/2018,1,8624,161,4297,676,0,1,13759
5/8/2018,2,8615,161,3884,730,0,1,13391
5/8/2018,3,8629,161,3902,785,0,1,13478
5/8/2018,4,8627,162,3960,798,0,1,13548
5/8/2018,5,8632,290,4243,592,0,1,13758
5/8/2018,6,8634,386,4580,553,5,1,14159
5/8/2018,7,8637,503,5341,690,43,1,15215
5/8/2018,8,8633,521,5535,372,140,1,15202
5/8/2018,9,8632,538,5467,307,240,1,15185
5/8/2018,10,8630,544,5114,304,305,9,14906
5/8/2018,11,8627,654,5202,261,330,25,15099
5/8/2018,12,8616,662,5163,245,335,27,15048
5/8/2018,13,8616,484,5223,245,335,31,14934
5/8/2018,14,8620,344,5272,265,332,31,14864
5/8/2018,15,8620,527,4973,265,320,31,14736
5/8/2018,16,8617,765,5004,318,272,51,15027
5/8/2018,17,8625,1127,5882,262,190,94,16180
5/8/2018,18,8628,1472,5890,179,85,176,16430
5/8/2018,19,8627,1392,5864,179,18,195,16275
5/8/2018,20,8618,1300,5798,273,1,195,16185
5/8/2018,21,8617,1287,5651,415,0,160,16130
5/8/2018,22,8619,1060,4934,508,0,56,15177
5/8/2018,23,8617,427,4333,723,0,23,14123
5/8/2018,24,8619,190,4182,756,0,17,13764
5/9/2018,1,8747,191,4049,744,0,16,13747
5/9/2018,2,8806,190,3900,434,0,17,13347
5/9/2018,3,8813,190,3855,313,0,18,13189
5/9/2018,4,8813,190,3872,414,0,18,13307
5/9/2018,5,8809,237,3918,615,0,22,13601
5/9/2018,6,8896,343,4274,828,6,27,14374
5/9/2018,7,8972,521,4710,1260,46,32,15541
5/9/2018,8,9029,666,5004,891,123,32,15745
5/9/2018,9,9116,948,5002,529,199,32,15826
5/9/2018,10,9104,1002,4806,605,261,32,15810
5/9/2018,11,9098,988,4760,808,293,32,15979
5/9/2018,12,9105,971,4531,849,301,329,16086
5/9/2018,13,8944,975,4546,889,306,330,15990
5/9/2018,14,9036,976,4598,900,301,36,15847
5/9/2018,15,9126,928,4521,1207,264,32,16078
5/9/2018,16,9243,464,4641,1876,200,32,16456
5/9/2018,17,9316,363,4937,2155,126,32,16929
5/9/2018,18,9331,361,4766,2297,66,32,16853
5/9/2018,19,9321,377,4926,2395,16,32,17067
5/9/2018,20,9321,361,4737,2729,1,32,17181
5/9/2018,21,9323,361,4521,3033,0,32,17270
5/9/2018,22,9315,366,4089,1925,0,32,15727
5/9/2018,23,9305,228,4112,1004,0,24,14673
5/9/2018,24,9251,165,3859,293,0,18,13586
5/10/2018,1,8812,165,3926,289,0,17,13209
5/10/2018,2,8816,164,4013,352,0,17,13362
5/10/2018,3,8634,165,3984,464,0,18,13265
5/10/2018,4,8646,188,3970,417,0,18,13239
5/10/2018,5,8719,196,3957,296,0,19,13187
5/10/2018,6,9211,195,3949,979,1,25,14360
5/10/2018,7,9485,193,4104,1714,5,32,15533
5/10/2018,8,9487,193,4311,2168,32,32,16223
5/10/2018,9,9478,193,4382,2142,101,32,16328
5/10/2018,10,9472,193,4308,2515,126,32,16646
5/10/2018,11,9479,192,4485,2366,136,33,16691
5/10/2018,12,9469,163,4492,2198,161,32,16515
5/10/2018,13,9524,193,4506,2099,172,32,16526
5/10/2018,14,9514,192,4300,2071,122,32,16231
5/10/2018,15,9601,279,4352,1932,164,32,16360
5/10/2018,16,9623,301,4416,1870,110,33,16353
5/10/2018,17,9627,302,4506,1873,80,32,16420
5/10/2018,18,9632,301,4635,1522,63,32,16185
5/10/2018,19,9632,302,4905,1526,19,32,16416
5/10/2018,20,9630,304,4918,1505,2,32,16391
5/10/2018,21,9628,303,4587,1917,0,33,16468
5/10/2018,22,9627,302,4334,1129,0,32,15424
5/10/2018,23,9639,303,3794,516,0,30,14282
5/10/2018,24,9487,302,3743,171,0,18,13721
5/11/2018,1,8978,303,3775,297,0,16,13369
5/11/2018,2,8813,301,3742,725,0,16,13597
5/11/2018,3,8822,305,3793,609,0,16,13545
5/11/2018,4,8818,354,3872,620,0,17,13681
5/11/2018,5,8905,414,3791,656,1,39,13806
5/11/2018,6,9413,433,4182,491,7,75,14601
5/11/2018,7,9698,464,4607,677,52,154,15652
5/11/2018,8,9697,466,4646,560,127,166,15662
5/11/2018,9,9689,469,4868,292,211,129,15658
5/11/2018,10,9673,470,4851,196,249,173,15612
5/11/2018,11,9665,469,4902,151,254,198,15639
5/11/2018,12,9687,469,4822,172,257,166,15573
5/11/2018,13,9701,469,4898,228,239,127,15662
5/11/2018,14,9696,470,5258,300,194,123,16041
5/11/2018,15,9688,469,4711,259,176,107,15410
5/11/2018,16,9690,469,5017,412,137,102,15827
5/11/2018,17,9692,468,5289,355,109,150,16063
5/11/2018,18,9689,469,5690,353,51,193,16445
5/11/2018,19,9695,468,5778,518,13,194,16666
5/11/2018,20,9688,470,5593,588,1,195,16535
5/11/2018,21,9695,469,5561,516,0,193,16434
5/11/2018,22,9694,469,5315,616,0,160,16254
5/11/2018,23,9694,315,4469,596,0,40,15114
5/11/2018,24,9703,245,3971,554,0,2,14475
5/12/2018,1,9491,219,3861,595,0,3,14169
5/12/2018,2,9415,217,3767,502,0,1,13902
5/12/2018,3,9413,217,3746,307,0,1,13684
5/12/2018,4,9415,219,3782,286,0,1,13703
5/12/2018,5,9409,218,3765,502,0,1,13895
5/12/2018,6,9408,218,3840,386,7,1,13860
5/12/2018,7,9417,219,4039,651,38,1,14365
5/12/2018,8,9672,218,4432,551,92,1,14966
5/12/2018,9,9704,218,4963,462,155,1,15503
5/12/2018,10,9705,218,4724,377,195,1,15220
5/12/2018,11,9701,217,4567,176,195,1,14857
5/12/2018,12,9694,218,4781,98,159,1,14951
5/12/2018,13,9682,218,4727,108,135,1,14871
5/12/2018,14,9686,218,4625,134,95,1,14759
5/12/2018,15,9655,217,4637,150,55,1,14715
5/12/2018,16,9697,217,4713,135,91,1,14854
5/12/2018,17,9691,218,4978,203,142,1,15233
5/12/2018,18,9680,218,5072,387,81,1,15439
5/12/2018,19,9686,218,5452,308,22,1,15687
5/12/2018,20,9677,218,5442,293,2,1,15633
5/12/2018,21,9671,220,5102,229,0,1,15223
5/12/2018,22,9609,218,4931,498,0,1,15257
5/12/2018,23,9264,222,4514,318,0,2,14320
5/12/2018,24,9143,220,4491,346,0,2,14202
5/13/2018,1,9027,217,4257,355,0,1,13857
5/13/2018,2,8856,217,4117,395,0,1,13586
5/13/2018,3,8856,220,3971,384,0,1,13432
5/13/2018,4,8858,222,3899,451,0,1,13431
5/13/2018,5,8859,222,4132,351,0,1,13565
5/13/2018,6,8862,214,3998,435,8,1,13518
5/13/2018,7,8936,211,4197,408,42,1,13795
5/13/2018,8,9363,212,4478,243,131,1,14428
5/13/2018,9,9401,211,4379,124,193,1,14309
5/13/2018,10,9405,211,4294,152,233,1,14296
5/13/2018,11,9403,212,4601,109,107,1,14433
5/13/2018,12,9400,212,4520,69,208,1,14410
5/13/2018,13,9403,212,4336,139,306,1,14397
5/13/2018,14,9519,211,4178,190,300,1,14399
5/13/2018,15,9689,211,4188,156,281,1,14526
5/13/2018,16,9697,212,4412,125,232,1,14679
5/13/2018,17,9700,212,4949,159,175,1,15196
5/13/2018,18,9702,221,5092,203,85,1,15304
5/13/2018,19,9704,158,5478,220,21,1,15582
5/13/2018,20,9698,107,5529,279,1,1,15615
5/13/2018,21,9700,113,5577,419,0,1,15810
5/13/2018,22,9696,116,5161,574,0,1,15548
5/13/2018,23,9695,160,4380,595,0,1,14831
5/13/2018,24,9693,167,3926,411,0,1,14198
5/14/2018,1,9476,205,3696,674,0,12,14063
5/14/2018,2,9461,218,3576,630,0,16,13901
5/14/2018,3,9533,232,3678,789,0,17,14249
5/14/2018,4,9548,257,3708,243,0,16,13772
5/14/2018,5,9552,278,3931,333,1,21,14116
5/14/2018,6,9793,302,4436,331,10,26,14898
5/14/2018,7,9848,342,5093,265,50,45,15643
5/14/2018,8,9844,374,5061,147,133,75,15634
5/14/2018,9,9842,454,4906,173,205,132,15712
5/14/2018,10,9837,547,4953,211,260,181,15989
5/14/2018,11,9835,794,4882,188,252,183,16134
5/14/2018,12,9835,941,4764,415,238,190,16383
5/14/2018,13,9836,1063,4729,437,247,190,16502
5/14/2018,14,9842,1066,4894,416,298,181,16697
5/14/2018,15,9845,1215,4943,425,283,156,16867
5/14/2018,16,9845,1241,4941,451,224,128,16830
5/14/2018,17,9839,1248,5167,748,161,173,17336
5/14/2018,18,9852,1392,5218,779,87,185,17513
5/14/2018,19,9854,1133,5185,585,24,193,16974
5/14/2018,20,9855,875,5143,706,2,194,16775
5/14/2018,21,9851,616,5019,775,0,191,16452
5/14/2018,22,9846,420,5003,495,0,146,15910
5/14/2018,23,9853,222,4664,544,0,33,15316
5/14/2018,24,9849,164,4064,391,0,16,14484
5/15/2018,1,9856,164,3801,518,0,17,14356
5/15/2018,2,9850,163,3548,525,0,17,14103
5/15/2018,3,9854,168,3346,588,0,16,13972
5/15/2018,4,9859,164,3451,588,0,16,14078
5/15/2018,5,9849,164,3533,608,1,20,14175
5/15/2018,6,9866,165,4159,796,2,26,15014
5/15/2018,7,9872,195,5151,812,17,32,16079
5/15/2018,8,9875,180,5634,735,40,32,16496
5/15/2018,9,9872,164,5361,513,73,32,16015
5/15/2018,10,9875,164,5250,585,63,32,15969
5/15/2018,11,9869,161,5082,689,77,32,15910
5/15/2018,12,9870,163,4921,596,131,32,15713
5/15/2018,13,9867,172,4988,514,152,32,15725
5/15/2018,14,9865,168,5051,438,190,32,15744
5/15/2018,15,9854,144,4885,227,155,34,15299
5/15/2018,16,9859,264,4941,364,241,33,15702
5/15/2018,17,9860,287,5028,426,173,32,15806
5/15/2018,18,9859,325,5033,505,88,31,15841
5/15/2018,19,9866,344,5058,564,21,31,15884
5/15/2018,20,9861,345,5025,833,2,32,16098
5/15/2018,21,9860,344,5100,900,0,31,16235
5/15/2018,22,9859,260,4984,284,0,32,15419
5/15/2018,23,9861,164,4514,195,0,23,14757
5/15/2018,24,9645,164,3917,208,0,18,13952
5/16/2018,1,9576,164,3812,301,0,18,13871
5/16/2018,2,9570,165,3494,238,0,16,13483
5/16/2018,3,9570,168,3563,483,0,17,13801
5/16/2018,4,9574,212,3524,655,0,18,13983
5/16/2018,5,9793,249,3771,649,0,21,14483
5/16/2018,6,9870,322,4040,519,9,44,14804
5/16/2018,7,9872,394,4677,676,43,79,15741
5/16/2018,8,9864,577,5101,365,120,82,16109
5/16/2018,9,9862,759,4940,175,199,97,16032
5/16/2018,10,9862,749,4800,125,256,105,15897
5/16/2018,11,9857,751,4715,195,305,155,15978
5/16/2018,12,9856,832,4808,208,300,122,16126
5/16/2018,13,9855,768,4907,176,302,121,16129
5/16/2018,14,9856,765,4942,261,287,122,16233
5/16/2018,15,9860,614,5082,270,302,150,16278
5/16/2018,16,9850,432,5111,195,256,147,15991
5/16/2018,17,9853,268,5390,223,171,197,16102
5/16/2018,18,9851,346,5461,179,92,196,16125
5/16/2018,19,9851,348,5232,153,23,195,15802
5/16/2018,20,9849,373,5695,168,4,32,16121
5/16/2018,21,9831,386,5640,298,0,32,16187
5/16/2018,22,9835,348,5204,408,0,32,15827
5/16/2018,23,9840,347,4459,455,0,23,15124
5/16/2018,24,9828,191,3913,632,0,63,14627
5/17/2018,1,9838,166,3810,255,0,17,14086
5/17/2018,2,9587,167,3803,254,0,16,13827
5/17/2018,3,9563,166,3554,387,0,16,13686
5/17/2018,4,9559,167,3619,337,0,16,13698
5/17/2018,5,9556,165,3862,486,0,17,14086
5/17/2018,6,9655,165,4420,604,7,23,14874
5/17/2018,7,9857,164,4922,519,49,31,15542
5/17/2018,8,9853,166,5371,319,143,31,15883
5/17/2018,9,9849,164,5248,268,234,31,15794
5/17/2018,10,9848,164,4993,265,290,31,15591
5/17/2018,11,9846,164,4730,256,311,31,15338
5/17/2018,12,9842,170,4624,369,331,30,15366
5/17/2018,13,9683,181,4569,626,321,31,15411
5/17/2018,14,9691,213,4665,236,252,31,15088
5/17/2018,15,9843,283,4613,482,305,31,15557
5/17/2018,16,9846,412,4600,1266,258,30,16412
5/17/2018,17,9851,456,4690,1294,181,31,16503
5/17/2018,18,9850,712,4858,1416,87,31,16954
5/17/2018,19,9849,718,4823,1604,25,32,17051
5/17/2018,20,9847,720,4861,1581,4,32,17045
5/17/2018,21,9842,718,4908,1617,0,32,17117
5/17/2018,22,9842,566,4488,1254,0,32,16182
5/17/2018,23,9845,537,4120,553,0,22,15077
5/17/2018,24,9851,301,3487,540,0,16,14195
5/18/2018,1,9853,156,3268,388,0,15,13680
5/18/2018,2,9865,154,3287,202,0,15,13523
5/18/2018,3,9866,154,3318,359,0,15,13712
5/18/2018,4,9867,154,3325,253,0,15,13614
5/18/2018,5,9867,155,3318,553,0,18,13911
5/18/2018,6,9867,155,3436,1199,9,25,14691
5/18/2018,7,9874,159,3650,1889,58,30,15660
5/18/2018,8,9872,222,3897,1684,128,31,15834
5/18/2018,9,9862,341,3815,1322,200,31,15571
5/18/2018,10,9867,289,3683,1149,217,30,15235
5/18/2018,11,9866,252,3538,1259,298,27,15240
5/18/2018,12,9866,228,3478,1363,301,27,15263
5/18/2018,13,9864,236,3484,1422,324,27,15357
5/18/2018,14,9864,225,3455,1161,306,26,15037
5/18/2018,15,9860,292,3594,997,310,26,15079
5/18/2018,16,9862,326,3736,1059,252,27,15262
5/18/2018,17,9855,189,3772,1842,162,27,15847
5/18/2018,18,9837,159,3993,2194,80,28,16291
5/18/2018,19,9842,159,4244,2400,22,28,16695
5/18/2018,20,9836,159,4421,2569,3,28,17016
5/18/2018,21,9850,158,4315,2566,0,28,16917
5/18/2018,22,9849,158,3796,2267,0,28,16098
5/18/2018,23,9852,104,3486,1396,0,19,14857
5/18/2018,24,9849,102,3276,748,0,9,13984
5/19/2018,1,9857,102,3249,633,0,1,13842
5/19/2018,2,9859,101,3238,449,0,1,13648
5/19/2018,3,9639,100,3264,445,0,1,13449
5/19/2018,4,9572,101,3257,537,0,1,13468
5/19/2018,5,9584,103,3282,643,0,1,13613
5/19/2018,6,9806,107,3290,682,5,1,13891
5/19/2018,7,9889,107,3472,658,26,1,14153
5/19/2018,8,9884,109,3874,955,60,1,14883
5/19/2018,9,9883,112,3927,1760,88,1,15771
5/19/2018,10,9874,128,4357,1681,93,3,16136
5/19/2018,11,9877,135,4659,1530,89,1,16291
5/19/2018,12,9874,145,4391,1498,97,1,16006
5/19/2018,13,9875,133,4513,1400,118,1,16040
5/19/2018,14,9836,113,4745,1223,139,18,16074
5/19/2018,15,9874,133,4463,1246,125,48,15889
5/19/2018,16,9874,115,4393,1191,111,106,15790
5/19/2018,17,9877,114,5009,1061,54,145,16260
5/19/2018,18,9904,108,5144,1043,33,162,16394
5/19/2018,19,9905,111,4719,1243,15,162,16155
5/19/2018,20,9900,109,4579,1436,3,162,16189
5/19/2018,21,9901,130,4666,1345,0,143,16185
5/19/2018,22,9905,108,4062,1368,0,117,15560
5/19/2018,23,9903,100,3692,1080,0,27,14802
5/19/2018,24,9905,101,3340,720,0,1,14067
5/20/2018,1,9906,100,3260,566,0,1,13833
5/20/2018,2,9838,100,3228,482,0,1,13649
5/20/2018,3,9614,100,3225,502,0,1,13442
5/20/2018,4,9614,100,3202,452,0,1,13369
5/20/2018,5,9610,100,3196,559,0,2,13467
5/20/2018,6,9614,107,3205,618,1,1,13546
5/20/2018,7,9620,111,3452,641,33,1,13858
5/20/2018,8,9851,115,3660,692,67,1,14386
5/20/2018,9,9913,118,3908,675,171,1,14786
5/20/2018,10,9918,118,4168,548,185,1,14938
5/20/2018,11,9915,116,4213,483,194,1,14922
5/20/2018,12,9916,116,4275,432,260,1,15000
5/20/2018,13,9917,106,4200,423,281,1,14928
5/20/2018,14,9918,106,4050,406,238,1,14719
5/20/2018,15,9915,106,4223,286,221,2,14753
5/20/2018,16,9917,106,4342,544,166,1,15076
5/20/2018,17,9917,106,4642,537,132,1,15335
5/20/2018,18,9916,106,4974,528,77,2,15603
5/20/2018,19,9919,106,5106,596,21,1,15749
5/20/2018,20,9924,106,5261,454,2,1,15748
5/20/2018,21,9925,105,4754,401,0,1,15186
5/20/2018,22,9928,105,4333,471,0,1,14838
5/20/2018,23,9934,106,3957,470,0,1,14468
5/20/2018,24,9932,106,3429,472,0,2,13941
5/21/2018,1,9939,106,3211,448,0,1,13705
5/21/2018,2,9787,106,3189,375,0,1,13458
5/21/2018,3,9455,107,3180,370,0,1,13113
5/21/2018,4,9391,107,3218,407,0,1,13124
5/21/2018,5,9399,107,3216,558,0,1,13281
5/21/2018,6,9398,107,3284,468,9,1,13267
5/21/2018,7,9397,107,3509,442,56,1,13512
5/21/2018,8,9397,107,3949,117,60,1,13631
5/21/2018,9,9090,107,4078,121,129,1,13526
5/21/2018,10,8806,121,4092,290,303,1,13613
5/21/2018,11,8803,132,4013,417,325,1,13691
5/21/2018,12,8818,135,4072,512,325,1,13863
5/21/2018,13,9083,137,3832,566,311,1,13930
5/21/2018,14,9165,149,3849,470,306,8,13947
5/21/2018,15,9345,134,4046,457,245,7,14234
5/21/2018,16,9533,134,4426,465,156,4,14718
5/21/2018,17,9927,135,5056,363,101,1,15583
5/21/2018,18,9938,134,4951,380,50,1,15454
5/21/2018,19,9940,134,4810,466,17,1,15368
5/21/2018,20,9938,134,4662,749,2,1,15486
5/21/2018,21,9938,120,4360,780,0,1,15199
5/21/2018,22,9937,134,4134,484,0,1,14690
5/21/2018,23,9941,107,3586,454,0,1,14089
5/21/2018,24,9784,108,3290,278,0,1,13461
5/22/2018,1,9281,107,3390,286,0,15,13079
5/22/2018,2,9103,107,3250,586,0,17,13063
5/22/2018,3,9102,108,3413,638,0,16,13277
5/22/2018,4,9150,107,3498,553,0,18,13326
5/22/2018,5,9512,107,3661,417,0,20,13717
5/22/2018,6,9838,117,3898,253,1,48,14155
5/22/2018,7,9933,188,4603,203,10,59,14996
5/22/2018,8,9933,201,5450,155,44,60,15843
5/22/2018,9,9935,225,5305,199,82,61,15807
5/22/2018,10,9942,270,5101,173,117,57,15660
5/22/2018,11,9926,321,5058,203,135,55,15698
5/22/2018,12,9920,380,5127,244,134,52,15857
5/22/2018,13,9923,411,5139,188,118,51,15830
5/22/2018,14,9922,418,5138,247,118,50,15893
5/22/2018,15,9921,489,4940,209,96,50,15705
5/22/2018,16,9921,592,4941,333,93,51,15931
5/22/2018,17,9918,642,4832,478,70,38,15978
5/22/2018,18,9914,612,5013,464,42,32,16077
5/22/2018,19,9918,629,5108,475,20,32,16182
5/22/2018,20,9913,622,4826,725,2,32,16120
5/22/2018,21,9911,660,4818,545,0,32,15966
5/22/2018,22,9899,485,4658,286,0,32,15360
5/22/2018,23,9900,345,4335,417,0,20,15017
5/22/2018,24,9900,307,4015,449,0,17,14688
5/23/2018,1,9900,314,3946,356,0,16,14532
5/23/2018,2,9903,322,3670,280,0,16,14191
5/23/2018,3,9906,349,3391,187,0,12,13845
5/23/2018,4,9773,359,3418,123,0,11,13684
5/23/2018,5,9650,377,3630,201,0,5,13863
5/23/2018,6,9724,406,3944,311,8,1,14394
5/23/2018,7,9904,436,4280,242,55,1,14918
5/23/2018,8,9899,470,4540,134,148,1,15192
5/23/2018,9,9901,539,4513,127,236,1,15317
5/23/2018,10,9895,590,4334,70,278,1,15168
5/23/2018,11,9913,639,4251,223,328,1,15355
5/23/2018,12,9921,852,4220,329,334,16,15672
5/23/2018,13,9922,992,4322,376,331,17,15960
5/23/2018,14,9922,1154,4345,498,313,2,16234
5/23/2018,15,9921,1307,4424,383,293,1,16329
5/23/2018,16,9928,1342,4712,277,209,1,16469
5/23/2018,17,9929,1288,5074,243,160,1,16695
5/23/2018,18,9933,1275,5296,173,69,1,16747
5/23/2018,19,9937,1280,5717,165,25,1,17125
5/23/2018,20,9940,1264,5912,168,5,1,17290
5/23/2018,21,9944,916,6091,246,0,1,17198
5/23/2018,22,9943,624,5483,247,0,1,16298
5/23/2018,23,9944,271,4712,305,0,1,15233
5/23/2018,24,9951,257,3760,294,0,1,14263
5/24/2018,1,9814,256,3648,317,0,1,14036
5/24/2018,2,9697,240,3375,292,0,1,13605
5/24/2018,3,9698,230,3236,284,0,1,13449
5/24/2018,4,9689,232,3283,306,0,1,13511
5/24/2018,5,9688,305,3397,297,0,9,13696
5/24/2018,6,9883,382,3971,315,7,11,14569
5/24/2018,7,9943,454,5042,183,51,34,15707
5/24/2018,8,9937,468,4987,54,143,25,15614
5/24/2018,9,9933,563,4838,45,235,24,15638
5/24/2018,10,9935,573,5075,34,299,29,15945
5/24/2018,11,9928,746,5148,82,323,27,16254
5/24/2018,12,9926,986,5064,192,332,28,16528
5/24/2018,13,9934,959,4562,350,332,31,16168
5/24/2018,14,9928,860,4463,511,329,31,16122
5/24/2018,15,9927,981,4947,667,311,31,16864
5/24/2018,16,9926,1116,5125,870,255,30,17322
5/24/2018,17,9933,1304,4981,940,180,31,17369
5/24/2018,18,9929,1389,5100,758,85,31,17292
5/24/2018,19,9928,1399,5610,871,27,31,17866
5/24/2018,20,9918,1392,5470,1046,4,31,17861
5/24/2018,21,9911,918,5115,1353,0,31,17328
5/24/2018,22,9929,790,4772,1346,0,31,16868
5/24/2018,23,9924,609,4301,1250,0,22,16106
5/24/2018,24,9928,292,3844,914,0,19,14997
5/25/2018,1,9934,250,3185,1109,0,16,14494
5/25/2018,2,9933,249,3191,665,0,31,14069
5/25/2018,3,9930,254,3157,371,0,35,13747
5/25/2018,4,9926,300,3183,307,0,32,13748
5/25/2018,5,9923,380,3329,726,0,24,14382
5/25/2018,6,9938,643,3495,1196,9,25,15306
5/25/2018,7,9938,807,4213,1230,52,31,16271
5/25/2018,8,9938,1151,4930,928,128,32,17107
5/25/2018,9,9932,1545,5133,826,180,32,17648
5/25/2018,10,9931,1793,5091,852,209,31,17907
5/25/2018,11,9930,1752,4858,888,250,31,17709
5/25/2018,12,9928,1744,4813,565,270,31,17351
5/25/2018,13,9929,1425,4647,767,257,31,17056
5/25/2018,14,9934,1331,4726,647,250,31,16919
5/25/2018,15,9931,1366,4839,691,268,32,17127
5/25/2018,16,9937,1323,4993,1126,230,31,17640
5/25/2018,17,9930,1312,4927,1649,143,31,17992
5/25/2018,18,9921,1101,5117,1634,78,30,17881
5/25/2018,19,9920,753,5486,1528,19,31,17737
5/25/2018,20,9914,793,5910,1233,3,31,17884
5/25/2018,21,9913,789,5468,1463,0,31,17664
5/25/2018,22,9918,670,4623,1596,0,30,16837
5/25/2018,23,9919,403,4188,1293,0,24,15827
5/25/2018,24,9924,256,3843,1331,0,10,15364
5/26/2018,1,9927,187,3232,1499,0,1,14846
5/26/2018,2,9923,187,3256,849,0,1,14216
5/26/2018,3,9920,187,3216,708,0,1,14032
5/26/2018,4,9927,188,3226,485,0,1,13827
5/26/2018,5,9930,181,3352,392,0,1,13856
5/26/2018,6,9927,282,3285,313,8,1,13816
5/26/2018,7,9930,382,3651,532,48,1,14544
5/26/2018,8,9926,525,4472,511,103,1,15538
5/26/2018,9,9925,704,5341,217,178,2,16367
5/26/2018,10,9925,988,5304,213,178,1,16609
5/26/2018,11,9927,1008,5210,301,195,1,16642
5/26/2018,12,9923,1106,5748,260,201,1,17239
5/26/2018,13,9918,1223,5466,205,221,2,17035
5/26/2018,14,9931,1402,4906,326,215,2,16782
5/26/2018,15,9930,1404,5102,354,158,1,16949
5/26/2018,16,9923,1405,5532,276,168,1,17305
5/26/2018,17,9925,1432,5378,376,120,1,17232
5/26/2018,18,9918,1465,5387,313,81,1,17165
5/26/2018,19,9917,1589,5237,257,22,1,17023
5/26/2018,20,9913,763,5506,270,2,1,16455
5/26/2018,21,9911,558,5245,472,0,1,16187
5/26/2018,22,9912,545,4883,538,0,1,15879
5/26/2018,23,9917,406,4487,512,0,1,15323
5/26/2018,24,9914,313,3926,619,0,1,14773
5/27/2018,1,9910,152,3739,583,0,1,14385
5/27/2018,2,9913,129,3423,659,0,1,14125
5/27/2018,3,9914,129,3392,603,0,1,14039
5/27/2018,4,9907,129,3307,509,0,1,13853
5/27/2018,5,9904,135,3273,434,1,1,13748
5/27/2018,6,9901,139,3262,133,3,1,13439
5/27/2018,7,9902,212,3549,144,33,1,13841
5/27/2018,8,9903,227,4118,80,76,1,14405
5/27/2018,9,9901,365,4680,113,198,1,15258
5/27/2018,10,9903,535,4784,128,223,1,15574
5/27/2018,11,9903,830,4691,144,283,3,15854
5/27/2018,12,9903,987,4709,239,254,4,16096
5/27/2018,13,9901,1055,4710,482,298,25,16471
5/27/2018,14,9900,1194,4810,407,297,26,16634
5/27/2018,15,9862,1209,5257,532,282,20,17162
5/27/2018,16,9879,1362,5425,432,238,14,17350
5/27/2018,17,9896,1364,5740,395,160,13,17568
5/27/2018,18,9896,1363,5957,311,84,16,17627
5/27/2018,19,9895,1392,5722,509,25,11,17554
5/27/2018,20,9889,1109,5609,678,4,1,17290
5/27/2018,21,9877,827,5504,1032,0,1,17241
5/27/2018,22,9870,395,5399,1164,0,1,16829
5/27/2018,23,9876,203,4689,1007,0,1,15776
5/27/2018,24,9881,203,4367,923,0,1,15375
5/28/2018,1,9887,205,3890,869,0,1,14852
5/28/2018,2,9886,203,3714,801,0,1,14605
5/28/2018,3,9885,220,3241,755,0,2,14103
5/28/2018,4,9889,321,3258,557,0,1,14026
5/28/2018,5,9885,608,3302,163,0,1,13959
5/28/2018,6,9881,1098,3621,387,7,1,14995
5/28/2018,7,9877,1542,4412,383,45,6,16265
5/28/2018,8,9875,1807,5261,209,124,10,17286
5/28/2018,9,9872,2219,4803,183,183,13,17273
5/28/2018,10,9871,2547,4717,123,80,14,17352
5/28/2018,11,9865,2968,4709,105,99,11,17757
5/28/2018,12,9869,3023,4709,157,172,10,17940
5/28/2018,13,9867,3042,4775,194,310,15,18203
5/28/2018,14,9863,3113,4807,300,300,26,18409
5/28/2018,15,9865,3074,5307,284,298,33,18861
5/28/2018,16,9867,3074,5847,277,247,46,19358
5/28/2018,17,9874,3312,5994,282,170,50,19682
5/28/2018,18,9876,3491,6013,332,85,48,19845
5/28/2018,19,9877,3262,6061,339,22,43,19604
5/28/2018,20,9872,3401,5971,277,4,42,19567
5/28/2018,21,9871,2904,6049,294,0,42,19160
5/28/2018,22,9874,2307,5434,267,0,25,17907
5/28/2018,23,9875,991,5226,207,0,20,16319
5/28/2018,24,9873,394,4893,326,0,16,15502
5/29/2018,1,9891,248,4210,469,0,14,14832
5/29/2018,2,9889,254,3889,247,0,14,14293
5/29/2018,3,9891,244,3563,722,0,15,14435
5/29/2018,4,9891,282,3592,899,0,15,14679
5/29/2018,5,9886,494,3513,999,0,15,14907
5/29/2018,6,9887,786,3891,658,4,21,15247
5/29/2018,7,9895,1031,4501,1001,52,26,16506
5/29/2018,8,9888,1130,5717,871,137,26,17769
5/29/2018,9,9889,1226,5417,905,227,26,17690
5/29/2018,10,9886,1345,5057,1031,292,26,17637
5/29/2018,11,9882,1554,4978,985,321,26,17746
5/29/2018,12,9886,1700,4855,827,330,26,17624
5/29/2018,13,9879,1731,5006,741,332,27,17716
5/29/2018,14,9876,1879,5171,633,324,27,17910
5/29/2018,15,9879,1717,5710,634,302,29,18271
5/29/2018,16,9877,2005,5917,727,258,44,18828
5/29/2018,17,9879,2032,5802,785,186,43,18727
5/29/2018,18,9881,1989,5688,956,94,40,18648
5/29/2018,19,9887,1688,5698,1259,23,38,18593
5/29/2018,20,9881,1738,5411,1556,5,32,18623
5/29/2018,21,9877,1624,4918,1826,0,25,18270
5/29/2018,22,9871,949,4559,1492,0,26,16897
5/29/2018,23,9867,619,4387,905,0,18,15796
5/29/2018,24,9865,331,3888,866,0,14,14964
5/30/2018,1,9873,279,3486,1078,0,13,14729
5/30/2018,2,9865,239,3275,894,0,13,14286
5/30/2018,3,9878,257,3295,979,0,13,14422
5/30/2018,4,9875,293,3325,831,0,12,14336
5/30/2018,5,9857,332,3719,655,0,13,14576
5/30/2018,6,9867,499,4105,559,5,22,15057
5/30/2018,7,9868,700,4478,660,49,26,15781
5/30/2018,8,9865,943,4894,426,126,26,16280
5/30/2018,9,9861,1161,4939,285,133,26,16405
5/30/2018,10,9861,1367,5044,439,249,26,16986
5/30/2018,11,9853,1597,4877,504,226,26,17083
5/30/2018,12,9854,1686,4859,572,299,26,17296
5/30/2018,13,9720,1900,5030,1032,306,26,18014
5/30/2018,14,9677,1982,5067,1130,312,26,18194
5/30/2018,15,9813,2343,5263,1392,270,26,19107
5/30/2018,16,9790,2226,5205,1799,196,33,19249
5/30/2018,17,9711,2191,5470,2113,145,43,19673
5/30/2018,18,9712,1853,5426,2551,79,46,19667
5/30/2018,19,9715,1756,5220,2695,24,46,19456
5/30/2018,20,9708,1415,5138,2994,5,49,19309
5/30/2018,21,9703,1250,5229,3276,0,41,19499
5/30/2018,22,9691,918,5034,3314,0,26,18983
5/30/2018,23,9626,458,4231,3477,0,16,17808
5/30/2018,24,9628,370,3430,3587,0,14,17029
5/31/2018,1,9632,371,3308,2410,0,15,15736
5/31/2018,2,9630,371,3335,2011,0,15,15362
5/31/2018,3,9638,369,3282,1778,0,13,15080
5/31/2018,4,9639,370,3334,1692,0,13,15048
5/31/2018,5,9572,387,3273,2062,0,16,15310
5/31/2018,6,9578,392,3667,2636,4,23,16300
5/31/2018,7,9579,455,4191,2990,27,28,17270
5/31/2018,8,9578,463,4920,3071,65,31,18128
5/31/2018,9,9576,683,4833,2866,114,58,18130
5/31/2018,10,9575,920,5082,2664,174,56,18471
5/31/2018,11,9573,1058,5173,2967,207,39,19017
5/31/2018,12,9563,1106,5283,2846,204,28,19030
5/31/2018,13,9566,1498,5619,2662,207,26,19578
5/31/2018,14,9565,1878,5472,2451,215,30,19611
5/31/2018,15,9566,2319,5463,2272,224,52,19896
5/31/2018,16,9565,2533,4937,2299,148,55,19537
5/31/2018,17,9559,2596,5217,1976,94,55,19497
5/31/2018,18,9557,2617,5360,1659,62,49,19304
5/31/2018,19,9557,2603,5343,1423,27,47,19000
5/31/2018,20,9556,2611,5319,1337,8,50,18881
5/31/2018,21,9545,2550,5510,1113,0,50,18768
5/31/2018,22,9535,2084,4891,1032,0,38,17580
5/31/2018,23,9567,919,4668,1279,0,19,16452
5/31/2018,24,9196,460,4554,1319,0,16,15545
6/1/2018,1,8744,468,4265,1052,0,13,14542
6/1/2018,2,8742,446,4129,961,0,15,14293
6/1/2018,3,8745,442,4577,845,0,14,14623
6/1/2018,4,9029,470,4307,703,0,13,14522
6/1/2018,5,9132,719,3922,366,0,16,14155
6/1/2018,6,9133,1234,4213,266,7,21,14874
6/1/2018,7,9135,1758,4813,530,40,26,16302
6/1/2018,8,9096,2064,5663,415,75,26,17339
6/1/2018,9,9117,2302,5742,361,162,26,17710
6/1/2018,10,9118,2500,5720,291,212,26,17867
6/1/2018,11,9121,2567,5616,364,248,26,17942
6/1/2018,12,9117,2603,5678,502,270,26,18196
6/1/2018,13,9120,2669,5665,671,256,26,18407
6/1/2018,14,9122,2618,5850,677,182,26,18475
6/1/2018,15,9119,2781,5831,715,148,26,18620
6/1/2018,16,9117,2853,5967,789,193,26,18945
6/1/2018,17,9122,2855,5809,1249,161,28,19224
6/1/2018,18,9123,2409,5581,1464,70,33,18680
6/1/2018,19,9122,2418,5565,1429,21,26,18581
6/1/2018,20,9123,2266,4981,1601,8,28,18007
6/1/2018,21,9220,1581,4644,1610,0,29,17084
6/1/2018,22,9240,761,4520,1911,0,45,16477
6/1/2018,23,9304,563,4231,1545,0,36,15679
6/1/2018,24,9341,399,3716,1488,0,18,14962
6/2/2018,1,9340,351,3451,1581,0,2,14725
6/2/2018,2,9347,351,3331,1066,0,1,14096
6/2/2018,3,9338,352,3332,549,0,1,13572
6/2/2018,4,9077,350,3278,853,0,1,13559
6/2/2018,5,9054,349,3264,1018,0,1,13686
6/2/2018,6,9077,299,3291,1316,7,1,13991
6/2/2018,7,9345,294,3434,1220,38,1,14332
6/2/2018,8,9359,295,3961,1116,97,1,14829
6/2/2018,9,9360,292,4275,812,157,1,14897
6/2/2018,10,9354,290,4534,640,199,1,15018
6/2/2018,11,9343,291,5205,503,236,1,15579
6/2/2018,12,9341,389,4592,630,276,1,15229
6/2/2018,13,9345,438,4543,580,267,1,15174
6/2/2018,14,9350,607,4526,606,281,1,15371
6/2/2018,15,9346,756,4417,501,277,1,15298
6/2/2018,16,9341,941,4586,456,245,1,15570
6/2/2018,17,9335,995,5177,501,179,1,16188
6/2/2018,18,9327,1111,5562,461,97,1,16559
6/2/2018,19,9323,1167,5768,381,25,1,16665
6/2/2018,20,9320,1120,5652,345,5,1,16443
6/2/2018,21,9329,966,5119,493,0,1,15908
6/2/2018,22,9333,596,4706,448,0,1,15084
6/2/2018,23,9316,522,4145,287,0,1,14271
6/2/2018,24,8764,360,4288,417,0,1,13830
6/3/2018,1,8800,337,3959,646,0,1,13743
6/3/2018,2,9239,338,3611,637,0,1,13826
6/3/2018,3,9435,337,3256,624,0,1,13653
6/3/2018,4,9449,336,3182,542,0,1,13510
6/3/2018,5,9444,340,3087,507,1,1,13380
6/3/2018,6,9445,344,3093,188,6,1,13077
6/3/2018,7,9442,343,3321,334,54,1,13495
6/3/2018,8,9434,342,3660,355,125,1,13917
6/3/2018,9,9433,344,4216,307,181,1,14482
6/3/2018,10,9435,343,4828,204,148,1,14959
6/3/2018,11,9439,347,5276,213,105,1,15381
6/3/2018,12,9440,445,5031,177,101,1,15195
6/3/2018,13,9444,497,5010,308,119,7,15385
6/3/2018,14,9406,586,5188,200,154,4,15538
6/3/2018,15,9443,645,5265,481,112,1,15947
6/3/2018,16,9445,762,5453,748,69,1,16478
6/3/2018,17,9511,983,5580,645,42,2,16763
6/3/2018,18,9541,784,5571,763,34,1,16694
6/3/2018,19,9552,748,5141,1086,13,1,16541
6/3/2018,20,9547,756,4610,1585,2,1,16501
6/3/2018,21,9547,757,4464,1116,0,1,15885
6/3/2018,22,9546,462,4282,1109,0,1,15400
6/3/2018,23,9550,349,3942,1037,0,1,14879
6/3/2018,24,9557,348,3500,1354,0,1,14760
6/4/2018,1,9559,346,3223,1219,0,1,14348
6/4/2018,2,9575,348,3223,897,0,7,14050
6/4/2018,3,9566,349,3210,783,0,12,13920
6/4/2018,4,9574,348,3184,813,0,13,13932
6/4/2018,5,9573,351,3272,1018,0,14,14228
6/4/2018,6,9572,370,3723,1387,3,21,15076
6/4/2018,7,9571,444,4095,2056,27,25,16218
6/4/2018,8,9561,545,4544,1932,54,26,16662
6/4/2018,9,9565,543,4572,2311,87,25,17103
6/4/2018,10,9571,497,4687,2436,149,25,17365
6/4/2018,11,9569,551,4539,2434,173,28,17294
6/4/2018,12,9573,656,4418,2353,169,26,17195
6/4/2018,13,9572,772,4314,2288,197,26,17169
6/4/2018,14,9571,917,4307,1658,205,26,16684
6/4/2018,15,9561,918,4389,1051,185,26,16130
6/4/2018,16,9560,922,4442,1368,193,26,16511
6/4/2018,17,9565,950,4512,1424,136,26,16613
6/4/2018,18,9570,1088,4700,1456,57,26,16897
6/4/2018,19,9567,959,4761,1579,23,26,16915
6/4/2018,20,9569,705,4924,1740,4,26,16968
6/4/2018,21,9585,677,4716,1850,0,26,16854
6/4/2018,22,9600,677,4593,1712,0,26,16608
6/4/2018,23,9621,683,3969,1302,0,18,15593
6/4/2018,24,9627,425,3458,854,0,14,14378
6/5/2018,1,9638,272,3384,657,0,14,13965
6/5/2018,2,9637,230,3310,463,0,14,13654
6/5/2018,3,9645,230,3338,323,0,14,13550
6/5/2018,4,9649,231,3299,434,0,14,13627
6/5/2018,5,9642,230,3455,615,0,14,13956
6/5/2018,6,9641,231,3746,905,11,19,14553
6/5/2018,7,9643,271,4322,1288,50,26,15600
6/5/2018,8,9642,316,4664,1286,111,26,16045
6/5/2018,9,9643,377,4601,1203,170,26,16020
6/5/2018,10,9641,498,4731,1369,194,26,16459
6/5/2018,11,9641,667,4818,1365,200,26,16717
6/5/2018,12,9640,838,4780,1214,182,26,16680
6/5/2018,13,9638,1206,4549,1223,187,26,16829
6/5/2018,14,9643,1431,4398,735,187,27,16421
6/5/2018,15,9654,1506,4476,553,116,26,16331
6/5/2018,16,9648,1629,4771,660,102,26,16836
6/5/2018,17,9646,1660,4859,672,79,26,16942
6/5/2018,18,9650,1658,4911,582,39,26,16866
6/5/2018,19,9648,1453,4885,899,22,26,16933
6/5/2018,20,9648,1287,5059,1056,4,26,17080
6/5/2018,21,9646,1112,5315,888,0,26,16987
6/5/2018,22,9645,703,4772,594,0,26,15740
6/5/2018,23,9648,328,4525,616,0,18,15135
6/5/2018,24,9649,238,4020,642,0,13,14562
6/6/2018,1,9640,240,3851,472,0,13,14216
6/6/2018,2,9640,239,3516,444,0,13,13852
6/6/2018,3,9649,240,3476,539,0,12,13916
6/6/2018,4,9647,224,3447,628,0,13,13959
6/6/2018,5,9641,314,3597,259,1,17,13829
6/6/2018,6,9649,466,3961,447,11,23,14557
6/6/2018,7,9646,570,4666,310,53,26,15271
6/6/2018,8,9642,572,5230,251,105,26,15826
6/6/2018,9,9643,572,4974,219,139,26,15573
6/6/2018,10,9647,649,4971,343,156,26,15792
6/6/2018,11,9652,702,4690,394,191,26,15655
6/6/2018,12,9650,846,4755,416,203,26,15896
6/6/2018,13,9643,1192,4692,236,192,26,15981
6/6/2018,14,9636,1489,4737,217,162,26,16267
6/6/2018,15,9633,1746,4634,221,154,26,16414
6/6/2018,16,9634,1783,4633,249,143,26,16468
6/6/2018,17,9639,1763,4809,270,138,26,16645
6/6/2018,18,9645,1752,4727,428,74,26,16652
6/6/2018,19,9641,1584,5201,470,27,26,16949
6/6/2018,20,9642,1566,5291,412,7,26,16944
6/6/2018,21,9639,1297,4832,387,0,26,16181
6/6/2018,22,9640,865,4318,390,0,26,15239
6/6/2018,23,9638,557,3868,574,0,15,14652
6/6/2018,24,9637,252,3638,739,0,13,14279
6/7/2018,1,9637,227,3599,811,0,13,14287
6/7/2018,2,9464,227,3506,925,0,12,14134
6/7/2018,3,9430,226,3526,825,0,13,14020
6/7/2018,4,9431,235,3552,737,0,14,13969
6/7/2018,5,9426,310,3662,838,0,12,14248
6/7/2018,6,9433,461,3789,909,8,21,14621
6/7/2018,7,9435,724,4536,934,35,27,15691
6/7/2018,8,9437,1058,4533,816,75,44,15963
6/7/2018,9,9434,1473,4480,716,166,45,16314
6/7/2018,10,9421,1988,4433,477,260,48,16627
6/7/2018,11,9411,2079,4549,353,247,43,16682
6/7/2018,12,9414,2098,4521,388,242,44,16707
6/7/2018,13,9277,2108,4532,545,278,45,16785
6/7/2018,14,9253,2104,4648,442,235,45,16727
6/7/2018,15,9409,2016,4621,404,251,42,16743
6/7/2018,16,9422,1936,4605,406,239,34,16642
6/7/2018,17,9425,1955,4618,232,161,27,16418
6/7/2018,18,9429,1781,5031,163,60,26,16490
6/7/2018,19,9432,1499,5150,355,34,27,16497
6/7/2018,20,9430,1113,5585,332,7,26,16493
6/7/2018,21,9423,1339,5751,331,0,26,16870
6/7/2018,22,9428,1007,4886,316,0,26,15663
6/7/2018,23,9429,440,4703,295,0,18,14885
6/7/2018,24,9422,185,4402,275,0,13,14297
6/8/2018,1,9424,187,4108,265,0,12,13996
6/8/2018,2,9418,185,4247,323,0,12,14185
6/8/2018,3,9418,189,4004,509,0,13,14133
6/8/2018,4,9419,191,3686,635,0,12,13943
6/8/2018,5,9421,282,3525,611,0,13,13852
6/8/2018,6,9418,366,3921,570,12,19,14306
6/8/2018,7,9422,468,4797,590,57,25,15359
6/8/2018,8,9420,622,5204,327,129,26,15728
6/8/2018,9,9416,821,5088,226,216,26,15793
6/8/2018,10,9416,1090,4888,203,281,26,15904
6/8/2018,11,9419,1226,5064,188,300,26,16223
6/8/2018,12,9418,1436,5219,182,302,26,16583
6/8/2018,13,9414,1619,5151,269,301,27,16781
6/8/2018,14,9412,1819,5086,379,293,26,17015
6/8/2018,15,9409,1796,4652,488,285,26,16656
6/8/2018,16,9414,1757,4861,486,245,26,16789
6/8/2018,17,9418,1787,5167,661,189,28,17250
6/8/2018,18,9417,1790,5164,478,96,26,16971
6/8/2018,19,9419,1793,5798,446,28,26,17510
6/8/2018,20,9423,1821,5815,323,5,26,17413
6/8/2018,21,9422,1815,5762,389,0,26,17414
6/8/2018,22,9423,1048,4972,473,0,26,15942
6/8/2018,23,9421,365,4583,447,0,19,14835
6/8/2018,24,9420,184,4493,346,0,10,14453
6/9/2018,1,9416,183,4078,298,0,1,13976
6/9/2018,2,9417,184,4108,294,0,1,14004
6/9/2018,3,9416,184,3433,317,0,1,13351
6/9/2018,4,9424,183,3531,318,0,1,13457
6/9/2018,5,9425,184,3650,427,0,1,13687
6/9/2018,6,9427,184,3690,512,11,1,13825
6/9/2018,7,9427,283,3603,550,49,1,13913
6/9/2018,8,9424,409,4603,521,92,1,15050
6/9/2018,9,9424,610,5229,425,133,1,15822
6/9/2018,10,9427,680,5034,411,170,1,15723
6/9/2018,11,9427,746,5291,364,181,1,16010
6/9/2018,12,9424,746,5030,264,209,1,15674
6/9/2018,13,9429,757,4772,317,194,1,15470
6/9/2018,14,9429,808,4167,350,189,1,14944
6/9/2018,15,9385,931,4126,333,152,1,14928
6/9/2018,16,9426,933,4557,790,118,1,15825
6/9/2018,17,9428,931,4594,736,112,1,15802
6/9/2018,18,9426,931,5180,734,64,1,16336
6/9/2018,19,9426,759,5066,704,29,1,15985
6/9/2018,20,9425,720,5355,806,6,1,16313
6/9/2018,21,9427,562,5189,985,0,1,16164
6/9/2018,22,9423,537,4549,1138,0,1,15648
6/9/2018,23,9426,330,4003,1239,0,1,14999
6/9/2018,24,9421,187,3670,1185,0,1,14464
6/10/2018,1,9426,189,3476,1451,0,1,14543
6/10/2018,2,9427,188,3364,980,0,1,13960
6/10/2018,3,9422,188,3273,806,0,18,13707
6/10/2018,4,9428,188,3151,539,0,22,13328
6/10/2018,5,9430,188,3004,608,0,36,13266
6/10/2018,6,9432,188,3059,383,3,39,13104
6/10/2018,7,9432,188,3130,615,40,39,13444
6/10/2018,8,9432,186,3434,967,114,37,14170
6/10/2018,9,9428,186,3655,1219,171,29,14688
6/10/2018,10,9431,186,3725,1567,228,25,15162
6/10/2018,11,9430,186,3684,1673,242,19,15234
6/10/2018,12,9419,187,3770,1662,253,14,15305
6/10/2018,13,9419,291,3779,1689,240,10,15428
6/10/2018,14,9414,338,3755,1715,236,1,15459
6/10/2018,15,9411,403,3967,1600,234,1,15616
6/10/2018,16,9409,405,4111,1951,206,1,16083
6/10/2018,17,9406,409,4622,2098,146,1,16682
6/10/2018,18,9409,411,4912,1921,75,1,16729
6/10/2018,19,9402,415,5023,1649,26,1,16516
6/10/2018,20,9396,413,5239,1443,3,1,16495
6/10/2018,21,9400,412,5156,1472,0,2,16442
6/10/2018,22,9401,353,4154,1691,0,1,15600
6/10/2018,23,9403,187,3682,1612,0,1,14885
6/10/2018,24,9404,188,3566,1208,0,1,14367
6/11/2018,1,9409,188,3194,971,0,1,13763
6/11/2018,2,9410,187,3246,1044,0,9,13896
6/11/2018,3,9408,188,3199,951,0,12,13758
6/11/2018,4,9406,190,3129,955,0,11,13691
6/11/2018,5,9402,193,3112,834,0,15,13556
6/11/2018,6,9399,195,3369,1110,6,20,14099
6/11/2018,7,9411,220,3736,1913,47,26,15353
6/11/2018,8,9409,315,4071,1906,133,26,15860
6/11/2018,9,9413,433,3923,1897,215,26,15907
6/11/2018,10,9400,563,3912,1662,300,26,15863
6/11/2018,11,9404,589,3915,1716,329,26,15979
6/11/2018,12,9401,597,3898,1784,334,26,16040
6/11/2018,13,9400,645,4049,1770,334,26,16224
6/11/2018,14,9393,797,4097,1652,333,26,16298
6/11/2018,15,9385,836,4493,1533,325,26,16598
6/11/2018,16,9374,707,4935,1422,275,26,16739
6/11/2018,17,9376,628,5502,1253,203,26,16988
6/11/2018,18,9375,782,5319,1236,105,26,16843
6/11/2018,19,9377,1288,5630,1197,28,26,17546
6/11/2018,20,9371,1179,5344,1151,5,26,17076
6/11/2018,21,9376,1185,5368,1385,0,26,17340
6/11/2018,22,9384,786,4492,1610,0,29,16301
6/11/2018,23,9397,498,3458,1815,0,21,15189
6/11/2018,24,9398,451,3260,1715,0,12,14836
6/12/2018,1,9398,304,3062,1395,0,12,14171
6/12/2018,2,9399,216,2878,1497,0,10,14000
6/12/2018,3,9395,217,2930,1494,0,22,14058
6/12/2018,4,9392,240,2910,1329,0,24,13895
6/12/2018,5,9393,244,3004,985,0,22,13648
6/12/2018,6,9393,304,3361,797,7,26,13888
6/12/2018,7,9392,425,4676,766,53,31,15343
6/12/2018,8,9387,725,4210,563,145,26,15056
6/12/2018,9,9383,1178,4116,446,225,27,15375
6/12/2018,10,9382,1305,4337,290,289,26,15629
6/12/2018,11,9379,1369,4335,271,304,26,15684
6/12/2018,12,9375,1565,4319,267,319,26,15871
6/12/2018,13,9333,1710,5002,321,318,26,16710
6/12/2018,14,9368,1645,5033,452,311,26,16835
6/12/2018,15,9369,1810,5076,590,291,24,17160
6/12/2018,16,9378,1982,5525,743,225,26,17879
6/12/2018,17,9383,2290,5370,681,142,27,17893
6/12/2018,18,9390,2359,5135,518,68,26,17496
6/12/2018,19,9394,2136,5315,429,24,26,17324
6/12/2018,20,9392,2072,5241,525,3,26,17259
6/12/2018,21,9386,2169,4976,509,0,26,17066
6/12/2018,22,9388,1217,4641,628,0,26,15900
6/12/2018,23,9384,669,4001,670,0,17,14741
6/12/2018,24,9372,333,3997,639,0,14,14355
6/13/2018,1,9371,214,4252,598,0,13,14448
6/13/2018,2,9365,233,4199,712,0,13,14522
6/13/2018,3,9361,212,3844,745,0,12,14174
6/13/2018,4,9361,239,3824,659,0,13,14096
6/13/2018,5,9370,239,3529,662,0,16,13816
6/13/2018,6,9382,267,4464,700,1,20,14834
6/13/2018,7,9381,422,5094,727,23,26,15673
6/13/2018,8,9386,766,4726,864,60,26,15828
6/13/2018,9,9386,843,4692,1058,77,26,16082
6/13/2018,10,9382,668,4874,1108,148,26,16206
6/13/2018,11,9385,900,4672,1670,143,26,16796
6/13/2018,12,9377,1215,4357,2273,177,26,17425
6/13/2018,13,9374,1529,4510,2836,181,26,18456
6/13/2018,14,9361,1324,4487,3270,175,26,18643
6/13/2018,15,9354,1282,4686,3328,125,26,18801
6/13/2018,16,9347,1355,4723,3065,99,25,18614
6/13/2018,17,9332,1461,5021,3003,106,26,18949
6/13/2018,18,9329,1248,5057,3164,62,25,18885
6/13/2018,19,9326,1301,5005,2839,24,26,18521
6/13/2018,20,9338,1353,4924,2199,4,26,17844
6/13/2018,21,9351,628,4965,2315,0,25,17284
6/13/2018,22,9370,362,4458,2095,0,25,16310
6/13/2018,23,9385,255,3911,1802,0,17,15370
6/13/2018,24,9398,235,3537,1881,0,13,15064
6/14/2018,1,9410,235,3173,1882,0,13,14713
6/14/2018,2,9415,239,2905,1519,0,11,14089
6/14/2018,3,9420,239,2945,1460,0,12,14076
6/14/2018,4,9420,236,2941,1385,0,13,13995
6/14/2018,5,9416,236,2964,1723,0,14,14353
6/14/2018,6,9415,245,3396,1939,3,24,15022
6/14/2018,7,9415,326,3816,2054,35,26,15672
6/14/2018,8,9414,333,4446,1930,102,25,16250
6/14/2018,9,9410,559,4828,1770,173,26,16766
6/14/2018,10,9412,776,4220,1501,245,26,16180
6/14/2018,11,9413,897,4325,1443,289,26,16393
6/14/2018,12,9414,884,4331,1431,276,26,16362
6/14/2018,13,9412,974,4402,1730,268,26,16812
6/14/2018,14,9410,1164,4445,1733,256,26,17034
6/14/2018,15,9407,1450,4589,1710,234,26,17416
6/14/2018,16,9404,1636,4987,1723,199,26,17975
6/14/2018,17,9408,1658,5377,1485,150,26,18104
6/14/2018,18,9409,1695,5535,1062,93,26,17820
6/14/2018,19,9413,1556,5561,709,46,26,17311
6/14/2018,20,9414,1428,5497,438,25,26,16828
6/14/2018,21,9419,1173,5361,430,0,26,16409
6/14/2018,22,9412,815,4747,456,0,26,15456
6/14/2018,23,9416,299,4381,399,0,16,14511
6/14/2018,24,9426,218,4146,375,0,14,14179
6/15/2018,1,9431,217,3941,430,0,13,14032
6/15/2018,2,9433,235,3677,375,0,14,13734
6/15/2018,3,9434,247,3628,310,0,16,13635
6/15/2018,4,9429,274,3807,277,0,14,13801
6/15/2018,5,9432,453,3731,271,0,14,13901
6/15/2018,6,9430,646,3913,231,6,34,14260
6/15/2018,7,9431,847,4238,206,51,40,14813
6/15/2018,8,9434,863,4725,123,146,27,15318
6/15/2018,9,9427,887,4965,67,234,36,15616
6/15/2018,10,9433,1040,4871,63,295,32,15734
6/15/2018,11,9429,1343,4875,103,300,27,16077
6/15/2018,12,9428,1612,5323,98,308,29,16798
6/15/2018,13,9427,1673,4858,185,289,27,16459
6/15/2018,14,9430,1828,4484,289,288,26,16345
6/15/2018,15,9438,1921,4518,429,273,30,16609
6/15/2018,16,9432,2025,5035,414,237,30,17173
6/15/2018,17,9434,1988,5180,383,181,26,17192
6/15/2018,18,9441,1552,5545,407,94,26,17065
6/15/2018,19,9449,1591,5609,375,31,26,17081
6/15/2018,20,9442,1547,5336,316,6,26,16673
6/15/2018,21,9434,1140,5219,436,0,26,16255
6/15/2018,22,9431,903,4957,428,0,26,15745
6/15/2018,23,9440,370,4778,467,0,14,15069
6/15/2018,24,9442,246,4359,451,0,4,14502
6/16/2018,1,9449,244,3848,372,0,1,13914
6/16/2018,2,9451,237,4066,398,0,1,14153
6/16/2018,3,9452,237,3546,539,0,1,13775
6/16/2018,4,9453,235,3473,648,0,1,13810
6/16/2018,5,9514,234,3342,626,0,1,13717
6/16/2018,6,9678,235,3278,572,11,1,13775
6/16/2018,7,9683,338,3753,649,47,1,14471
6/16/2018,8,9681,400,3926,434,101,1,14543
6/16/2018,9,9645,489,3963,512,157,1,14767
6/16/2018,10,9632,746,4180,526,186,1,15271
6/16/2018,11,9636,774,4885,356,242,1,15894
6/16/2018,12,9631,835,5033,220,247,2,15968
6/16/2018,13,9633,949,5360,289,298,5,16534
6/16/2018,14,9599,890,5047,387,287,2,16212
6/16/2018,15,9637,1027,5178,331,230,1,16404
6/16/2018,16,9770,1332,5107,337,178,1,16725
6/16/2018,17,9825,1480,5481,248,168,1,17203
6/16/2018,18,9823,1715,5474,156,88,1,17257
6/16/2018,19,9821,1672,5399,106,30,1,17029
6/16/2018,20,9872,1500,5391,42,6,2,16813
6/16/2018,21,9991,1414,5584,71,0,15,17075
6/16/2018,22,10004,1582,5260,120,0,3,16969
6/16/2018,23,10007,740,4683,202,0,1,15633
6/16/2018,24,10008,304,4085,186,0,1,14584
6/17/2018,1,10016,225,3517,216,0,1,13975
6/17/2018,2,10025,226,3410,339,0,1,14001
6/17/2018,3,10017,223,3208,371,0,1,13820
6/17/2018,4,10020,240,3204,522,0,1,13987
6/17/2018,5,10021,255,3191,389,1,1,13858
6/17/2018,6,10021,314,3212,109,2,1,13659
6/17/2018,7,10021,583,3430,259,43,2,14338
6/17/2018,8,10013,843,3970,164,103,3,15096
6/17/2018,9,10007,1186,4356,315,200,22,16086
6/17/2018,10,10009,1584,4428,493,257,42,16813
6/17/2018,11,10004,1827,4710,630,288,40,17499
6/17/2018,12,10003,2139,5066,740,291,41,18280
6/17/2018,13,10080,2489,5022,675,293,28,18587
6/17/2018,14,10102,2573,5349,619,282,18,18943
6/17/2018,15,10100,2517,5279,795,264,19,18974
6/17/2018,16,10095,2505,5098,1139,228,25,19090
6/17/2018,17,10097,2514,5040,1335,163,24,19173
6/17/2018,18,10092,2530,4972,1464,82,26,19166
6/17/2018,19,10092,2533,5154,1493,31,25,19328
6/17/2018,20,10092,2440,5095,1614,7,25,19273
6/17/2018,21,10089,2162,5301,1817,0,23,19392
6/17/2018,22,10073,1418,5313,1861,0,7,18672
6/17/2018,23,10102,541,4797,2021,0,5,17466
6/17/2018,24,10155,374,4132,2169,0,1,16831
6/18/2018,1,10158,380,3804,2167,0,3,16512
6/18/2018,2,10161,392,4003,2150,0,1,16707
6/18/2018,3,10158,499,3561,2326,0,8,16552
6/18/2018,4,10156,827,3373,2298,0,14,16668
6/18/2018,5,10160,1274,3271,2153,0,14,16872
6/18/2018,6,10158,1673,3394,1950,1,20,17196
6/18/2018,7,10167,1990,4193,2010,36,25,18421
6/18/2018,8,10158,2383,4867,2006,88,25,19527
6/18/2018,9,10145,2656,5022,2090,142,25,20080
6/18/2018,10,10148,3300,4861,2195,178,26,20708
6/18/2018,11,10153,3269,4434,2382,243,36,20517
6/18/2018,12,10160,3149,4356,2280,206,37,20188
6/18/2018,13,10170,3286,4817,2038,115,40,20466
6/18/2018,14,10177,3379,4896,1930,149,41,20572
6/18/2018,15,10152,3391,4986,1931,137,39,20636
6/18/2018,16,10168,3501,4584,2118,121,43,20535
6/18/2018,17,10175,3137,5010,1766,94,47,20229
6/18/2018,18,10181,2914,5111,1804,41,44,20095
6/18/2018,19,10181,3022,5155,1294,20,41,19713
6/18/2018,20,10180,3238,5310,919,8,41,19696
6/18/2018,21,10186,3042,5216,881,0,35,19360
6/18/2018,22,10197,2542,4389,863,0,26,18017
6/18/2018,23,10201,1194,4243,799,0,19,16456
6/18/2018,24,10201,448,4120,840,0,16,15625
6/19/2018,1,10211,323,3706,710,0,13,14963
6/19/2018,2,10217,329,3693,663,0,14,14916
6/19/2018,3,10214,340,3727,742,0,12,15035
6/19/2018,4,10216,449,3761,750,0,12,15188
6/19/2018,5,10219,606,3357,709,0,15,14906
6/19/2018,6,10223,744,3530,539,6,21,15063
6/19/2018,7,10208,746,3774,700,40,26,15494
6/19/2018,8,10211,834,4243,857,103,26,16274
6/19/2018,9,10229,1086,4439,808,157,26,16745
6/19/2018,10,10233,1470,4583,718,192,26,17222
6/19/2018,11,10232,1560,4776,558,297,25,17448
6/19/2018,12,10231,1585,4877,353,306,26,17378
6/19/2018,13,10229,1583,4770,279,295,26,17182
6/19/2018,14,10225,1563,4907,352,296,26,17369
6/19/2018,15,10230,1646,4751,412,285,26,17350
6/19/2018,16,10227,1850,4867,398,233,28,17603
6/19/2018,17,10221,2091,5150,299,171,27,17959
6/19/2018,18,10217,2113,5147,263,81,26,17847
6/19/2018,19,10220,1832,5144,256,25,26,17503
6/19/2018,20,10221,1713,5183,229,5,26,17377
6/19/2018,21,10219,1588,5215,149,0,26,17197
6/19/2018,22,10220,859,5242,146,0,26,16493
6/19/2018,23,10218,353,4936,135,0,17,15659
6/19/2018,24,10234,253,4453,136,0,16,15092
6/20/2018,1,10234,222,3775,136,0,12,14379
6/20/2018,2,10233,220,3356,126,0,13,13948
6/20/2018,3,10231,223,3346,158,0,12,13970
6/20/2018,4,10234,225,3404,143,0,14,14020
6/20/2018,5,10238,330,3481,168,0,15,14232
6/20/2018,6,10244,549,3752,221,7,20,14793
6/20/2018,7,10243,828,4100,257,28,26,15482
6/20/2018,8,10242,1041,4577,309,67,26,16262
6/20/2018,9,10239,1438,4710,246,93,26,16752
6/20/2018,10,10241,1673,4479,151,156,26,16726
6/20/2018,11,10236,1654,4048,79,168,26,16211
6/20/2018,12,10225,1655,4176,102,200,26,16384
6/20/2018,13,10110,1655,4067,129,213,27,16201
6/20/2018,14,10079,1677,4111,174,252,26,16319
6/20/2018,15,10165,1687,4242,219,268,27,16608
6/20/2018,16,10411,1784,4525,265,250,26,17261
6/20/2018,17,10445,1859,4627,280,187,27,17425
6/20/2018,18,10654,1914,4720,228,96,26,17638
6/20/2018,19,10678,1443,5208,167,33,26,17555
6/20/2018,20,10704,1150,5189,167,6,26,17242
6/20/2018,21,10874,1117,4917,181,0,26,17115
6/20/2018,22,10880,924,4753,230,0,26,16813
6/20/2018,23,10889,500,4486,286,0,21,16182
6/20/2018,24,10889,275,3904,428,0,14,15510
6/21/2018,1,10901,188,3414,617,0,13,15133
6/21/2018,2,10906,190,3009,661,0,13,14779
6/21/2018,3,10906,186,2959,438,0,13,14502
6/21/2018,4,10854,187,2866,369,0,13,14289
6/21/2018,5,10722,188,2895,589,0,15,14409
6/21/2018,6,11021,204,3272,798,5,29,15329
6/21/2018,7,11062,246,3679,1046,46,36,16115
6/21/2018,8,11062,246,4095,860,120,41,16424
6/21/2018,9,11067,247,4038,629,235,41,16257
6/21/2018,10,11064,244,4067,531,301,27,16234
6/21/2018,11,11066,244,4267,483,322,27,16409
6/21/2018,12,11065,331,4158,469,326,26,16375
6/21/2018,13,11057,464,4064,472,315,26,16398
6/21/2018,14,11059,583,3998,377,313,26,16356
6/21/2018,15,11049,589,4075,461,300,26,16500
6/21/2018,16,11049,592,4851,769,272,26,17559
6/21/2018,17,11030,660,5636,873,184,26,18409
6/21/2018,18,11034,596,5144,851,102,26,17753
6/21/2018,19,11042,590,5609,770,27,26,18064
6/21/2018,20,11026,593,5387,827,6,26,17865
6/21/2018,21,11064,589,4613,874,0,26,17166
6/21/2018,22,11072,388,4448,814,0,26,16748
6/21/2018,23,11085,185,3615,1111,0,20,16016
6/21/2018,24,11088,178,3172,787,0,17,15242
6/22/2018,1,11020,186,3042,299,0,16,14563
6/22/2018,2,10553,188,3061,264,0,15,14081
6/22/2018,3,10243,185,2868,250,0,14,13560
6/22/2018,4,9976,183,2993,264,0,14,13430
6/22/2018,5,10033,178,2963,671,0,16,13861
6/22/2018,6,10512,205,3200,851,10,20,14798
6/22/2018,7,11025,238,3190,1431,51,26,15961
6/22/2018,8,11097,241,3224,1988,134,28,16712
6/22/2018,9,11091,229,3279,2145,182,44,16970
6/22/2018,10,11072,239,3377,2114,203,80,17085
6/22/2018,11,11079,236,3786,1696,259,98,17154
6/22/2018,12,11070,226,4115,1327,295,89,17122
6/22/2018,13,11062,209,4179,1660,205,81,17396
6/22/2018,14,11059,222,3956,1891,183,82,17393
6/22/2018,15,11059,303,3961,2009,176,102,17610
6/22/2018,16,11059,375,4241,1736,147,123,17681
6/22/2018,17,11065,440,4180,1935,89,144,17853
6/22/2018,18,11074,449,4261,1825,49,171,17829
6/22/2018,19,11063,465,4175,1870,15,176,17764
6/22/2018,20,11055,472,4277,1968,3,151,17926
6/22/2018,21,11054,479,4290,2210,0,187,18220
6/22/2018,22,10287,528,4344,2158,0,197,17514
6/22/2018,23,10193,233,3638,2082,0,186,16332
6/22/2018,24,10201,104,3171,1612,0,159,15247
6/23/2018,1,10199,118,3327,1031,0,67,14742
6/23/2018,2,10197,122,3278,822,0,18,14437
6/23/2018,3,10225,124,3116,742,0,1,14208
6/23/2018,4,10214,125,3231,634,0,1,14205
6/23/2018,5,9811,118,3293,475,0,1,13698
6/23/2018,6,9765,124,3211,752,2,1,13855
6/23/2018,7,9859,117,3615,760,17,5,14373
6/23/2018,8,10116,125,4452,584,54,7,15338
6/23/2018,9,10384,130,4945,426,76,29,15990
6/23/2018,10,10414,156,5180,418,89,72,16329
6/23/2018,11,10426,145,4793,366,85,155,15970
6/23/2018,12,10434,130,4626,185,125,173,15673
6/23/2018,13,10452,124,4890,76,145,172,15859
6/23/2018,14,10442,130,4722,42,119,172,15627
6/23/2018,15,10439,250,4608,68,98,172,15635
6/23/2018,16,10433,326,4703,94,96,172,15824
6/23/2018,17,10434,463,4666,82,33,166,15844
6/23/2018,18,10436,470,4591,188,17,111,15813
6/23/2018,19,10433,473,4337,217,10,120,15590
6/23/2018,20,10420,476,4368,294,2,126,15686
6/23/2018,21,10420,477,4717,261,0,29,15904
6/23/2018,22,10415,471,4567,185,0,1,15639
6/23/2018,23,10423,274,4046,126,0,1,14870
6/23/2018,24,10422,132,4030,147,0,1,14732
6/24/2018,1,10428,132,3613,120,0,1,14294
6/24/2018,2,10365,131,3368,147,0,1,14012
6/24/2018,3,10193,130,3414,169,0,1,13907
6/24/2018,4,10181,129,3157,206,0,1,13674
6/24/2018,5,9914,130,3390,281,0,1,13716
6/24/2018,6,9900,210,3460,306,1,1,13878
6/24/2018,7,9918,319,3559,384,23,5,14208
6/24/2018,8,9926,495,4115,369,61,6,14972
6/24/2018,9,10148,486,4500,373,109,27,15643
6/24/2018,10,10317,490,4824,453,132,75,16291
6/24/2018,11,10450,494,4676,533,146,159,16458
6/24/2018,12,10448,611,4229,707,121,170,16286
6/24/2018,13,10441,702,4548,594,126,170,16581
6/24/2018,14,10438,546,4251,735,108,170,16248
6/24/2018,15,10389,449,4622,786,121,170,16537
6/24/2018,16,10422,615,4543,1106,102,170,16958
6/24/2018,17,10427,712,4616,907,116,170,16948
6/24/2018,18,10431,751,4575,1074,69,170,17070
6/24/2018,19,10439,628,4634,1181,29,170,17081
6/24/2018,20,10433,570,4695,1073,6,134,16911
6/24/2018,21,10435,569,4721,941,0,58,16724
6/24/2018,22,10443,564,4084,787,0,85,15963
6/24/2018,23,10446,395,3726,887,0,101,15555
6/24/2018,24,10449,215,3131,881,0,9,14685
6/25/2018,1,10430,123,3144,586,0,1,14284
6/25/2018,2,10261,129,2989,451,0,1,13831
6/25/2018,3,10135,128,3067,532,0,1,13863
6/25/2018,4,9912,171,3191,692,0,11,13977
6/25/2018,5,9976,279,3128,814,0,16,14213
6/25/2018,6,10238,469,3377,726,7,23,14840
6/25/2018,7,10463,718,3692,673,44,56,15646
6/25/2018,8,10454,781,3916,621,139,98,16009
6/25/2018,9,10459,795,4101,460,241,167,16223
6/25/2018,10,10457,823,4169,452,295,190,16386
6/25/2018,11,10452,882,4247,435,315,195,16526
6/25/2018,12,10474,1034,4064,445,327,182,16526
6/25/2018,13,10519,1308,3974,439,331,145,16716
6/25/2018,14,10531,1261,4125,543,326,96,16882
6/25/2018,15,10563,1293,4191,544,314,82,16987
6/25/2018,16,10601,1116,4360,461,273,80,16891
6/25/2018,17,10612,1075,4482,478,211,88,16946
6/25/2018,18,10611,1077,5316,441,113,117,17675
6/25/2018,19,10607,1094,5366,307,29,138,17541
6/25/2018,20,10599,1109,5142,227,6,138,17221
6/25/2018,21,10595,768,4821,314,0,139,16637
6/25/2018,22,10595,340,4476,462,0,122,15995
6/25/2018,23,10604,204,3803,525,0,26,15162
6/25/2018,24,10548,201,3341,590,0,13,14693
6/26/2018,1,10074,203,3331,551,0,13,14172
6/26/2018,2,9763,203,3244,554,0,12,13776
6/26/2018,3,9739,212,3118,465,0,13,13547
6/26/2018,4,9736,222,3103,518,1,14,13594
6/26/2018,5,9816,236,3064,725,1,20,13862
6/26/2018,6,10298,260,3284,706,12,22,14582
6/26/2018,7,10597,323,3697,1026,52,26,15721
6/26/2018,8,10596,321,3889,917,136,26,15885
6/26/2018,9,10609,335,4132,894,213,26,16209
6/26/2018,10,10570,366,4073,825,274,26,16134
6/26/2018,11,10593,370,4222,807,312,26,16330
6/26/2018,12,10596,367,4246,777,324,26,16336
6/26/2018,13,10437,374,4217,807,324,26,16185
6/26/2018,14,10513,374,4360,733,319,26,16325
6/26/2018,15,10602,329,4480,674,299,26,16410
6/26/2018,16,10592,353,5016,674,245,26,16906
6/26/2018,17,10591,345,5276,882,188,26,17308
6/26/2018,18,10596,316,4903,1242,96,26,17179
6/26/2018,19,10597,319,4570,1382,36,26,16930
6/26/2018,20,10598,327,4476,1554,7,26,16988
6/26/2018,21,10595,322,4424,1707,0,26,17074
6/26/2018,22,10593,320,4278,1603,0,27,16821
6/26/2018,23,10588,278,3661,1493,0,15,16035
6/26/2018,24,10590,285,3317,865,0,13,15070
6/27/2018,1,10579,267,3190,468,0,13,14517
6/27/2018,2,10208,266,3159,505,0,14,14152
6/27/2018,3,9987,261,3260,455,0,13,13976
6/27/2018,4,9732,269,3307,789,1,13,14111
6/27/2018,5,9796,273,3292,901,1,14,14277
6/27/2018,6,10264,339,3558,1114,5,19,15299
6/27/2018,7,10581,442,3570,1219,16,27,15855
6/27/2018,8,10574,651,4002,976,46,27,16276
6/27/2018,9,10578,986,4054,921,79,27,16645
6/27/2018,10,10576,1157,4086,1055,89,27,16990
6/27/2018,11,10577,1194,4349,1033,106,27,17286
6/27/2018,12,10579,1278,4303,1119,100,27,17406
6/27/2018,13,10583,1614,4717,1100,90,27,18131
6/27/2018,14,10441,1675,4597,1032,99,27,17871
6/27/2018,15,10416,1776,4542,890,107,28,17759
6/27/2018,16,10515,1805,4705,729,91,26,17871
6/27/2018,17,10581,1583,4643,568,66,26,17467
6/27/2018,18,10594,1352,4564,420,38,26,16994
6/27/2018,19,10596,1115,4848,299,19,26,16903
6/27/2018,20,10591,1072,5023,219,5,26,16936
6/27/2018,21,10589,1232,4818,266,0,26,16931
6/27/2018,22,10587,561,4576,454,0,26,16204
6/27/2018,23,10594,351,3705,409,0,8,15067
6/27/2018,24,10587,315,3301,419,0,1,14623
6/28/2018,1,10592,167,3221,511,0,1,14492
6/28/2018,2,10593,114,3106,608,0,1,14422
6/28/2018,3,10590,195,3144,332,0,1,14262
6/28/2018,4,10588,277,3160,308,0,4,14337
6/28/2018,5,10597,453,3106,522,1,15,14694
6/28/2018,6,10617,868,3423,485,3,21,15417
6/28/2018,7,10628,1379,3981,446,32,27,16493
6/28/2018,8,10624,1556,4041,356,74,30,16681
6/28/2018,9,10620,1567,4055,270,139,27,16678
6/28/2018,10,10636,1640,4196,230,218,27,16947
6/28/2018,11,10657,1975,4336,209,224,26,17427
6/28/2018,12,10663,2376,4215,174,265,26,17719
6/28/2018,13,10665,2618,4334,188,267,26,18098
6/28/2018,14,10667,2601,4703,278,272,27,18548
6/28/2018,15,10669,2735,4765,516,224,26,18935
6/28/2018,16,10671,2856,5163,723,230,26,19669
6/28/2018,17,10666,2956,5352,760,171,27,19932
6/28/2018,18,10671,3243,5371,707,95,28,20115
6/28/2018,19,10671,3760,5238,729,30,29,20457
6/28/2018,20,10671,3623,5112,755,6,30,20197
6/28/2018,21,10691,2526,4937,824,0,29,19007
6/28/2018,22,10683,2195,4721,882,0,29,18510
6/28/2018,23,10683,693,4339,947,0,18,16680
6/28/2018,24,10675,232,3875,1015,0,10,15807
6/29/2018,1,10701,143,3161,830,0,11,14846
6/29/2018,2,10704,151,3064,598,0,11,14528
6/29/2018,3,10702,165,3145,597,0,11,14620
6/29/2018,4,10704,376,3200,557,0,12,14849
6/29/2018,5,10697,854,3135,249,0,17,14952
6/29/2018,6,10704,1515,3512,245,3,22,16001
6/29/2018,7,10707,2003,4140,139,41,28,17058
6/29/2018,8,10705,2368,4438,42,133,28,17714
6/29/2018,9,10696,2475,4554,23,219,27,17994
6/29/2018,10,10700,2731,4771,86,284,27,18599
6/29/2018,11,10693,2879,5099,145,316,29,19161
6/29/2018,12,10694,3045,5158,344,324,48,19613
6/29/2018,13,10682,3123,5062,653,314,88,19922
6/29/2018,14,10672,3133,5053,845,309,172,20184
6/29/2018,15,10677,3067,5192,1032,298,179,20445
6/29/2018,16,10666,2922,5260,1054,246,162,20310
6/29/2018,17,10673,3571,5144,1173,169,148,20878
6/29/2018,18,10703,3302,5008,1498,88,161,20760
6/29/2018,19,10707,3023,5003,1630,30,156,20549
6/29/2018,20,10703,2668,4908,1700,7,149,20135
6/29/2018,21,10694,2266,4802,1927,0,173,19862
6/29/2018,22,10694,1416,4499,2125,0,171,18905
6/29/2018,23,10700,466,4463,2250,0,132,18011
6/29/2018,24,10709,179,4021,2309,0,24,17242
6/30/2018,1,10722,199,3566,2299,0,1,16787
6/30/2018,2,10734,180,3129,2021,0,1,16065
6/30/2018,3,10730,173,3127,1734,0,1,15765
6/30/2018,4,10730,200,3108,1659,0,2,15699
6/30/2018,5,10720,214,3073,1486,0,1,15494
6/30/2018,6,10726,294,3233,1579,1,1,15834
6/30/2018,7,10735,614,3276,1250,24,1,15900
6/30/2018,8,10727,1089,3829,788,99,2,16534
6/30/2018,9,10733,1806,3984,1325,182,6,18036
6/30/2018,10,10730,2075,4127,1399,200,34,18565
6/30/2018,11,10728,2214,4613,1462,262,114,19393
6/30/2018,12,10719,2535,4753,1517,289,137,19950
6/30/2018,13,10728,2822,4880,1425,308,150,20313
6/30/2018,14,10729,2714,5070,1436,291,125,20365
6/30/2018,15,10722,2669,4846,1867,274,104,20482
6/30/2018,16,10724,2657,4761,1994,222,101,20459
6/30/2018,17,10725,2779,4808,2182,155,98,20747
6/30/2018,18,10725,2858,4866,2018,78,96,20641
6/30/2018,19,10718,2896,5043,1652,31,93,20433
6/30/2018,20,10717,2644,5241,1542,7,12,20163
6/30/2018,21,10832,2606,5066,1814,0,8,20326
6/30/2018,22,10954,1629,4542,2200,0,2,19327
6/30/2018,23,10959,615,4306,2111,0,1,17992
6/30/2018,24,10962,299,3888,2020,0,1,17170
7/1/2018,1,10959,286,3226,1714,0,1,16186
7/1/2018,2,10961,288,3354,1377,0,1,15981
7/1/2018,3,10961,287,3551,1387,0,1,16187
7/1/2018,4,10965,289,3219,1339,0,1,15813
7/1/2018,5,11017,291,3463,1164,0,1,15936
7/1/2018,6,11097,495,3245,862,1,1,15701
7/1/2018,7,11090,981,3379,503,38,1,15992
7/1/2018,8,11084,1533,3545,382,120,1,16665
7/1/2018,9,11082,2182,3812,349,183,2,17610
7/1/2018,10,11073,2348,4395,454,251,27,18548
7/1/2018,11,11060,2497,4687,607,288,67,19206
7/1/2018,12,11053,2676,4444,946,310,111,19540
7/1/2018,13,11042,2734,5110,1315,310,124,20635
7/1/2018,14,11043,2749,4820,1569,310,117,20608
7/1/2018,15,11041,2841,4182,1570,290,78,20002
7/1/2018,16,11046,2604,4704,1638,246,65,20303
7/1/2018,17,11052,2349,5320,1729,180,19,20649
7/1/2018,18,11059,2311,5396,1630,79,6,20481
7/1/2018,19,11061,2077,5442,1551,26,5,20162
7/1/2018,20,11065,1974,5098,1637,6,5,19785
7/1/2018,21,11068,1606,4591,2050,0,1,19316
7/1/2018,22,11071,1386,4162,2439,0,1,19059
7/1/2018,23,11072,651,4050,2598,0,1,18372
7/1/2018,24,11058,240,3620,2769,0,1,17688
7/2/2018,1,11046,277,3415,2618,0,1,17357
7/2/2018,2,11075,259,2915,2460,0,1,16710
7/2/2018,3,11090,305,2868,1981,0,1,16245
7/2/2018,4,11071,474,2937,1521,0,1,16004
7/2/2018,5,11075,893,2865,1101,0,1,15935
7/2/2018,6,11080,1250,3035,683,1,1,16050
7/2/2018,7,11073,1392,3590,1034,32,2,17123
7/2/2018,8,11067,1469,3752,1056,107,1,17452
7/2/2018,9,11062,1691,4309,1056,162,2,18282
7/2/2018,10,11068,2438,4729,965,225,30,19455
7/2/2018,11,11073,3036,4773,823,261,64,20030
7/2/2018,12,11079,3283,4745,867,289,137,20400
7/2/2018,13,11088,3198,4828,814,290,166,20384
7/2/2018,14,11098,3061,4858,901,281,167,20366
7/2/2018,15,11097,3315,4747,920,261,136,20476
7/2/2018,16,11094,3465,4453,776,243,80,20111
7/2/2018,17,11095,3405,5116,882,148,32,20678
7/2/2018,18,11104,3418,5101,628,79,19,20349
7/2/2018,19,11113,3479,5329,540,33,20,20514
7/2/2018,20,11104,3241,5058,561,8,12,19984
7/2/2018,21,11095,3117,5004,497,0,1,19714
7/2/2018,22,11102,2775,4480,422,0,1,18780
7/2/2018,23,11115,2218,3584,357,0,1,17275
7/2/2018,24,11118,1060,3175,205,0,1,15559
7/3/2018,1,11117,640,3024,274,0,1,15056
7/3/2018,2,11112,450,2993,204,0,1,14760
7/3/2018,3,11123,437,2958,138,0,3,14659
7/3/2018,4,11132,585,2912,147,0,12,14788
7/3/2018,5,11139,879,2914,110,0,16,15058
7/3/2018,6,11144,1225,3422,254,2,23,16070
7/3/2018,7,11147,1673,3827,269,30,32,16978
7/3/2018,8,11138,2019,4021,146,94,44,17462
7/3/2018,9,11134,2337,3988,168,160,84,17871
7/3/2018,10,11138,2668,4391,336,279,160,18972
7/3/2018,11,11119,2701,4684,493,307,178,19482
7/3/2018,12,11114,2767,4797,576,306,181,19741
7/3/2018,13,11117,2916,4775,623,317,184,19932
7/3/2018,14,11124,2824,5107,607,298,190,20150
7/3/2018,15,11115,3090,5286,484,291,212,20478
7/3/2018,16,11111,3348,5230,453,238,175,20555
7/3/2018,17,11113,3489,5374,499,169,126,20770
7/3/2018,18,11119,3684,5502,523,91,134,21053
7/3/2018,19,11126,3764,5493,540,29,141,21093
7/3/2018,20,11118,3335,5395,504,8,198,20558
7/3/2018,21,11123,3014,4747,634,0,201,19719
7/3/2018,22,11135,2652,4445,791,0,173,19196
7/3/2018,23,11133,1678,4066,756,0,87,17720
7/3/2018,24,11146,930,3599,810,0,28,16513
7/4/2018,1,11143,334,3370,846,0,13,15706
7/4/2018,2,11138,280,3036,704,0,13,15171
7/4/2018,3,11126,296,3104,591,0,12,15129
7/4/2018,4,11124,397,3300,311,0,13,15145
7/4/2018,5,11131,731,3053,156,0,14,15085
7/4/2018,6,11141,1213,3059,108,1,20,15542
7/4/2018,7,11158,1688,3431,95,39,31,16442
7/4/2018,8,11153,1993,3697,33,112,54,17042
7/4/2018,9,11147,2535,4236,10,206,95,18229
7/4/2018,10,11146,2923,4515,5,270,84,18943
7/4/2018,11,11149,3238,4645,12,305,82,19431
7/4/2018,12,11150,3224,4606,42,308,82,19412
7/4/2018,13,11144,3754,4783,72,316,107,20176
7/4/2018,14,11139,4261,5107,74,311,112,21004
7/4/2018,15,11129,4367,5103,102,288,113,21102
7/4/2018,16,11124,4582,5181,82,245,114,21328
7/4/2018,17,11139,4411,5191,77,178,115,21111
7/4/2018,18,11137,4459,5065,98,92,110,20961
7/4/2018,19,11133,4601,5040,121,30,110,21035
7/4/2018,20,11127,4405,4888,135,7,108,20670
7/4/2018,21,11112,4394,4884,119,0,106,20615
7/4/2018,22,11092,3760,4675,169,0,88,19784
7/4/2018,23,11102,2655,4224,236,0,115,18332
7/4/2018,24,11119,2424,3429,360,0,118,17450
7/5/2018,1,11172,1735,2935,590,0,73,16505
7/5/2018,2,11181,1628,2726,534,0,68,16137
7/5/2018,3,11175,1299,2696,570,0,68,15808
7/5/2018,4,11179,1232,2741,570,0,69,15791
7/5/2018,5,11163,1475,2788,432,0,38,15896
7/5/2018,6,11163,2003,3072,454,1,22,16715
7/5/2018,7,11175,2388,3537,488,36,28,17652
7/5/2018,8,11176,3030,3977,612,112,28,18935
7/5/2018,9,11172,3853,4299,482,200,49,20055
7/5/2018,10,11165,4311,4145,492,253,100,20466
7/5/2018,11,11164,4255,4370,530,287,142,20748
7/5/2018,12,11134,4021,4520,623,289,162,20749
7/5/2018,13,11119,3977,4619,861,300,140,21016
7/5/2018,14,11120,4162,4891,992,289,105,21559
7/5/2018,15,11127,4200,5050,1037,290,106,21810
7/5/2018,16,11128,4225,5039,1098,221,105,21816
7/5/2018,17,11137,3492,4737,1246,130,81,20823
7/5/2018,18,11138,3472,4429,1312,71,51,20473
7/5/2018,19,11120,3726,4948,941,25,47,20807
7/5/2018,20,11123,4677,4696,908,3,29,21436
7/5/2018,21,11129,3756,4279,1274,0,29,20467
7/5/2018,22,11132,2545,4143,1368,0,29,19217
7/5/2018,23,11101,1433,3941,1690,0,22,18187
7/5/2018,24,11102,778,3174,2122,0,16,17192
7/6/2018,1,11112,326,2724,2239,0,11,16412
7/6/2018,2,11176,261,2621,1956,0,9,16023
7/6/2018,3,11193,264,2578,2045,0,9,16089
7/6/2018,4,11212,264,2633,1916,0,11,16036
7/6/2018,5,11236,264,2646,1931,0,15,16092
7/6/2018,6,11250,265,2690,2073,1,37,16316
7/6/2018,7,11255,279,2858,2337,44,42,16815
7/6/2018,8,11251,365,3048,2299,138,29,17130
7/6/2018,9,11259,519,3142,1847,236,29,17032
7/6/2018,10,11253,634,3194,1752,301,29,17163
7/6/2018,11,11262,771,3251,2254,323,29,17890
7/6/2018,12,11273,878,3646,1877,331,28,18033
7/6/2018,13,11069,1013,3858,1506,313,28,17787
7/6/2018,14,11104,1145,3796,1497,311,28,17881
7/6/2018,15,11233,1316,3925,1126,312,28,17940
7/6/2018,16,11234,1320,3997,1415,268,28,18262
7/6/2018,17,11233,1321,3963,1412,201,28,18158
7/6/2018,18,11236,1324,4101,1279,106,28,18074
7/6/2018,19,11231,994,4151,1559,29,28,17992
7/6/2018,20,11227,898,4141,1365,6,28,17665
7/6/2018,21,11217,733,4107,1272,0,28,17357
7/6/2018,22,11196,702,3530,1259,0,28,16715
7/6/2018,23,11207,295,3018,902,0,16,15438
7/6/2018,24,11208,206,2723,831,0,7,14975
7/7/2018,1,11199,207,2595,951,0,1,14953
7/7/2018,2,11188,205,2529,376,0,1,14299
7/7/2018,3,11186,206,2483,343,0,1,14219
7/7/2018,4,10994,154,2476,301,0,1,13926
7/7/2018,5,10933,189,2513,276,0,1,13912
7/7/2018,6,10673,289,2961,210,2,1,14136
7/7/2018,7,10675,497,3218,211,23,1,14625
7/7/2018,8,10941,729,3378,221,137,1,15407
7/7/2018,9,11222,853,3360,162,226,1,15824
7/7/2018,10,11210,936,3349,219,282,1,15997
7/7/2018,11,11194,1094,3256,177,316,1,16038
7/7/2018,12,11175,1292,3306,158,182,1,16114
7/7/2018,13,11166,1327,3553,224,287,1,16558
7/7/2018,14,11164,1377,3512,448,327,1,16829
7/7/2018,15,11137,1462,3670,388,299,1,16957
7/7/2018,16,11172,1470,3719,532,265,1,17159
7/7/2018,17,11175,987,4331,563,195,3,17254
7/7/2018,18,11177,1002,4925,489,107,4,17704
7/7/2018,19,11182,880,4848,373,28,1,17312
7/7/2018,20,11180,846,4415,339,6,1,16787
7/7/2018,21,11178,751,4121,383,0,1,16434
7/7/2018,22,11217,282,3841,401,0,1,15742
7/7/2018,23,11220,204,3471,380,0,1,15276
7/7/2018,24,11217,205,3081,441,0,1,14945
7/8/2018,1,11223,206,2793,527,0,7,14756
7/8/2018,2,11224,206,2753,497,0,6,14686
7/8/2018,3,10961,132,2692,411,0,14,14210
7/8/2018,4,10650,185,2800,433,0,16,14084
7/8/2018,5,10376,187,2745,432,0,22,13762
7/8/2018,6,10352,254,2698,300,1,23,13628
7/8/2018,7,10458,268,3018,424,41,16,14225
7/8/2018,8,10855,428,3517,300,119,15,15234
7/8/2018,9,11140,675,3192,289,158,16,15470
7/8/2018,10,11144,860,3456,299,151,12,15922
7/8/2018,11,11137,983,3500,487,253,2,16362
7/8/2018,12,11143,1155,3569,441,318,1,16627
7/8/2018,13,11151,1467,3731,423,325,2,17099
7/8/2018,14,11102,1704,4160,395,312,6,17679
7/8/2018,15,11155,1766,3839,449,290,16,17515
7/8/2018,16,11163,1951,4533,617,242,22,18528
7/8/2018,17,11157,2010,4531,733,193,24,18648
7/8/2018,18,11155,2238,4636,648,105,19,18801
7/8/2018,19,11154,2406,4649,504,27,17,18757
7/8/2018,20,11134,2297,4484,538,5,19,18477
7/8/2018,21,11124,1999,4249,847,0,20,18239
7/8/2018,22,11131,1555,3645,1032,0,20,17383
7/8/2018,23,11142,443,3338,1014,0,25,15962
7/8/2018,24,11146,207,2738,1183,0,30,15304
7/9/2018,1,11157,207,2443,1122,0,38,14967
7/9/2018,2,11149,206,2490,976,0,38,14859
7/9/2018,3,11128,221,2531,1182,0,42,15104
7/9/2018,4,11130,245,2524,1088,0,51,15038
7/9/2018,5,11113,429,2573,998,0,54,15167
7/9/2018,6,11104,893,2662,986,3,63,15711
7/9/2018,7,11112,1431,2972,822,37,68,16442
7/9/2018,8,11111,1615,3421,614,120,76,16957
7/9/2018,9,11116,1771,3491,587,206,108,17279
7/9/2018,10,11132,2172,3680,852,279,194,18309
7/9/2018,11,11110,2313,3918,888,304,226,18759
7/9/2018,12,11104,2397,4156,1004,322,229,19212
7/9/2018,13,11108,2281,4479,1166,327,230,19591
7/9/2018,14,11107,2476,4474,1408,326,222,20013
7/9/2018,15,11101,2609,4455,1740,313,223,20441
7/9/2018,16,11099,2703,4827,1879,268,222,20998
7/9/2018,17,11088,3020,5188,1655,192,224,21367
7/9/2018,18,11061,3591,4998,1611,105,193,21559
7/9/2018,19,11057,3001,4936,1543,30,87,20654
7/9/2018,20,11060,2896,5160,1219,7,54,20396
7/9/2018,21,11057,3271,4915,1298,0,55,20596
7/9/2018,22,11094,2650,4384,1520,0,52,19700
7/9/2018,23,11110,1783,3502,1544,0,44,17983
7/9/2018,24,11132,1018,3390,1449,0,33,17022
7/10/2018,1,11155,379,3025,1403,0,31,15993
7/10/2018,2,11122,253,2909,1262,0,14,15560
7/10/2018,3,11136,263,2944,1096,0,13,15452
7/10/2018,4,11141,426,2786,1035,0,13,15401
7/10/2018,5,11149,881,2527,654,0,17,15228
7/10/2018,6,11158,1437,2765,528,3,21,15912
7/10/2018,7,11158,1871,3061,306,30,53,16479
7/10/2018,8,11151,2160,3573,307,109,98,17398
7/10/2018,9,11143,2832,3963,209,195,191,18533
7/10/2018,10,11144,3348,4312,146,266,225,19441
7/10/2018,11,11134,3440,4494,198,281,222,19769
7/10/2018,12,11118,3451,4536,476,291,198,20070
7/10/2018,13,11117,3099,4464,832,272,204,19988
7/10/2018,14,11120,3146,4512,1170,259,199,20406
7/10/2018,15,11117,3327,4654,1395,259,204,20956
7/10/2018,16,11114,3481,4851,1437,228,196,21307
7/10/2018,17,11113,3016,4646,1795,169,162,20901
7/10/2018,18,11120,2764,4646,1807,92,164,20593
7/10/2018,19,11122,2899,4357,1606,34,195,20213
7/10/2018,20,11137,3129,3957,1204,6,203,19636
7/10/2018,21,11156,2744,3813,1206,0,203,19122
7/10/2018,22,11173,2057,3333,1166,0,150,17879
7/10/2018,23,11180,1096,3240,923,0,41,16480
7/10/2018,24,11182,849,2873,962,0,15,15881
7/11/2018,1,11190,528,2887,976,0,12,15593
7/11/2018,2,11200,463,3088,848,0,12,15611
7/11/2018,3,11206,470,3310,701,0,12,15699
7/11/2018,4,11176,581,3048,662,0,12,15479
7/11/2018,5,11190,818,3096,585,0,17,15706
7/11/2018,6,11178,1187,3006,354,2,29,15756
7/11/2018,7,11165,1435,3391,296,24,56,16367
7/11/2018,8,11169,1552,3537,105,83,99,16545
7/11/2018,9,11167,1808,3758,29,147,194,17103
7/11/2018,10,11161,2076,3572,65,195,219,17288
7/11/2018,11,11157,2090,3675,181,209,208,17520
7/11/2018,12,11146,2006,3626,422,211,159,17570
7/11/2018,13,11006,2233,3985,577,303,128,18232
7/11/2018,14,11177,2538,3704,700,316,107,18542
7/11/2018,15,11193,2699,3729,926,275,114,18936
7/11/2018,16,11191,2586,4052,978,238,118,19163
7/11/2018,17,11205,2650,4605,899,185,162,19706
7/11/2018,18,11206,2922,4766,735,100,195,19924
7/11/2018,19,11193,3043,4761,606,30,169,19802
7/11/2018,20,11175,2819,4656,527,6,170,19353
7/11/2018,21,11148,2440,4535,579,0,116,18818
7/11/2018,22,11149,2200,3840,593,0,37,17819
7/11/2018,23,11155,1767,3455,517,0,16,16910
7/11/2018,24,11155,1303,3168,512,0,13,16151
7/12/2018,1,11167,488,3055,448,0,13,15171
7/12/2018,2,11172,334,3087,370,0,13,14976
7/12/2018,3,11177,345,3043,354,0,20,14939
7/12/2018,4,11184,368,2957,274,0,34,14817
7/12/2018,5,11204,639,2678,202,0,18,14741
7/12/2018,6,11229,1065,2732,102,5,21,15154
7/12/2018,7,11205,1519,2893,109,43,27,15796
7/12/2018,8,11162,1814,3027,89,126,28,16246
7/12/2018,9,11154,1935,3344,92,211,27,16763
7/12/2018,10,11143,2371,3131,174,274,32,17125
7/12/2018,11,11113,2812,3068,278,302,34,17607
7/12/2018,12,11156,2805,3213,390,285,32,17881
7/12/2018,13,11147,2857,3714,343,296,31,18388
7/12/2018,14,11132,3016,3924,368,288,31,18759
7/12/2018,15,11124,3096,4264,452,282,33,19251
7/12/2018,16,11120,3491,4484,487,241,53,19876
7/12/2018,17,11128,3962,4499,362,157,95,20203
7/12/2018,18,11122,3876,4504,292,78,150,20022
7/12/2018,19,11124,3283,4701,277,31,200,19616
7/12/2018,20,11128,3174,4540,206,4,225,19277
7/12/2018,21,11151,3051,4378,259,0,223,19062
7/12/2018,22,11176,2355,4164,465,0,171,18331
7/12/2018,23,11197,1344,3612,601,0,52,16806
7/12/2018,24,11205,668,3521,599,0,14,16007
7/13/2018,1,11210,368,3280,749,0,14,15621
7/13/2018,2,11213,237,3490,715,0,16,15671
7/13/2018,3,11206,250,3614,707,0,14,15791
7/13/2018,4,11196,417,2996,741,0,16,15366
7/13/2018,5,11192,833,2605,668,1,16,15315
7/13/2018,6,11182,1212,2720,609,5,19,15747
7/13/2018,7,11174,1410,3225,533,31,28,16401
7/13/2018,8,11161,1698,3710,246,113,28,16956
7/13/2018,9,11156,2343,3964,258,172,31,17924
7/13/2018,10,11163,2816,3734,335,241,58,18347
7/13/2018,11,11161,3097,3800,483,294,97,18932
7/13/2018,12,11164,3505,4201,313,291,179,19653
7/13/2018,13,11173,4302,4110,254,255,210,20304
7/13/2018,14,11174,4331,4321,231,259,208,20524
7/13/2018,15,11158,3917,4317,376,260,210,20238
7/13/2018,16,11153,3361,4338,621,217,211,19901
7/13/2018,17,11140,3552,4458,751,140,208,20249
7/13/2018,18,11154,3550,4379,779,86,208,20156
7/13/2018,19,11141,3918,4385,566,27,209,20246
7/13/2018,20,11112,3795,4363,485,5,193,19953
7/13/2018,21,11098,3764,4200,705,0,148,19915
7/13/2018,22,11103,3076,3779,931,0,54,18943
7/13/2018,23,11097,1786,3678,1112,0,18,17691
7/13/2018,24,11103,804,3607,862,0,10,16386
7/14/2018,1,11118,313,3515,969,0,1,15916
7/14/2018,2,11134,234,3230,864,0,1,15463
7/14/2018,3,11128,248,3381,776,0,1,15534
7/14/2018,4,11136,330,3083,774,0,1,15324
7/14/2018,5,11140,678,3310,630,0,1,15759
7/14/2018,6,11145,1156,3015,526,1,1,15844
7/14/2018,7,11144,1473,3262,343,20,1,16243
7/14/2018,8,11140,1711,3678,108,77,1,16715
7/14/2018,9,11133,2123,3807,70,138,2,17273
7/14/2018,10,11131,2455,4015,59,213,20,17893
7/14/2018,11,11137,2876,4056,90,189,69,18417
7/14/2018,12,11132,3055,3779,133,164,153,18416
7/14/2018,13,11132,3229,4052,200,169,196,18978
7/14/2018,14,11092,3073,4118,232,213,193,18921
7/14/2018,15,11138,3168,4300,259,148,186,19199
7/14/2018,16,11138,3052,4327,269,149,186,19121
7/14/2018,17,11137,2969,4414,189,148,183,19040
7/14/2018,18,11141,3132,4472,175,136,175,19231
7/14/2018,19,11136,2786,4520,159,121,176,18898
7/14/2018,20,11110,2454,4488,151,102,176,18481
7/14/2018,21,11102,2139,4468,283,97,169,18258
7/14/2018,22,11101,1832,4012,318,97,90,17450
7/14/2018,23,11130,1533,3565,256,97,13,16594
7/14/2018,24,11166,724,3254,237,97,1,15479
7/15/2018,1,11181,313,3362,200,97,1,15154
7/15/2018,2,11180,280,3000,190,97,1,14748
7/15/2018,3,11173,282,3284,135,97,1,14972
7/15/2018,4,11161,292,3082,87,97,2,14721
7/15/2018,5,11171,475,3264,60,97,2,15069
7/15/2018,6,11169,884,3082,55,98,5,15293
7/15/2018,7,11170,1307,3363,48,121,4,16013
7/15/2018,8,11172,1574,3595,27,175,2,16545
7/15/2018,9,11163,1842,3775,27,234,5,17046
7/15/2018,10,11156,2163,3750,26,255,25,17375
7/15/2018,11,11141,2829,3860,41,261,66,18198
7/15/2018,12,11122,3161,3771,69,296,140,18559
7/15/2018,13,11111,3605,4014,136,298,172,19336
7/15/2018,14,11099,3743,4093,188,281,162,19566
7/15/2018,15,11084,3788,4309,164,271,96,19712
7/15/2018,16,11084,3880,4666,159,261,94,20144
7/15/2018,17,11096,3892,4720,93,229,99,20129
7/15/2018,18,11108,3762,4505,108,162,66,19711
7/15/2018,19,11113,3900,4536,100,118,64,19831
7/15/2018,20,11124,3936,4333,129,101,77,19700
7/15/2018,21,11133,3887,4133,222,97,91,19563
7/15/2018,22,11139,3164,4004,282,97,12,18698
7/15/2018,23,11148,2638,3594,334,97,1,17812
7/15/2018,24,11151,1949,3264,379,97,1,16841
7/16/2018,1,11148,1079,2960,446,97,1,15731
7/16/2018,2,11146,746,3020,483,97,1,15493
7/16/2018,3,11150,798,3141,436,97,7,15629
7/16/2018,4,11144,997,2917,568,97,13,15736
7/16/2018,5,11143,1192,2622,479,97,14,15547
7/16/2018,6,11146,1420,2642,441,97,21,15767
7/16/2018,7,11120,1960,3073,514,110,27,16804
7/16/2018,8,11111,2354,3588,504,154,28,17739
7/16/2018,9,11105,2761,4143,454,182,34,18679
7/16/2018,10,11101,3402,4399,623,220,37,19782
7/16/2018,11,11102,4139,4454,545,262,49,20551
7/16/2018,12,11103,4140,4303,644,271,51,20512
7/16/2018,13,11101,3871,4415,962,274,47,20670
7/16/2018,14,11131,3678,4073,1110,259,48,20299
7/16/2018,15,11150,3875,3571,1125,158,23,19902
7/16/2018,16,11155,3938,3845,975,142,19,20074
7/16/2018,17,11168,4278,3979,667,73,35,20200
7/16/2018,18,11167,3616,3768,827,43,45,19466
7/16/2018,19,11157,3654,4400,372,20,47,19650
7/16/2018,20,11153,3654,4540,301,6,44,19698
7/16/2018,21,11155,3912,4478,266,0,29,19840
7/16/2018,22,11141,2810,4047,527,0,27,18552
7/16/2018,23,11115,2009,3491,455,0,18,17088
7/16/2018,24,11117,565,3695,416,0,15,15808
7/17/2018,1,11122,323,3371,869,0,15,15700
7/17/2018,2,11119,345,2760,1009,0,15,15248
7/17/2018,3,11118,432,2751,1071,0,15,15387
7/17/2018,4,11104,675,2766,1093,0,16,15654
7/17/2018,5,11084,936,2845,1278,0,15,16158
7/17/2018,6,11108,1224,2796,1147,0,22,16297
7/17/2018,7,11131,1451,3320,895,14,28,16839
7/17/2018,8,11139,1721,3620,634,62,27,17203
7/17/2018,9,11150,1900,3557,727,109,28,17471
7/17/2018,10,11159,2004,3667,805,177,28,17840
7/17/2018,11,11163,2239,3766,1063,212,28,18471
7/17/2018,12,11173,2375,3821,1256,211,29,18865
7/17/2018,13,11292,2328,3771,1418,217,33,19059
7/17/2018,14,11347,2492,3438,1483,208,50,19018
7/17/2018,15,11350,2736,3644,1409,287,49,19475
7/17/2018,16,11347,2758,3863,1317,260,32,19577
7/17/2018,17,11344,2802,3953,1876,165,28,20168
7/17/2018,18,11360,2675,4259,1645,91,28,20058
7/17/2018,19,11363,2583,4237,1458,28,28,19697
7/17/2018,20,11362,2422,3832,1110,6,28,18760
7/17/2018,21,11610,1953,3963,984,0,28,18538
7/17/2018,22,11690,1498,3549,823,0,27,17587
7/17/2018,23,11706,854,2859,624,0,17,16060
7/17/2018,24,11692,350,2731,595,0,13,15381
7/18/2018,1,11680,297,2648,646,0,11,15282
7/18/2018,2,11690,295,2770,687,0,11,15453
7/18/2018,3,11866,310,2512,666,0,12,15366
7/18/2018,4,11879,323,2502,491,0,13,15208
7/18/2018,5,11883,353,2470,292,0,14,15012
7/18/2018,6,11893,565,2795,506,2,20,15781
7/18/2018,7,11892,1122,3248,437,39,26,16764
7/18/2018,8,11898,1587,3635,207,123,27,17477
7/18/2018,9,11887,1600,3592,113,198,27,17417
7/18/2018,10,11870,1581,3400,85,263,28,17227
7/18/2018,11,11871,1543,3747,135,289,28,17613
7/18/2018,12,12005,1559,3732,205,304,27,17832
7/18/2018,13,11860,1465,3551,243,312,27,17458
7/18/2018,14,11948,1525,3541,114,226,27,17381
7/18/2018,15,11995,1529,3745,368,272,27,17936
7/18/2018,16,11978,1548,4324,421,238,27,18536
7/18/2018,17,11965,1405,4767,394,190,27,18748
7/18/2018,18,11970,1658,4573,320,104,28,18653
7/18/2018,19,11979,1740,4551,245,28,28,18571
7/18/2018,20,11988,1497,4298,207,5,28,18023
7/18/2018,21,11991,1167,4152,185,0,28,17523
7/18/2018,22,11997,981,3474,153,0,28,16633
7/18/2018,23,12000,597,3278,167,0,15,16057
7/18/2018,24,11924,516,2873,170,0,13,15496
7/19/2018,1,11275,430,3461,185,0,13,15364
7/19/2018,2,11278,310,3083,146,0,14,14831
7/19/2018,3,11284,314,3159,130,0,14,14901
7/19/2018,4,11288,351,3094,130,0,13,14876
7/19/2018,5,11288,601,3032,118,0,13,15052
7/19/2018,6,11294,793,2958,159,2,21,15227
7/19/2018,7,11289,1043,3112,168,36,27,15675
7/19/2018,8,11273,1357,2908,95,110,31,15774
7/19/2018,9,11249,1426,2992,121,206,31,16025
7/19/2018,10,11227,1642,3565,149,271,29,16883
7/19/2018,11,11213,1998,3640,194,294,27,17366
7/19/2018,12,11202,2264,3866,296,299,32,17959
7/19/2018,13,11202,2304,3820,445,314,29,18114
7/19/2018,14,11213,2373,3584,445,318,27,17960
7/19/2018,15,11239,2620,4002,455,315,27,18658
7/19/2018,16,11256,2979,4416,408,256,28,19343
7/19/2018,17,11253,3244,4713,373,192,27,19802
7/19/2018,18,11245,3644,4684,358,105,27,20063
7/19/2018,19,11240,3750,4544,341,27,28,19930
7/19/2018,20,11234,3113,4444,361,5,28,19185
7/19/2018,21,11231,2380,4320,579,0,28,18538
7/19/2018,22,11247,1439,3722,970,0,28,17406
7/19/2018,23,11237,618,3144,1380,0,17,16396
7/19/2018,24,11230,289,2678,1494,0,19,15710
7/20/2018,1,11222,203,2420,1739,0,16,15600
7/20/2018,2,11212,206,2496,1635,0,16,15565
7/20/2018,3,11206,206,2523,1617,0,17,15569
7/20/2018,4,11198,282,2554,1663,0,18,15715
7/20/2018,5,11207,644,2544,1690,0,16,16101
7/20/2018,6,11228,1080,2557,1301,2,21,16189
7/20/2018,7,11234,1403,2844,1245,37,28,16791
7/20/2018,8,11227,1492,3515,1203,122,28,17587
7/20/2018,9,11224,1582,3178,1278,204,28,17494
7/20/2018,10,11221,1838,3411,1305,274,29,18078
7/20/2018,11,11213,1870,3842,1541,295,32,18793
7/20/2018,12,11184,1887,4166,1778,286,32,19333
7/20/2018,13,11135,2005,4089,2063,269,37,19598
7/20/2018,14,11109,1901,4250,2172,271,49,19752
7/20/2018,15,11098,1916,4560,2031,274,49,19928
7/20/2018,16,11098,2190,4645,1906,225,93,20157
7/20/2018,17,11101,2155,4628,1748,167,130,19929
7/20/2018,18,11096,2190,4526,1570,77,155,19614
7/20/2018,19,11082,2445,4379,1449,24,174,19553
7/20/2018,20,11069,2607,4383,1365,2,211,19637
7/20/2018,21,11052,2468,4098,1388,0,81,19087
7/20/2018,22,11058,2133,3662,1640,0,37,18530
7/20/2018,23,11070,1010,3467,2011,0,15,17573
7/20/2018,24,11067,817,3405,1856,0,1,17146
7/21/2018,1,11067,382,3338,1862,0,1,16650
7/21/2018,2,11064,299,3178,1766,0,1,16308
7/21/2018,3,11063,238,2856,1821,0,1,15979
7/21/2018,4,11054,237,2639,1965,0,1,15896
7/21/2018,5,11027,314,2459,1899,0,1,15700
7/21/2018,6,11020,541,2461,1913,3,1,15939
7/21/2018,7,11012,787,2603,1724,35,1,16162
7/21/2018,8,11000,981,2962,1791,74,1,16809
7/21/2018,9,10994,1125,3082,1688,138,1,17028
7/21/2018,10,10994,1266,3382,1682,164,1,17489
7/21/2018,11,10987,1483,3798,1667,140,1,18076
7/21/2018,12,10987,1697,3964,1505,154,1,18308
7/21/2018,13,10978,1757,4033,1488,203,1,18460
7/21/2018,14,10924,1488,3740,1292,178,1,17623
7/21/2018,15,10970,1529,4026,1133,187,1,17846
7/21/2018,16,10985,1439,4321,1158,147,1,18051
7/21/2018,17,10982,1174,4191,1260,99,1,17707
7/21/2018,18,10956,1057,3935,1394,61,1,17404
7/21/2018,19,10931,904,3747,1525,24,1,17132
7/21/2018,20,10901,842,3789,1565,3,1,17101
7/21/2018,21,10870,921,3914,1773,0,1,17479
7/21/2018,22,10855,869,3528,1936,0,1,17189
7/21/2018,23,10854,659,3007,1997,0,1,16518
7/21/2018,24,10857,600,2861,1753,0,1,16072
7/22/2018,1,10854,596,3083,1439,0,1,15973
7/22/2018,2,10826,599,2614,1356,0,1,15396
7/22/2018,3,10847,601,2531,1314,0,1,15294
7/22/2018,4,10892,689,2528,1236,0,1,15346
7/22/2018,5,10902,706,2586,1308,0,1,15503
7/22/2018,6,10906,759,2596,1285,1,1,15548
7/22/2018,7,10918,833,2642,1305,8,2,15708
7/22/2018,8,10915,989,2711,1199,51,1,15866
7/22/2018,9,10922,999,3065,1166,107,1,16260
7/22/2018,10,10945,1001,3153,1382,113,1,16595
7/22/2018,11,10977,1004,2915,1837,101,1,16835
7/22/2018,12,10253,923,3680,1864,104,1,16825
7/22/2018,13,9050,1376,4475,1822,161,1,16885
7/22/2018,14,9059,1448,4233,1449,180,1,16370
7/22/2018,15,9066,1353,4124,1087,159,3,15792
7/22/2018,16,9076,1572,4481,773,165,15,16082
7/22/2018,17,9077,1759,4428,686,126,44,16120
7/22/2018,18,9069,1961,4208,420,64,113,15835
7/22/2018,19,9067,2283,4073,317,31,143,15914
7/22/2018,20,9067,2443,3993,352,4,142,16001
7/22/2018,21,9065,2577,3870,365,0,146,16023
7/22/2018,22,9059,2445,3614,417,0,141,15676
7/22/2018,23,9055,2256,3329,423,0,94,15157
7/22/2018,24,9061,1878,3179,435,0,63,14616
7/23/2018,1,9061,1601,2740,387,0,25,13814
7/23/2018,2,9063,1405,2791,324,0,15,13598
7/23/2018,3,9067,1391,2783,341,0,14,13596
7/23/2018,4,9061,1457,2882,364,0,14,13778
7/23/2018,5,9052,1811,2482,222,0,14,13581
7/23/2018,6,9044,2385,2622,478,2,20,14551
7/23/2018,7,9047,2712,3182,419,20,27,15407
7/23/2018,8,9045,3159,3542,331,79,28,16184
7/23/2018,9,9047,3721,3587,244,132,54,16785
7/23/2018,10,9045,4288,3671,264,189,78,17535
7/23/2018,11,9045,5122,3767,323,212,83,18552
7/23/2018,12,9043,5126,4088,334,239,84,18914
7/23/2018,13,9043,5292,4176,305,190,114,19120
7/23/2018,14,9047,5524,4194,289,168,119,19341
7/23/2018,15,9048,5455,4064,289,160,92,19108
7/23/2018,16,9051,5140,4246,338,141,44,18960
7/23/2018,17,9048,5204,4192,311,99,39,18893
7/23/2018,18,9024,5269,4289,285,49,41,18957
7/23/2018,19,9022,5322,4300,326,25,29,19024
7/23/2018,20,9025,5205,4230,293,6,28,18787
7/23/2018,21,9025,5352,4189,247,0,28,18841
7/23/2018,22,9018,4689,3667,335,0,28,17737
7/23/2018,23,9015,3169,3388,687,0,17,16276
7/23/2018,24,9012,2364,3035,598,0,11,15020
7/24/2018,1,9024,1838,3053,472,0,10,14397
7/24/2018,2,9025,1985,3161,419,0,8,14598
7/24/2018,3,9037,1978,3185,418,0,11,14629
7/24/2018,4,9040,2111,3121,445,0,14,14731
7/24/2018,5,9034,1904,2854,511,1,17,14321
7/24/2018,6,9024,2039,2881,580,1,20,14545
7/24/2018,7,9010,2739,3418,618,20,28,15833
7/24/2018,8,9003,3643,3705,548,62,28,16989
7/24/2018,9,9011,4410,3743,484,121,28,17797
7/24/2018,10,9019,4584,3966,481,151,28,18229
7/24/2018,11,9024,4804,4395,428,176,28,18855
7/24/2018,12,9034,5173,4407,428,159,30,19231
7/24/2018,13,9039,5374,4395,487,164,54,19513
7/24/2018,14,9037,5456,4127,487,180,86,19373
7/24/2018,15,9030,5362,4114,482,161,91,19240
7/24/2018,16,9027,5363,4277,428,121,125,19341
7/24/2018,17,9028,5276,4414,485,49,125,19377
7/24/2018,18,9029,4971,4282,320,39,125,18766
7/24/2018,19,9024,5097,4248,255,19,85,18728
7/24/2018,20,9006,5226,4214,241,5,30,18722
7/24/2018,21,8986,5139,3907,331,0,28,18391
7/24/2018,22,9002,4588,3890,354,0,28,17862
7/24/2018,23,9016,3420,3828,345,0,17,16626
7/24/2018,24,9025,2430,3498,330,0,13,15296
7/25/2018,1,9042,2423,3124,339,0,12,14940
7/25/2018,2,9060,2057,3064,365,0,11,14557
7/25/2018,3,9209,2027,3005,343,0,10,14594
7/25/2018,4,9284,2031,2843,446,0,13,14617
7/25/2018,5,9346,2045,2653,435,0,15,14494
7/25/2018,6,9482,2189,2722,364,1,18,14776
7/25/2018,7,9491,2394,3244,340,11,28,15508
7/25/2018,8,9491,3057,3585,297,47,27,16504
7/25/2018,9,9515,3507,3901,173,111,28,17235
7/25/2018,10,9697,3965,3929,149,166,28,17934
7/25/2018,11,9668,4240,4279,203,166,28,18584
7/25/2018,12,8904,4807,4436,422,176,30,18775
7/25/2018,13,8880,4851,4104,541,211,48,18635
7/25/2018,14,8878,4960,4352,480,237,87,18994
7/25/2018,15,8926,5296,4497,392,241,138,19490
7/25/2018,16,8982,5471,4819,399,218,94,19983
7/25/2018,17,8988,5560,4744,328,148,104,19872
7/25/2018,18,9018,5589,4575,282,72,86,19622
7/25/2018,19,9095,5296,4578,198,25,85,19277
7/25/2018,20,9203,5142,4455,146,5,34,18985
7/25/2018,21,9300,5058,4046,188,0,28,18620
7/25/2018,22,9300,3931,3965,219,0,28,17443
7/25/2018,23,9347,2733,3749,177,0,18,16024
7/25/2018,24,9375,2175,3475,246,0,15,15286
7/26/2018,1,9393,1676,3025,355,0,15,14464
7/26/2018,2,9444,1582,2884,465,0,15,14390
7/26/2018,3,9577,1580,2587,587,0,15,14346
7/26/2018,4,9603,1350,2660,854,0,15,14482
7/26/2018,5,9640,1599,2613,798,0,16,14666
7/26/2018,6,9637,1891,2694,591,1,20,14834
7/26/2018,7,9649,2190,2996,568,37,28,15468
7/26/2018,8,9678,2528,3368,635,98,27,16334
7/26/2018,9,9679,2807,3744,836,166,28,17260
7/26/2018,10,9654,3098,3349,1450,219,28,17798
7/26/2018,11,9650,3237,3342,1736,249,28,18242
7/26/2018,12,9650,3102,3675,1997,231,28,18683
7/26/2018,13,9536,3219,4147,1928,248,28,19106
7/26/2018,14,9613,3656,4042,1970,252,28,19561
7/26/2018,15,9795,3748,4262,1594,262,30,19691
7/26/2018,16,9881,3878,4309,1165,191,30,19454
7/26/2018,17,9888,3643,4541,969,121,46,19208
7/26/2018,18,9914,3736,4586,592,76,79,18983
7/26/2018,19,9921,3859,4588,473,25,90,18956
7/26/2018,20,9905,3155,4242,597,4,162,18065
7/26/2018,21,9912,2889,3833,854,0,207,17695
7/26/2018,22,9917,2548,3296,1096,0,175,17032
7/26/2018,23,9919,1595,2931,1118,0,77,15640
7/26/2018,24,9911,930,3004,1270,0,25,15140
7/27/2018,1,9911,530,3024,1102,0,13,14580
7/27/2018,2,9926,447,3129,893,0,13,14408
7/27/2018,3,9931,632,3196,799,0,13,14571
7/27/2018,4,9946,820,3049,617,0,13,14445
7/27/2018,5,9991,962,2573,569,0,16,14111
7/27/2018,6,9992,1156,3035,618,1,22,14824
7/27/2018,7,9996,1429,3285,568,31,25,15334
7/27/2018,8,10017,1525,3596,443,83,32,15696
7/27/2018,9,10036,1724,3810,412,154,32,16168
7/27/2018,10,10034,1968,3766,556,196,36,16556
7/27/2018,11,10018,2089,3813,744,245,36,16945
7/27/2018,12,9999,2239,4147,1029,223,26,17663
7/27/2018,13,10001,2479,4345,1163,254,26,18268
7/27/2018,14,9990,2464,4556,1091,265,27,18393
7/27/2018,15,9971,2418,4608,1095,262,26,18380
7/27/2018,16,9970,2399,4722,1081,216,25,18413
7/27/2018,17,9987,2847,4756,938,130,26,18684
7/27/2018,18,9978,2679,4553,842,68,27,18147
7/27/2018,19,9970,2503,4724,674,27,27,17925
7/27/2018,20,9962,2584,4421,449,4,26,17446
7/27/2018,21,9965,2495,4148,504,0,27,17139
7/27/2018,22,9974,1825,3777,440,0,27,16043
7/27/2018,23,10014,866,3625,458,0,17,14980
7/27/2018,24,10028,343,3189,508,0,11,14079
7/28/2018,1,10072,242,2935,530,0,1,13780
7/28/2018,2,10097,225,2752,650,0,1,13725
7/28/2018,3,10118,236,2940,681,0,2,13977
7/28/2018,4,10105,326,3150,620,0,2,14203
7/28/2018,5,10084,538,3204,573,0,1,14400
7/28/2018,6,10030,774,3167,682,2,1,14656
7/28/2018,7,9934,852,2872,698,35,1,14392
7/28/2018,8,9929,860,3444,638,92,1,14964
7/28/2018,9,9923,1073,3861,754,159,1,15771
7/28/2018,10,9920,1057,3892,857,198,1,15925
7/28/2018,11,9908,1030,3838,889,182,1,15848
7/28/2018,12,9908,1178,3701,904,203,1,15895
7/28/2018,13,9912,1478,3478,837,231,5,15941
7/28/2018,14,9901,1652,3591,774,185,4,16107
7/28/2018,15,9897,1320,3725,776,182,5,15905
7/28/2018,16,9909,1411,3993,712,193,2,16220
7/28/2018,17,9992,1459,4036,663,114,1,16265
7/28/2018,18,10145,1430,3943,419,64,1,16002
7/28/2018,19,10179,1299,4165,216,26,1,15886
7/28/2018,20,10179,1128,3963,177,5,1,15453
7/28/2018,21,10171,894,3964,252,0,2,15283
7/28/2018,22,10166,503,3650,274,0,2,14595
7/28/2018,23,10149,224,3502,249,0,6,14130
7/28/2018,24,10131,240,3301,206,0,4,13882
7/29/2018,1,10123,221,3268,210,0,3,13825
7/29/2018,2,10107,247,3418,270,0,1,14043
7/29/2018,3,10083,264,3359,387,0,1,14094
7/29/2018,4,10080,199,3217,340,0,1,13837
7/29/2018,5,10072,228,3421,295,0,1,14017
7/29/2018,6,10077,261,3229,302,3,1,13873
7/29/2018,7,10078,426,3084,238,40,1,13867
7/29/2018,8,10087,722,3089,38,56,1,13993
7/29/2018,9,10083,792,3708,23,207,1,14814
7/29/2018,10,10101,884,3854,61,271,1,15172
7/29/2018,11,10135,975,3901,127,277,1,15416
7/29/2018,12,10163,1117,3912,259,260,1,15712
7/29/2018,13,10173,1412,3840,383,248,1,16057
7/29/2018,14,10123,1582,3671,479,281,1,16137
7/29/2018,15,10095,1639,3714,384,245,2,16079
7/29/2018,16,10093,1918,3647,301,205,2,16166
7/29/2018,17,10083,2013,4107,317,136,1,16657
7/29/2018,18,10072,1794,4237,278,74,1,16456
7/29/2018,19,10057,1954,4149,251,21,4,16436
7/29/2018,20,10042,1792,3826,223,2,1,15886
7/29/2018,21,10029,1560,3958,187,0,1,15735
7/29/2018,22,10017,955,3854,154,0,1,14981
7/29/2018,23,10053,510,3560,187,0,1,14311
7/29/2018,24,10069,458,3178,181,0,1,13887
7/30/2018,1,10104,463,3180,117,0,1,13865
7/30/2018,2,10124,596,3252,82,0,1,14055
7/30/2018,3,10135,747,3055,81,0,10,14028
7/30/2018,4,10143,1066,2757,82,0,13,14061
7/30/2018,5,10156,1413,2610,54,0,14,14247
7/30/2018,6,10171,1569,2828,59,1,20,14648
7/30/2018,7,10174,2002,2961,57,19,27,15240
7/30/2018,8,10200,2055,2858,21,40,28,15202
7/30/2018,9,10200,2207,3181,13,92,28,15721
7/30/2018,10,10170,2527,3449,2,125,28,16301
7/30/2018,11,10133,2755,3648,9,166,28,16739
7/30/2018,12,10119,3138,4008,20,173,28,17486
7/30/2018,13,10168,3473,4031,74,243,40,18029
7/30/2018,14,10214,3336,4190,168,197,74,18179
7/30/2018,15,10234,3300,4360,111,228,103,18336
7/30/2018,16,10261,3592,4617,89,189,159,18907
7/30/2018,17,10309,3865,4618,126,124,194,19236
7/30/2018,18,10344,3615,4494,85,52,139,18729
7/30/2018,19,10347,3427,4387,81,24,186,18452
7/30/2018,20,10354,3129,4225,83,4,184,17979
7/30/2018,21,10370,3185,4058,69,0,74,17756
7/30/2018,22,10370,2844,3358,122,0,26,16720
7/30/2018,23,10363,1818,3221,151,0,12,15565
7/30/2018,24,10399,1219,2753,137,0,10,14518
7/31/2018,1,10453,997,2776,130,0,10,14366
7/31/2018,2,10427,972,2804,171,0,12,14386
7/31/2018,3,10420,967,2724,222,0,12,14345
7/31/2018,4,10422,867,2683,173,0,12,14157
7/31/2018,5,10423,791,2688,160,0,13,14075
7/31/2018,6,10486,1129,2802,207,2,15,14641
7/31/2018,7,10510,1409,2888,260,32,27,15126
7/31/2018,8,10519,1742,2996,238,98,28,15621
7/31/2018,9,10537,2244,3225,153,176,28,16363
7/31/2018,10,10539,2640,3495,169,199,28,17070
7/31/2018,11,10511,3062,3676,229,264,28,17770
7/31/2018,12,10532,3231,3938,298,268,28,18295
7/31/2018,13,10495,3466,4060,383,281,28,18713
7/31/2018,14,10470,3511,4199,545,256,28,19009
7/31/2018,15,10466,3583,4288,560,220,28,19145
7/31/2018,16,10467,3637,4323,457,169,28,19081
7/31/2018,17,10467,3707,4523,377,107,30,19211
7/31/2018,18,10473,3778,4599,331,61,29,19271
7/31/2018,19,10477,3182,4438,367,18,29,18511
7/31/2018,20,10473,2881,4369,442,3,27,18195
7/31/2018,21,10499,3036,3862,431,0,27,17855
7/31/2018,22,10524,2332,3408,552,0,28,16844
7/31/2018,23,10521,972,3280,708,0,17,15498
7/31/2018,24,10512,468,2710,894,0,30,14614
8/1/2018,1,10500,244,2652,1061,0,13,14470
8/1/2018,2,10494,239,2523,1099,0,14,14369
8/1/2018,3,10462,245,2725,1125,0,11,14568
8/1/2018,4,10458,339,3008,983,0,11,14799
8/1/2018,5,10461,512,2980,1051,0,12,15016
8/1/2018,6,10459,961,2995,1297,1,26,15739
8/1/2018,7,10456,1476,3071,1177,16,34,16230
8/1/2018,8,10465,1984,3327,1022,51,27,16876
8/1/2018,9,10444,2541,3317,1110,80,27,17519
8/1/2018,10,10460,2887,3326,1275,136,28,18112
8/1/2018,11,10470,3237,3461,1342,145,28,18683
8/1/2018,12,10478,3421,3666,1097,130,27,18819
8/1/2018,13,10455,3778,3975,973,169,27,19377
8/1/2018,14,10431,3695,4064,853,163,28,19234
8/1/2018,15,10427,3783,4337,925,165,25,19662
8/1/2018,16,10444,3902,4421,869,107,27,19770
8/1/2018,17,10422,3965,4576,620,107,27,19717
8/1/2018,18,10402,3693,4656,479,66,28,19324
8/1/2018,19,10401,3565,4549,458,15,28,19016
8/1/2018,20,10393,3732,4361,570,1,28,19085
8/1/2018,21,10404,3383,3904,656,0,28,18375
8/1/2018,22,10416,2511,3602,764,0,28,17321
8/1/2018,23,10418,1660,3115,603,0,18,15814
8/1/2018,24,10431,675,3167,392,0,11,14676
8/2/2018,1,10452,480,2808,443,0,5,14188
8/2/2018,2,10454,450,2505,440,0,5,13854
8/2/2018,3,10452,564,2602,477,0,5,14100
8/2/2018,4,10450,747,2560,587,0,6,14350
8/2/2018,5,10450,970,2604,294,0,9,14327
8/2/2018,6,10458,1097,2771,264,0,17,14607
8/2/2018,7,10462,1550,2953,488,30,31,15514
8/2/2018,8,10454,2319,2961,386,71,27,16218
8/2/2018,9,10448,2654,3376,399,128,27,17032
8/2/2018,10,10430,3186,3574,297,173,27,17687
8/2/2018,11,10408,3944,3668,346,226,31,18623
8/2/2018,12,10402,4120,3561,670,244,29,19026
8/2/2018,13,10389,3943,4040,1027,273,47,19719
8/2/2018,14,10391,3735,4210,1184,276,75,19871
8/2/2018,15,10398,3996,4445,1032,239,87,20197
8/2/2018,16,10400,4314,4704,868,192,166,20644
8/2/2018,17,10401,4245,4698,875,146,188,20553
8/2/2018,18,10390,3703,4823,908,82,109,20015
8/2/2018,19,10382,3676,4825,756,27,101,19767
8/2/2018,20,10377,4102,4722,532,2,107,19842
8/2/2018,21,10374,3973,4408,659,0,126,19540
8/2/2018,22,10400,3134,4003,837,0,29,18403
8/2/2018,23,10425,2121,3466,722,0,17,16751
8/2/2018,24,10442,1398,2848,804,0,10,15502
8/3/2018,1,10452,639,2805,862,0,6,14764
8/3/2018,2,10455,508,2856,847,0,5,14671
8/3/2018,3,10445,522,3024,793,0,6,14790
8/3/2018,4,10444,686,3134,685,0,7,14956
8/3/2018,5,10439,915,2874,676,0,10,14914
8/3/2018,6,10424,1134,2873,580,0,15,15026
8/3/2018,7,10426,1669,3382,491,17,25,16010
8/3/2018,8,10428,2536,3260,324,74,27,16649
8/3/2018,9,10453,2956,3744,129,123,26,17431
8/3/2018,10,10466,3653,3799,85,165,28,18196
8/3/2018,11,10456,4030,3857,134,233,36,18746
8/3/2018,12,10439,4246,4056,221,246,100,19308
8/3/2018,13,10416,4363,4039,424,272,178,19692
8/3/2018,14,10419,4557,4137,549,261,204,20127
8/3/2018,15,10424,4354,4516,714,221,141,20370
8/3/2018,16,10434,4603,4738,447,176,96,20494
8/3/2018,17,10443,4792,4746,415,141,123,20660
8/3/2018,18,10438,4465,4762,308,95,85,20153
8/3/2018,19,10427,4670,4757,281,26,98,20259
8/3/2018,20,10416,3922,4756,162,4,86,19346
8/3/2018,21,10412,3991,4357,164,0,125,19049
8/3/2018,22,10413,3531,3615,241,0,80,17880
8/3/2018,23,10414,2537,3026,257,0,34,16268
8/3/2018,24,10405,1217,2994,193,0,9,14818
8/4/2018,1,10399,379,3097,193,0,1,14069
8/4/2018,2,10406,251,3254,157,0,1,14069
8/4/2018,3,10408,401,3276,158,0,1,14244
8/4/2018,4,10421,595,3205,142,0,1,14364
8/4/2018,5,10457,825,3222,134,0,1,14639
8/4/2018,6,10481,886,3147,158,1,1,14674
8/4/2018,7,10502,1091,3055,190,16,1,14855
8/4/2018,8,10497,1753,3317,159,90,1,15817
8/4/2018,9,10473,2111,3440,77,180,1,16282
8/4/2018,10,10443,2711,3533,91,255,1,17034
8/4/2018,11,10417,3469,3871,142,265,1,18165
8/4/2018,12,10402,3741,4071,181,296,1,18692
8/4/2018,13,10390,3932,4137,320,302,2,19083
8/4/2018,14,10384,3897,4135,400,300,17,19133
8/4/2018,15,10337,3811,4288,522,295,50,19303
8/4/2018,16,10389,4291,4516,579,248,57,20080
8/4/2018,17,10430,4550,4730,552,177,69,20508
8/4/2018,18,10478,4464,4767,504,89,67,20369
8/4/2018,19,10483,3673,4716,456,23,57,19408
8/4/2018,20,10477,3513,4596,475,3,52,19116
8/4/2018,21,10442,3305,4129,611,0,15,18502
8/4/2018,22,10130,2767,3704,761,0,1,17363
8/4/2018,23,9985,2066,3330,916,0,1,16298
8/4/2018,24,9979,1011,2959,1036,0,1,14986
8/5/2018,1,9980,384,3064,1321,0,1,14750
8/5/2018,2,9983,250,3028,1398,0,2,14661
8/5/2018,3,9982,265,3106,1444,0,2,14799
8/5/2018,4,9983,264,3226,1423,0,1,14897
8/5/2018,5,9998,336,3103,1371,0,1,14809
8/5/2018,6,10008,614,2892,1244,0,1,14759
8/5/2018,7,10025,1167,2714,736,27,1,14670
8/5/2018,8,10040,2031,2759,423,103,1,15357
8/5/2018,9,10041,2648,2871,359,172,1,16092
8/5/2018,10,10040,2829,3156,530,242,1,16798
8/5/2018,11,10029,3060,3690,715,297,1,17792
8/5/2018,12,10014,3272,4135,925,312,1,18659
8/5/2018,13,10014,3766,4237,980,317,27,19341
8/5/2018,14,10002,3877,4263,1413,300,50,19905
8/5/2018,15,9995,3631,4664,1796,297,55,20438
8/5/2018,16,9990,3597,4813,1964,250,56,20670
8/5/2018,17,9992,3998,4825,1842,167,56,20880
8/5/2018,18,9989,4102,4696,1732,78,40,20637
8/5/2018,19,9996,4280,4421,1687,27,1,20412
8/5/2018,20,9997,3335,4449,1854,3,1,19639
8/5/2018,21,9982,3074,4270,2130,0,1,19457
8/5/2018,22,9962,2807,3608,2315,0,2,18694
8/5/2018,23,9936,2067,2939,2438,0,3,17383
8/5/2018,24,9931,1237,2951,2329,0,1,16449
8/6/2018,1,9947,639,2991,2575,0,1,16153
8/6/2018,2,9978,602,3072,2481,0,1,16134
8/6/2018,3,10006,683,3015,2364,0,1,16069
8/6/2018,4,10012,903,2960,2188,0,1,16064
8/6/2018,5,10015,1166,2969,2033,0,1,16184
8/6/2018,6,10024,1379,2814,1676,0,1,15894
8/6/2018,7,10025,1782,3035,1314,17,1,16174
8/6/2018,8,10019,2222,3426,928,102,1,16698
8/6/2018,9,10009,3073,3489,885,183,1,17640
8/6/2018,10,10001,3864,3552,1149,239,1,18806
8/6/2018,11,9992,4141,3678,1422,280,1,19514
8/6/2018,12,9984,3934,3974,1556,284,2,19734
8/6/2018,13,9971,4210,4248,1223,286,5,19943
8/6/2018,14,9981,4412,4325,783,258,6,19765
8/6/2018,15,10009,4226,4398,515,156,35,19339
8/6/2018,16,10008,4058,4663,493,114,62,19398
8/6/2018,17,10010,4807,4908,355,57,84,20221
8/6/2018,18,10014,4421,4405,408,36,76,19360
8/6/2018,19,10028,3782,4388,361,13,55,18627
8/6/2018,20,10034,3344,4441,542,1,52,18414
8/6/2018,21,10040,3709,3850,337,0,64,18000
8/6/2018,22,10057,3564,3581,193,0,55,17450
8/6/2018,23,10062,2483,3407,358,0,14,16324
8/6/2018,24,10074,1833,3109,400,0,1,15417
8/7/2018,1,10082,1331,3432,340,0,1,15186
8/7/2018,2,10078,1443,3414,376,0,1,15312
8/7/2018,3,10066,1232,2902,448,0,1,14649
8/7/2018,4,10050,1321,3407,309,0,4,15091
8/7/2018,5,10036,1583,3098,233,0,13,14963
8/7/2018,6,10034,2103,3093,229,0,17,15476
8/7/2018,7,10033,2845,3026,188,3,28,16123
8/7/2018,8,10035,3640,2985,95,34,57,16846
8/7/2018,9,10034,4270,3303,35,87,74,17803
8/7/2018,10,10024,4894,3202,19,140,124,18403
8/7/2018,11,10021,5079,3415,16,178,182,18891
8/7/2018,12,10006,5358,3463,29,252,197,19305
8/7/2018,13,9986,5163,3878,94,254,194,19569
8/7/2018,14,10026,4936,4269,164,257,173,19825
8/7/2018,15,10085,4804,4423,195,220,196,19923
8/7/2018,16,10108,4713,4618,218,191,154,20002
8/7/2018,17,10121,4546,4621,233,137,105,19763
8/7/2018,18,10121,4505,4575,208,75,104,19588
8/7/2018,19,10112,4413,4535,161,25,104,19350
8/7/2018,20,10103,4652,4097,167,1,137,19157
8/7/2018,21,10090,4417,3911,164,0,154,18736
8/7/2018,22,10073,3666,3325,139,0,58,17261
8/7/2018,23,10063,3070,3089,108,0,39,16369
8/7/2018,24,10068,2406,2780,102,0,29,15385
8/8/2018,1,10058,1499,3306,160,0,29,15052
8/8/2018,2,10063,1292,3440,182,0,27,15004
8/8/2018,3,10065,1162,3285,321,0,27,14860
8/8/2018,4,10089,1176,3273,439,0,24,15001
8/8/2018,5,10129,1250,3077,497,0,22,14975
8/8/2018,6,10184,1616,3337,397,1,25,15560
8/8/2018,7,10226,2270,3558,448,17,22,16541
8/8/2018,8,10261,2457,3511,574,46,30,16879
8/8/2018,9,10295,2875,3655,630,57,31,17543
8/8/2018,10,10324,3711,3388,642,87,28,18180
8/8/2018,11,10313,4331,3438,740,115,28,18965
8/8/2018,12,10307,4449,3627,885,122,29,19419
8/8/2018,13,10300,4220,3792,933,131,30,19406
8/8/2018,14,10315,4346,3960,878,83,28,19610
8/8/2018,15,10302,4256,3919,683,90,28,19278
8/8/2018,16,10296,4129,4391,645,81,28,19570
8/8/2018,17,10314,4272,4655,465,75,29,19810
8/8/2018,18,10345,4615,4701,325,51,29,20066
8/8/2018,19,10363,4422,4617,198,19,28,19647
8/8/2018,20,10376,4616,4275,116,2,28,19413
8/8/2018,21,10379,4343,4084,103,0,29,18938
8/8/2018,22,10391,3419,3843,127,0,28,17808
8/8/2018,23,10490,2238,3332,117,0,22,16199
8/8/2018,24,10514,1065,3010,127,0,10,14726
8/9/2018,1,10535,857,2726,159,0,7,14284
8/9/2018,2,10548,841,2797,279,0,8,14473
8/9/2018,3,10581,579,3293,372,0,7,14832
8/9/2018,4,10572,623,3329,445,0,7,14976
8/9/2018,5,10550,836,3293,552,0,13,15244
8/9/2018,6,10525,1228,3262,617,0,18,15650
8/9/2018,7,10527,1821,3232,326,29,27,15962
8/9/2018,8,10510,2244,3430,152,97,29,16462
8/9/2018,9,10511,2590,3817,150,177,49,17294
8/9/2018,10,10517,3623,3715,271,259,76,18461
8/9/2018,11,10513,3882,3632,377,297,79,18780
8/9/2018,12,10495,4283,3808,569,293,99,19547
8/9/2018,13,10483,4435,3815,926,291,168,20118
8/9/2018,14,10447,4258,4112,1262,274,123,20476
8/9/2018,15,10463,4266,4073,1369,264,85,20520
8/9/2018,16,10475,4074,4451,1366,178,92,20636
8/9/2018,17,10499,4002,4494,1103,114,93,20305
8/9/2018,18,10511,3468,4699,757,31,96,19562
8/9/2018,19,10520,3399,4707,594,21,81,19322
8/9/2018,20,10524,3749,4628,477,0,101,19479
8/9/2018,21,10527,4343,3966,341,0,167,19344
8/9/2018,22,10542,4054,3493,305,0,94,18488
8/9/2018,23,10551,2561,3201,319,0,31,16663
8/9/2018,24,10535,1487,3248,230,0,9,15509
8/10/2018,1,10542,878,3281,338,0,7,15046
8/10/2018,2,10541,725,3001,517,0,7,14791
8/10/2018,3,10593,717,3013,580,0,7,14910
8/10/2018,4,10607,800,2950,614,0,7,14978
8/10/2018,5,10603,1042,2867,593,0,13,15118
8/10/2018,6,10607,1452,2871,718,0,21,15669
8/10/2018,7,10593,1786,3105,555,23,27,16089
8/10/2018,8,10574,2077,3275,429,77,27,16459
8/10/2018,9,10578,2788,3365,363,193,28,17315
8/10/2018,10,10578,3172,3343,328,279,27,17727
8/10/2018,11,10581,3275,3427,217,302,28,17830
8/10/2018,12,10600,3514,3799,191,312,43,18459
8/10/2018,13,10603,3461,3526,172,313,72,18147
8/10/2018,14,10613,3485,3866,200,295,78,18537
8/10/2018,15,10593,3541,4022,244,289,78,18767
8/10/2018,16,10573,3719,4128,274,264,48,19006
8/10/2018,17,10577,3989,4325,334,185,65,19475
8/10/2018,18,10585,3767,4376,355,94,91,19268
8/10/2018,19,10596,3682,4302,302,21,107,19010
8/10/2018,20,10601,3247,3900,205,1,119,18073
8/10/2018,21,10589,2878,3890,204,0,137,17698
8/10/2018,22,10612,2357,3385,199,0,144,16697
8/10/2018,23,10613,1552,2933,120,0,97,15315
8/10/2018,24,10619,739,2885,160,0,10,14413
8/11/2018,1,10629,412,2800,162,0,1,14004
8/11/2018,2,10628,387,2900,187,0,2,14104
8/11/2018,3,10637,393,3087,199,0,1,14317
8/11/2018,4,10646,404,3147,210,0,1,14408
8/11/2018,5,10640,481,2971,218,0,1,14311
8/11/2018,6,10637,715,2936,257,0,1,14546
8/11/2018,7,10601,999,2742,183,27,1,14553
8/11/2018,8,10457,1317,3294,148,115,1,15332
8/11/2018,9,9747,1700,3823,48,200,1,15519
8/11/2018,10,9736,2122,3695,68,279,1,15901
8/11/2018,11,9724,2346,3893,68,313,1,16345
8/11/2018,12,9721,2568,4023,56,316,1,16685
8/11/2018,13,9729,2879,3838,80,308,1,16835
8/11/2018,14,9725,2666,3778,147,309,19,16644
8/11/2018,15,9698,3185,3992,108,270,57,17310
8/11/2018,16,9701,3692,4202,105,218,148,18066
8/11/2018,17,9655,3907,4460,150,155,174,18501
8/11/2018,18,9733,3744,4404,74,75,143,18173
8/11/2018,19,9743,3649,4279,100,22,67,17860
8/11/2018,20,9737,3140,3856,129,1,55,16918
8/11/2018,21,9744,3137,3612,136,0,68,16697
8/11/2018,22,9776,2259,3365,136,0,10,15546
8/11/2018,23,9775,1466,3392,135,0,1,14769
8/11/2018,24,9770,692,3073,211,0,1,13747
8/12/2018,1,9783,432,3184,133,0,1,13533
8/12/2018,2,9814,387,3226,148,0,1,13576
8/12/2018,3,9893,439,3288,149,0,1,13770
8/12/2018,4,9941,383,3101,111,0,1,13537
8/12/2018,5,9917,392,3207,90,0,1,13607
8/12/2018,6,9917,463,3193,116,0,1,13690
8/12/2018,7,9927,737,3129,120,28,1,13942
8/12/2018,8,9920,1016,3213,91,104,1,14345
8/12/2018,9,9926,1297,3413,28,193,1,14858
8/12/2018,10,9929,1605,3584,18,262,1,15399
8/12/2018,11,9923,1986,3837,25,309,1,16081
8/12/2018,12,9907,2589,3936,44,328,5,16809
8/12/2018,13,9904,3097,3891,68,310,19,17289
8/12/2018,14,9945,3548,3818,73,284,53,17721
8/12/2018,15,9962,3778,3983,130,275,130,18258
8/12/2018,16,9953,3922,4267,198,221,122,18683
8/12/2018,17,9946,4115,4336,197,159,124,18877
8/12/2018,18,9963,4310,4239,224,83,172,18991
8/12/2018,19,10000,4271,4096,178,20,167,18732
8/12/2018,20,10020,3817,3907,182,0,153,18079
8/12/2018,21,10021,3704,3747,235,0,108,17815
8/12/2018,22,10024,2802,3537,275,0,16,16654
8/12/2018,23,10012,1803,3281,280,0,2,15378
8/12/2018,24,10038,1088,3013,322,0,2,14463
8/13/2018,1,10057,869,3106,324,0,7,14363
8/13/2018,2,10060,834,3179,371,0,6,14450
8/13/2018,3,10066,798,3090,407,0,6,14367
8/13/2018,4,10061,983,2881,376,0,6,14307
8/13/2018,5,10065,1405,2717,313,0,12,14512
8/13/2018,6,10056,1989,2694,223,0,21,14983
8/13/2018,7,10060,2562,2747,197,28,26,15620
8/13/2018,8,10061,2782,3227,210,100,26,16406
8/13/2018,9,10059,3420,3500,78,188,26,17271
8/13/2018,10,10065,4157,3554,84,225,27,18112
8/13/2018,11,10062,4561,3483,128,239,26,18499
8/13/2018,12,10069,4203,3734,168,243,27,18444
8/13/2018,13,10059,4262,3983,183,243,46,18776
8/13/2018,14,10052,4174,4212,225,220,73,18956
8/13/2018,15,10069,4166,4442,224,174,77,19152
8/13/2018,16,10087,4374,4607,251,137,77,19533
8/13/2018,17,10080,4380,4628,258,93,79,19518
8/13/2018,18,10089,4385,4638,166,45,79,19402
8/13/2018,19,10097,4496,4541,126,14,86,19360
8/13/2018,20,10113,4968,4285,127,0,165,19658
8/13/2018,21,10111,4775,3992,145,0,135,19158
8/13/2018,22,10108,4022,3441,146,0,53,17770
8/13/2018,23,10112,2733,3247,158,0,33,16283
8/13/2018,24,10123,2264,2779,194,0,30,15390
8/14/2018,1,10210,1812,2697,201,0,26,14946
8/14/2018,2,10338,1723,2742,252,0,28,15083
8/14/2018,3,10341,1715,2989,290,0,31,15366
8/14/2018,4,10289,1727,3077,309,0,30,15432
8/14/2018,5,10284,1739,2858,224,0,32,15137
8/14/2018,6,10282,1870,2982,183,0,41,15358
8/14/2018,7,10278,2148,3179,188,12,26,15831
8/14/2018,8,10280,2853,3136,120,72,27,16488
8/14/2018,9,10322,3758,3258,77,136,27,17578
8/14/2018,10,10632,3883,3291,78,188,27,18099
8/14/2018,11,10714,4175,3434,83,200,27,18633
8/14/2018,12,10565,4463,3502,140,207,29,18906
8/14/2018,13,10537,4742,3533,182,260,49,19303
8/14/2018,14,10724,4813,3625,305,233,51,19751
8/14/2018,15,10736,4510,4218,525,207,50,20246
8/14/2018,16,10728,4348,4670,641,194,52,20633
8/14/2018,17,10734,4410,4701,600,143,51,20639
8/14/2018,18,10723,4256,4385,557,62,52,20035
8/14/2018,19,10722,4400,4286,468,20,61,19957
8/14/2018,20,10721,4501,4328,531,0,67,20148
8/14/2018,21,10768,4515,3498,733,0,66,19580
8/14/2018,22,10886,2903,3111,815,0,68,17783
8/14/2018,23,10925,2249,2884,666,0,57,16781
8/14/2018,24,10931,1337,2783,678,0,53,15782
8/15/2018,1,10919,1154,2688,668,0,45,15474
8/15/2018,2,10903,1155,2771,762,0,37,15628
8/15/2018,3,10892,1167,2975,766,0,36,15836
8/15/2018,4,10878,1210,3146,636,0,33,15903
8/15/2018,5,10884,1260,2750,644,0,48,15586
8/15/2018,6,10894,1417,2811,590,0,57,15769
8/15/2018,7,10904,1979,2754,575,29,67,16308
8/15/2018,8,10908,2703,3079,392,94,72,17248
8/15/2018,9,10894,3336,3348,202,179,68,18027
8/15/2018,10,10900,4118,3456,202,241,69,18986
8/15/2018,11,10888,4623,3357,228,286,68,19450
8/15/2018,12,10912,4479,3462,386,290,62,19591
8/15/2018,13,10916,4148,3646,470,257,48,19485
8/15/2018,14,10894,3900,3852,649,221,48,19564
8/15/2018,15,10850,3899,3994,776,210,48,19777
8/15/2018,16,10819,4247,4518,768,163,49,20564
8/15/2018,17,10801,4206,4657,667,105,48,20484
8/15/2018,18,10840,3966,4656,565,55,47,20129
8/15/2018,19,11024,4212,4565,462,14,47,20324
8/15/2018,20,11072,4227,4231,459,0,45,20034
8/15/2018,21,11110,4316,3722,453,0,39,19640
8/15/2018,22,11099,3873,3481,454,0,34,18941
8/15/2018,23,11100,2563,3057,433,0,41,17194
8/15/2018,24,11122,1944,2776,536,0,44,16422
8/16/2018,1,11276,1281,2639,750,0,42,15988
8/16/2018,2,11288,1134,2664,900,0,45,16031
8/16/2018,3,11306,1131,2848,689,0,49,16023
8/16/2018,4,11458,1153,2794,487,0,40,15932
8/16/2018,5,11431,1185,2682,243,0,37,15578
8/16/2018,6,11391,1389,2771,228,0,49,15828
8/16/2018,7,11384,1889,2882,165,15,37,16372
8/16/2018,8,11391,2398,3286,367,72,29,17543
8/16/2018,9,11391,2686,3437,666,132,29,18341
8/16/2018,10,11359,2990,3799,759,167,48,19122
8/16/2018,11,11383,3783,3789,782,225,87,20049
8/16/2018,12,11440,3728,3798,757,238,101,20062
8/16/2018,13,11447,4038,4043,666,253,108,20555
8/16/2018,14,11433,3988,4155,839,234,107,20756
8/16/2018,15,11389,4014,4053,902,208,84,20650
8/16/2018,16,11325,4046,4210,754,175,101,20611
8/16/2018,17,11393,4002,4422,657,123,103,20700
8/16/2018,18,11393,4003,4394,505,52,91,20438
8/16/2018,19,11411,3770,4269,470,11,100,20031
8/16/2018,20,11423,3495,4131,824,0,133,20006
8/16/2018,21,11417,3815,3736,703,0,146,19817
8/16/2018,22,11406,2752,3612,680,0,82,18532
8/16/2018,23,11397,1897,3344,851,0,32,17521
8/16/2018,24,11400,955,3250,830,0,15,16450
8/17/2018,1,11400,936,3259,722,0,14,16331
8/17/2018,2,11396,963,3095,703,0,14,16171
8/17/2018,3,11404,824,3122,722,0,14,16086
8/17/2018,4,11470,1117,3222,639,0,15,16463
8/17/2018,5,11481,1518,3115,561,0,15,16690
8/17/2018,6,11516,1808,3009,579,0,18,16930
8/17/2018,7,11530,1979,3120,612,3,29,17273
8/17/2018,8,11510,2273,3499,666,13,28,17989
8/17/2018,9,11535,2535,3883,764,32,28,18777
8/17/2018,10,11478,3293,3962,839,40,28,19640
8/17/2018,11,11480,3750,4031,658,89,28,20036
8/17/2018,12,11436,4045,4253,628,140,42,20544
8/17/2018,13,11424,3847,4232,715,142,77,20437
8/17/2018,14,11450,3460,4204,812,147,79,20152
8/17/2018,15,11456,3592,4027,705,144,79,20003
8/17/2018,16,11465,3728,4123,629,81,79,20105
8/17/2018,17,11484,3503,4330,576,60,79,20032
8/17/2018,18,11517,3385,4312,347,27,79,19667
8/17/2018,19,11561,2918,4454,300,9,79,19321
8/17/2018,20,11588,2988,4130,364,0,104,19174
8/17/2018,21,11578,2569,3670,456,0,161,18434
8/17/2018,22,11575,1999,3560,450,0,66,17650
8/17/2018,23,11573,797,3544,361,0,20,16295
8/17/2018,24,11559,350,3602,282,0,9,15802
8/18/2018,1,11552,238,3426,355,0,1,15572
8/18/2018,2,11538,235,3356,446,0,1,15576
8/18/2018,3,11512,231,3180,465,0,1,15389
8/18/2018,4,11503,290,2944,652,0,1,15390
8/18/2018,5,11492,510,2759,524,0,1,15286
8/18/2018,6,11495,751,2775,577,0,1,15599
8/18/2018,7,11486,877,2788,386,10,1,15548
8/18/2018,8,11477,862,3068,288,66,1,15762
8/18/2018,9,11475,1046,3474,254,180,2,16431
8/18/2018,10,11491,1421,3264,287,233,1,16697
8/18/2018,11,11505,1570,3492,213,285,1,17066
8/18/2018,12,11494,1557,3667,221,299,1,17239
8/18/2018,13,11481,1495,3822,228,298,1,17325
8/18/2018,14,11525,1651,3657,254,291,1,17379
8/18/2018,15,11539,1765,3872,225,251,1,17653
8/18/2018,16,11544,2009,4107,217,201,1,18079
8/18/2018,17,11552,1925,4401,240,126,1,18245
8/18/2018,18,11564,1801,4322,184,61,1,17933
8/18/2018,19,11574,1561,4213,148,13,1,17510
8/18/2018,20,11575,1441,4193,203,0,1,17413
8/18/2018,21,11581,1487,3637,218,0,1,16924
8/18/2018,22,11580,1028,3402,172,0,1,16183
8/18/2018,23,11570,394,3326,180,0,1,15471
8/18/2018,24,11591,200,3089,159,0,1,15040
8/19/2018,1,11614,200,2964,165,0,1,14944
8/19/2018,2,11633,199,2910,150,0,1,14893
8/19/2018,3,11624,200,2664,143,0,1,14632
8/19/2018,4,11632,199,2491,58,0,1,14381
8/19/2018,5,11615,205,2529,88,0,1,14438
8/19/2018,6,11613,227,2613,103,0,1,14557
8/19/2018,7,11611,308,2785,180,25,1,14910
8/19/2018,8,11622,500,2929,248,88,1,15388
8/19/2018,9,11625,755,2926,135,170,1,15612
8/19/2018,10,11627,835,3080,85,228,1,15856
8/19/2018,11,11631,821,3412,48,273,1,16186
8/19/2018,12,11610,946,3616,28,270,1,16471
8/19/2018,13,11607,1067,3662,32,235,1,16604
8/19/2018,14,11595,1493,3156,44,234,1,16523
8/19/2018,15,11594,1849,3268,54,217,1,16983
8/19/2018,16,11663,1988,3679,74,199,1,17604
8/19/2018,17,11682,1995,3898,54,137,1,17767
8/19/2018,18,11688,1956,3902,59,64,1,17670
8/19/2018,19,11668,1979,3795,73,16,1,17532
8/19/2018,20,11670,1703,3611,68,0,1,17053
8/19/2018,21,11350,1599,3441,109,0,1,16500
8/19/2018,22,10887,908,3390,144,0,1,15330
8/19/2018,23,10902,304,3106,286,0,1,14599
8/19/2018,24,10919,171,2745,467,0,1,14303
8/20/2018,1,10909,184,2650,495,0,8,14246
8/20/2018,2,10898,191,2955,384,0,9,14437
8/20/2018,3,10899,191,3179,295,0,9,14573
8/20/2018,4,10900,300,3286,217,0,9,14712
8/20/2018,5,10900,488,3212,377,0,19,14996
8/20/2018,6,10895,820,3146,371,0,26,15258
8/20/2018,7,10892,1503,2909,281,18,28,15631
8/20/2018,8,10900,1914,2923,122,15,28,15902
8/20/2018,9,10894,2294,3320,181,146,28,16863
8/20/2018,10,10877,2297,3394,233,219,28,17048
8/20/2018,11,10849,2751,3537,237,229,30,17633
8/20/2018,12,10860,3234,3542,273,248,29,18186
8/20/2018,13,10862,3554,3710,286,270,40,18722
8/20/2018,14,10852,3591,3808,272,269,72,18864
8/20/2018,15,10837,3488,4090,330,219,79,19043
8/20/2018,16,10821,3783,4170,347,190,80,19391
8/20/2018,17,10797,3537,4092,302,102,79,18909
8/20/2018,18,10797,3135,4246,362,50,79,18669
8/20/2018,19,10785,2966,4382,454,9,84,18680
8/20/2018,20,10783,3005,4317,683,0,82,18870
8/20/2018,21,10780,2816,3473,1047,0,82,18198
8/20/2018,22,10794,1811,3075,1159,0,86,16925
8/20/2018,23,10818,971,3006,992,0,37,15824
8/20/2018,24,10822,590,2681,1211,0,14,15318
8/21/2018,1,10819,568,2536,1224,0,11,15158
8/21/2018,2,10804,568,2606,1362,0,11,15351
8/21/2018,3,10780,569,2716,1623,0,11,15699
8/21/2018,4,10798,582,2890,1296,0,11,15577
8/21/2018,5,10778,690,2667,1448,0,11,15594
8/21/2018,6,10773,1033,2846,1189,0,11,15852
8/21/2018,7,10767,1542,2905,1097,1,11,16323
8/21/2018,8,10760,1891,3031,1209,6,11,16908
8/21/2018,9,10760,2151,3252,1456,25,10,17654
8/21/2018,10,10757,2302,3364,1623,80,10,18136
8/21/2018,11,10758,2660,3853,1559,91,10,18931
8/21/2018,12,10764,2770,3709,1532,84,10,18869
8/21/2018,13,10766,2806,3821,1381,121,10,18905
8/21/2018,14,10767,2781,3901,1344,127,10,18930
8/21/2018,15,10740,2744,4179,1340,93,10,19106
8/21/2018,16,10799,2440,4214,1292,66,10,18821
8/21/2018,17,10811,2490,4373,1457,44,10,19185
8/21/2018,18,10744,2252,3973,1859,44,10,18882
8/21/2018,19,10742,1895,3423,2690,8,10,18768
8/21/2018,20,10730,1708,3638,2986,0,10,19072
8/21/2018,21,10752,1335,3840,2321,0,10,18258
8/21/2018,22,10758,913,3561,2348,0,10,17590
8/21/2018,23,10789,323,3020,2131,0,10,16273
8/21/2018,24,10842,200,2684,2122,0,10,15858
8/22/2018,1,10845,165,2443,2046,0,10,15509
8/22/2018,2,10858,202,2451,2056,0,10,15577
8/22/2018,3,10867,202,2449,1860,0,10,15388
8/22/2018,4,10844,209,2598,1740,0,10,15401
8/22/2018,5,10820,283,2692,1685,1,10,15491
8/22/2018,6,10818,489,2951,1562,1,10,15831
8/22/2018,7,10800,757,2986,1900,21,10,16474
8/22/2018,8,10770,885,3541,2005,56,10,17267
8/22/2018,9,10780,970,3445,2159,99,10,17463
8/22/2018,10,10794,913,3093,2231,157,10,17198
8/22/2018,11,10815,1018,3006,2169,184,10,17202
8/22/2018,12,10813,1298,2994,2104,163,305,17677
8/22/2018,13,10822,1481,3113,1699,196,304,17615
8/22/2018,14,10832,1482,3146,1879,245,10,17594
8/22/2018,15,10849,1490,3232,1796,254,10,17631
8/22/2018,16,10872,1034,3616,1730,221,12,17485
8/22/2018,17,10902,1045,3814,2016,134,11,17922
8/22/2018,18,10910,1050,3957,1503,72,11,17503
8/22/2018,19,10906,1172,4292,769,16,10,17165
8/22/2018,20,10909,1426,4141,525,0,10,17011
8/22/2018,21,10902,1320,3786,503,0,10,16521
8/22/2018,22,10895,569,3402,613,0,10,15489
8/22/2018,23,10871,360,2933,601,0,10,14775
8/22/2018,24,10846,515,2683,482,0,10,14536
8/23/2018,1,10827,534,2779,435,0,10,14585
8/23/2018,2,10827,543,2688,599,0,10,14667
8/23/2018,3,10848,542,2628,731,0,10,14759
8/23/2018,4,10847,471,2694,533,0,10,14555
8/23/2018,5,10852,400,2760,486,1,10,14509
8/23/2018,6,10858,279,2817,879,1,10,14844
8/23/2018,7,10876,335,2935,874,26,10,15056
8/23/2018,8,10905,375,3264,655,106,10,15315
8/23/2018,9,10913,453,3458,383,202,10,15419
8/23/2018,10,10945,458,3545,404,278,10,15640
8/23/2018,11,10953,854,3376,451,317,11,15962
8/23/2018,12,10928,1200,3255,508,310,12,16213
8/23/2018,13,10921,1446,3380,549,293,10,16599
8/23/2018,14,10890,1448,3550,1179,264,10,17341
8/23/2018,15,10847,1486,3362,1538,268,10,17511
8/23/2018,16,10834,1640,3519,1684,214,14,17905
8/23/2018,17,10827,1664,3920,1674,146,27,18258
8/23/2018,18,10837,1681,4007,1491,66,27,18109
8/23/2018,19,10910,1696,3834,1306,12,27,17785
8/23/2018,20,10976,1705,3602,1269,0,28,17580
8/23/2018,21,11025,1699,3285,1424,0,28,17461
8/23/2018,22,11049,1203,2886,1293,0,28,16459
8/23/2018,23,11050,452,2811,1386,0,16,15715
8/23/2018,24,11024,274,2802,1080,0,12,15192
8/24/2018,1,11036,235,2720,944,0,13,14948
8/24/2018,2,11012,205,2747,1011,0,11,14986
8/24/2018,3,10992,207,2717,864,0,11,14791
8/24/2018,4,10981,212,2835,714,0,12,14754
8/24/2018,5,10979,218,2928,518,0,12,14655
8/24/2018,6,10954,297,3136,516,0,27,14930
8/24/2018,7,10980,513,3278,584,23,32,15410
8/24/2018,8,10994,751,3626,622,103,28,16124
8/24/2018,9,11001,853,3549,495,200,28,16126
8/24/2018,10,11001,845,3578,792,270,28,16514
8/24/2018,11,10994,964,3661,1288,313,28,17248
8/24/2018,12,10989,1163,3333,1462,308,28,17283
8/24/2018,13,10958,1432,3288,1616,265,28,17587
8/24/2018,14,10932,1953,3418,1449,285,28,18065
8/24/2018,15,10924,2058,3650,1166,261,28,18087
8/24/2018,16,10895,2643,3996,908,203,28,18673
8/24/2018,17,10874,2642,4286,676,125,28,18631
8/24/2018,18,10873,2547,3950,605,51,27,18053
8/24/2018,19,10927,2072,3841,657,10,28,17535
8/24/2018,20,10952,2024,3619,877,0,28,17500
8/24/2018,21,10978,1516,3064,1206,0,28,16792
8/24/2018,22,10991,727,2836,1599,0,28,16181
8/24/2018,23,10992,282,2777,1417,0,20,15488
8/24/2018,24,10992,194,2744,1344,0,10,15284
8/25/2018,1,10993,193,2681,1116,0,1,14984
8/25/2018,2,10973,194,2729,1058,0,1,14955
8/25/2018,3,10938,199,2717,1261,0,1,15116
8/25/2018,4,10930,208,2701,1681,0,1,15521
8/25/2018,5,10910,573,2737,1667,1,1,15889
8/25/2018,6,10907,549,2677,1634,1,1,15769
8/25/2018,7,10929,733,2801,1677,16,1,16157
8/25/2018,8,10953,714,2874,2098,70,1,16710
8/25/2018,9,10979,619,2872,2469,135,1,17075
8/25/2018,10,11005,699,3152,2188,182,1,17227
8/25/2018,11,11003,996,3101,2543,198,1,17842
8/25/2018,12,11019,1127,3108,2619,188,1,18062
8/25/2018,13,11022,1277,2960,2136,167,1,17563
8/25/2018,14,11025,1437,2935,1625,164,1,17187
8/25/2018,15,11036,1438,3087,1535,145,1,17242
8/25/2018,16,11038,1109,3346,1923,122,1,17539
8/25/2018,17,11057,1016,3708,2011,62,1,17855
8/25/2018,18,11077,1016,3977,2033,44,1,18148
8/25/2018,19,11080,1013,4010,2098,5,1,18207
8/25/2018,20,11068,1131,4257,1987,0,1,18444
8/25/2018,21,11059,718,3559,2140,0,1,17477
8/25/2018,22,11041,305,3052,2223,0,1,16622
8/25/2018,23,11017,218,2828,2208,0,1,16272
8/25/2018,24,10991,216,2758,2080,0,1,16046
8/26/2018,1,10979,217,2490,1862,0,1,15549
8/26/2018,2,10982,221,2559,1684,0,1,15447
8/26/2018,3,10992,220,2588,1423,0,1,15224
8/26/2018,4,11020,295,2584,1189,0,1,15089
8/26/2018,5,11006,310,2595,990,0,1,14902
8/26/2018,6,11005,483,2722,773,1,1,14985
8/26/2018,7,11054,691,2857,693,4,1,15300
8/26/2018,8,11082,920,3172,544,48,1,15767
8/26/2018,9,11087,1292,3334,515,90,1,16319
8/26/2018,10,11076,1456,3270,428,170,1,16401
8/26/2018,11,11066,1716,3261,396,192,1,16632
8/26/2018,12,11057,1825,3335,466,208,2,16893
8/26/2018,13,11050,2201,3420,496,226,1,17394
8/26/2018,14,11006,2523,3539,491,252,1,17812
8/26/2018,15,11047,2948,3681,466,238,1,18381
8/26/2018,16,11056,2897,4158,496,193,1,18801
8/26/2018,17,11060,3149,4509,372,120,3,19213
8/26/2018,18,11062,3575,4544,286,56,4,19527
8/26/2018,19,11054,3544,4387,214,10,2,19211
8/26/2018,20,11057,3512,4335,218,0,6,19128
8/26/2018,21,11058,3376,3675,253,0,1,18363
8/26/2018,22,11072,2733,3336,385,0,1,17527
8/26/2018,23,11085,1827,3295,407,0,1,16615
8/26/2018,24,11099,1110,3275,330,0,1,15815
8/27/2018,1,11105,749,2782,568,0,1,15205
8/27/2018,2,11109,606,2617,747,0,9,15088
8/27/2018,3,11103,770,2574,1020,0,10,15477
8/27/2018,4,11106,1020,2554,602,0,10,15292
8/27/2018,5,11106,1529,2799,614,0,28,16076
8/27/2018,6,11106,1862,2686,693,0,27,16374
8/27/2018,7,11107,2215,2715,690,10,28,16765
8/27/2018,8,11096,2614,2848,459,41,34,17092
8/27/2018,9,11084,3161,2815,849,97,64,18070
8/27/2018,10,11074,3298,2928,1207,105,88,18700
8/27/2018,11,11050,3435,3051,1690,168,85,19479
8/27/2018,12,11027,3356,2947,1891,160,88,19469
8/27/2018,13,11049,3264,3007,2156,119,98,19693
8/27/2018,14,11066,3304,3137,2537,156,104,20304
8/27/2018,15,11068,3354,3320,2428,169,103,20442
8/27/2018,16,11073,3149,3835,2546,117,103,20823
8/27/2018,17,11086,3272,3908,2331,113,102,20812
8/27/2018,18,11095,3350,4121,2209,51,101,20927
8/27/2018,19,11092,3399,4210,2215,6,92,21014
8/27/2018,20,11085,3630,3771,2636,0,116,21238
8/27/2018,21,11067,3165,3484,2727,0,93,20536
8/27/2018,22,11026,2434,3256,2537,0,84,19337
8/27/2018,23,10976,1660,3014,2182,0,62,17894
8/27/2018,24,10986,685,2595,2429,0,15,16710
8/28/2018,1,10991,492,2484,2172,0,10,16149
8/28/2018,2,11003,592,2508,1986,0,10,16099
8/28/2018,3,11012,753,2363,2295,0,10,16433
8/28/2018,4,11023,923,2355,2544,0,10,16855
8/28/2018,5,11030,1020,2449,2184,0,15,16698
8/28/2018,6,11041,1302,2633,2225,1,22,17224
8/28/2018,7,11042,1834,2706,2433,6,27,18048
8/28/2018,8,11045,2350,2857,2747,53,29,19081
8/28/2018,9,11035,2640,3191,2482,130,56,19534
8/28/2018,10,11006,3338,3214,2502,187,80,20327
8/28/2018,11,10986,3430,3276,2548,236,81,20557
8/28/2018,12,10979,3744,3237,2742,244,89,21035
8/28/2018,13,10972,3758,3443,2740,258,85,21256
8/28/2018,14,11012,4683,3605,2209,238,108,21855
8/28/2018,15,11052,4747,3785,1645,233,169,21631
8/28/2018,16,11073,4698,3981,1392,203,181,21528
8/28/2018,17,11086,4614,4345,1258,128,184,21615
8/28/2018,18,11102,4044,4528,1112,55,100,20941
8/28/2018,19,11114,4296,4528,995,7,106,21046
8/28/2018,20,11116,4743,4220,976,0,163,21218
8/28/2018,21,11118,4683,3696,1239,0,208,20944
8/28/2018,22,11120,3434,3517,1657,0,109,19837
8/28/2018,23,11115,2289,3020,1939,0,78,18441
8/28/2018,24,11113,1215,2920,1716,0,67,17031
8/29/2018,1,11108,671,3084,1928,0,23,16814
8/29/2018,2,11105,422,2676,2060,0,10,16273
8/29/2018,3,11079,494,3089,1565,0,10,16237
8/29/2018,4,11082,660,3187,1734,0,11,16674
8/29/2018,5,11126,769,2539,1930,0,16,16380
8/29/2018,6,11129,1066,2713,1748,0,19,16675
8/29/2018,7,11121,1550,2773,2171,6,28,17649
8/29/2018,8,11120,2038,3360,2140,70,51,18779
8/29/2018,9,11127,2712,3406,1874,137,88,19344
8/29/2018,10,11122,3111,3603,1526,195,161,19718
8/29/2018,11,11120,3818,3721,1286,211,220,20376
8/29/2018,12,11109,3807,3383,1239,170,186,19894
8/29/2018,13,11092,3820,3735,962,188,119,19916
8/29/2018,14,11109,4040,3753,646,152,162,19862
8/29/2018,15,11106,3263,3735,776,186,131,19197
8/29/2018,16,11109,3146,4023,896,110,86,19370
8/29/2018,17,11105,3722,4238,1048,71,85,20269
8/29/2018,18,11112,3876,4137,1052,22,81,20280
8/29/2018,19,11121,3571,4059,1190,5,78,20024
8/29/2018,20,11123,3967,3725,1022,0,103,19940
8/29/2018,21,11128,3589,3550,973,0,94,19334
8/29/2018,22,11119,2683,3261,871,0,79,18013
8/29/2018,23,11116,1998,3059,724,0,32,16929
8/29/2018,24,11127,858,2883,626,0,13,15507
8/30/2018,1,11137,258,2935,574,0,11,14915
8/30/2018,2,11140,186,2940,477,0,11,14754
8/30/2018,3,11145,193,3041,486,0,11,14876
8/30/2018,4,11144,237,2948,565,0,11,14905
8/30/2018,5,11146,438,3231,498,0,15,15328
8/30/2018,6,11142,847,3092,415,0,22,15518
8/30/2018,7,11139,1343,2969,325,11,29,15816
8/30/2018,8,11124,1428,3069,259,70,50,16000
8/30/2018,9,11095,1427,2970,265,151,79,15987
8/30/2018,10,10946,1501,3160,262,195,79,16143
8/30/2018,11,10927,1787,3054,257,249,79,16353
8/30/2018,12,10945,1901,2886,168,262,76,16238
8/30/2018,13,10999,1651,3109,169,273,77,16278
8/30/2018,14,10902,1628,3171,78,142,80,16001
8/30/2018,15,10564,1839,3385,147,246,61,16242
8/30/2018,16,10552,1752,3590,116,176,27,16213
8/30/2018,17,10535,1581,3936,189,149,28,16418
8/30/2018,18,10522,1588,4037,230,66,28,16471
8/30/2018,19,10519,1613,4069,299,9,28,16537
8/30/2018,20,10513,1756,3711,386,0,28,16394
8/30/2018,21,10510,1566,3362,456,0,28,15922
8/30/2018,22,10516,894,2983,411,0,28,14832
8/30/2018,23,10538,248,2858,488,0,18,14150
8/30/2018,24,10530,135,2672,418,0,13,13768
8/31/2018,1,10534,137,2592,515,0,10,13788
8/31/2018,2,10544,139,2629,557,0,4,13873
8/31/2018,3,10550,152,2591,697,0,5,13995
8/31/2018,4,10561,233,2625,621,0,5,14045
8/31/2018,5,10549,399,2838,703,0,14,14503
8/31/2018,6,10537,692,2845,568,0,22,14664
8/31/2018,7,10532,827,3011,544,18,27,14959
8/31/2018,8,10508,895,3031,444,99,28,15005
8/31/2018,9,10456,1175,3453,226,191,28,15529
8/31/2018,10,10406,1581,3247,132,234,28,15628
8/31/2018,11,10464,1629,3477,142,250,28,15990
8/31/2018,12,10462,2027,3664,230,272,28,16683
8/31/2018,13,10468,2034,3648,233,282,27,16692
8/31/2018,14,10464,2339,3623,244,264,27,16961
8/31/2018,15,10456,2502,3927,366,234,27,17512
8/31/2018,16,10460,2307,3933,468,188,27,17383
8/31/2018,17,10230,2394,4231,488,108,28,17479
8/31/2018,18,10193,2686,4102,517,48,32,17578
8/31/2018,19,9988,2425,3957,498,6,32,16906
8/31/2018,20,9800,2259,3777,714,0,33,16583
8/31/2018,21,9716,2221,3158,752,0,27,15874
8/31/2018,22,9675,1706,2934,1087,0,27,15429
8/31/2018,23,9665,451,2764,1224,0,17,14121
8/31/2018,24,9665,190,2762,1207,0,5,13829
9/1/2018,1,9664,190,2586,1431,0,1,13872
9/1/2018,2,9668,192,2565,1626,0,2,14053
9/1/2018,3,9660,198,2916,1572,0,5,14351
9/1/2018,4,9643,274,2890,1624,0,12,14443
9/1/2018,5,9630,411,2731,1721,0,8,14501
9/1/2018,6,9639,585,2867,1751,0,2,14844
9/1/2018,7,9635,810,2713,1509,7,1,14675
9/1/2018,8,9629,870,2925,1411,53,4,14892
9/1/2018,9,9627,1039,3208,1156,112,29,15171
9/1/2018,10,9634,1314,3113,1067,165,65,15358
9/1/2018,11,9640,1398,3048,1038,215,88,15427
9/1/2018,12,9646,1748,3110,1348,220,92,16164
9/1/2018,13,9639,2173,3183,1393,229,69,16686
9/1/2018,14,9635,2239,3671,1392,259,64,17260
9/1/2018,15,9595,2496,4252,1175,252,56,17826
9/1/2018,16,9629,3177,4308,1011,196,116,18437
9/1/2018,17,9618,3264,4603,999,123,123,18730
9/1/2018,18,9619,2981,4453,925,43,120,18141
9/1/2018,19,9615,2900,4354,811,4,68,17752
9/1/2018,20,9604,2417,4111,1179,0,57,17368
9/1/2018,21,9606,2053,3831,1428,0,57,16975
9/1/2018,22,9602,1641,3379,1599,0,57,16278
9/1/2018,23,9600,1218,3539,1438,0,13,15808
9/1/2018,24,9609,616,3313,1392,0,1,14931
9/2/2018,1,9606,242,3125,1511,0,1,14485
9/2/2018,2,9610,209,3041,1510,0,1,14371
9/2/2018,3,9599,233,3256,1460,0,1,14549
9/2/2018,4,9594,252,3132,1582,0,1,14561
9/2/2018,5,9593,287,3060,1468,0,1,14409
9/2/2018,6,9584,475,3473,1316,1,1,14850
9/2/2018,7,9590,872,2834,1234,11,1,14542
9/2/2018,8,9588,1123,2904,1066,27,5,14713
9/2/2018,9,9581,1705,3041,1074,44,6,15451
9/2/2018,10,9578,2165,3505,619,75,30,15972
9/2/2018,11,9580,3055,3604,502,117,54,16912
9/2/2018,12,9573,3324,3438,738,188,78,17339
9/2/2018,13,9579,2842,3368,1121,222,57,17189
9/2/2018,14,9578,2936,3728,1410,249,57,17958
9/2/2018,15,9574,3313,4038,1575,233,57,18790
9/2/2018,16,9560,3825,4252,1546,193,60,19436
9/2/2018,17,9550,4285,4467,1243,121,71,19737
9/2/2018,18,9565,4334,4327,967,53,75,19321
9/2/2018,19,9574,4197,4303,897,6,65,19042
9/2/2018,20,9569,3941,3935,1008,0,68,18521
9/2/2018,21,9565,3530,3678,1251,0,63,18087
9/2/2018,22,9570,2294,3574,1573,0,52,17063
9/2/2018,23,9571,1062,3374,1794,0,10,15811
9/2/2018,24,9581,618,3082,1979,0,1,15261
9/3/2018,1,9586,592,2771,2184,0,1,15134
9/3/2018,2,9600,593,2702,2298,0,1,15194
9/3/2018,3,9602,654,3151,1802,0,1,15210
9/3/2018,4,9602,880,3209,1583,0,1,15275
9/3/2018,5,9598,818,3207,1472,0,4,15099
9/3/2018,6,9605,832,2959,1414,0,4,14814
9/3/2018,7,9604,1177,2839,1198,8,1,14827
9/3/2018,8,9600,1629,2967,834,84,19,15133
9/3/2018,9,9613,2428,3299,734,165,38,16277
9/3/2018,10,9620,3256,3469,749,252,69,17415
9/3/2018,11,9618,3972,3998,732,287,94,18701
9/3/2018,12,9625,4672,3836,681,296,125,19235
9/3/2018,13,9628,5029,3592,770,271,125,19415
9/3/2018,14,9629,4288,4133,1190,180,89,19509
9/3/2018,15,9630,4292,4343,990,136,89,19480
9/3/2018,16,9608,5111,4448,526,135,125,19953
9/3/2018,17,9593,5261,4616,379,79,127,20055
9/3/2018,18,9607,5395,4776,310,39,122,20249
9/3/2018,19,9616,5464,4442,240,7,121,19890
9/3/2018,20,9615,5485,4281,146,0,124,19651
9/3/2018,21,9622,5349,4036,122,0,130,19259
9/3/2018,22,9642,4019,3517,97,0,61,17336
9/3/2018,23,9645,2839,3347,109,0,10,15950
9/3/2018,24,9637,2367,2880,221,0,1,15106
9/4/2018,1,9639,2294,2893,89,0,1,14916
9/4/2018,2,9662,1944,2738,107,0,1,14452
9/4/2018,3,9662,1871,3014,191,0,1,14739
9/4/2018,4,9658,1956,2931,392,0,3,14940
9/4/2018,5,9657,2155,2689,237,0,13,14751
9/4/2018,6,9654,2352,2800,616,0,20,15442
9/4/2018,7,9649,2585,3284,728,14,33,16293
9/4/2018,8,9646,2841,3502,728,95,59,16871
9/4/2018,9,9638,3456,3557,633,162,81,17527
9/4/2018,10,9636,4427,3440,582,213,86,18384
9/4/2018,11,9633,4721,3489,569,246,86,18744
9/4/2018,12,9623,5202,3618,563,212,122,19340
9/4/2018,13,9613,5277,3961,585,251,141,19828
9/4/2018,14,9616,4789,4429,571,259,118,19782
9/4/2018,15,9616,5242,4448,477,266,143,20192
9/4/2018,16,9613,5266,4596,420,215,154,20264
9/4/2018,17,9611,5010,4747,382,121,180,20051
9/4/2018,18,9607,5066,4588,349,47,236,19893
9/4/2018,19,9603,5163,4281,382,3,244,19676
9/4/2018,20,9598,4692,4465,600,0,225,19580
9/4/2018,21,9615,4711,3802,772,0,230,19130
9/4/2018,22,9780,3595,3489,990,0,167,18021
9/4/2018,23,9781,2788,3233,1014,0,90,16906
9/4/2018,24,9779,1718,3155,1035,0,30,15717
9/5/2018,1,9886,1506,2927,1094,0,17,15430
9/5/2018,2,9960,1491,2850,1168,0,17,15486
9/5/2018,3,9983,1536,2877,1250,0,17,15663
9/5/2018,4,9990,1558,3036,1343,0,17,15944
9/5/2018,5,10150,1821,2802,1207,0,17,15997
9/5/2018,6,10152,2175,2818,1226,0,22,16393
9/5/2018,7,10150,2582,3018,1250,8,30,17038
9/5/2018,8,10146,3122,3439,1127,84,30,17948
9/5/2018,9,10139,4107,4222,906,165,30,19569
9/5/2018,10,10141,4508,3999,1017,238,31,19934
9/5/2018,11,10142,4648,3343,1306,278,31,19748
9/5/2018,12,10152,3668,3663,1688,291,41,19503
9/5/2018,13,10150,3891,3884,2006,290,57,20278
9/5/2018,14,10143,3864,4183,2438,290,52,20970
9/5/2018,15,10136,3953,4495,2648,256,68,21556
9/5/2018,16,10148,4008,4646,2540,197,92,21631
9/5/2018,17,10236,4257,4865,2154,118,94,21724
9/5/2018,18,10241,5032,4614,1729,46,113,21775
9/5/2018,19,10237,4841,4736,1581,4,145,21544
9/5/2018,20,10249,4192,4662,1659,0,107,20869
9/5/2018,21,10257,4060,4394,1582,0,92,20385
9/5/2018,22,10269,3738,4039,1586,0,49,19681
9/5/2018,23,10284,2591,3970,1330,0,26,18201
9/5/2018,24,10290,2523,3851,635,0,16,17315
9/6/2018,1,10294,1624,3575,693,0,13,16199
9/6/2018,2,10297,1265,3629,528,0,13,15732
9/6/2018,3,10324,1034,3286,686,0,13,15343
9/6/2018,4,10357,1042,3520,819,0,13,15751
9/6/2018,5,10368,1197,3387,555,0,17,15524
9/6/2018,6,10374,1630,3529,532,0,22,16087
9/6/2018,7,10374,2491,3579,518,4,31,16997
9/6/2018,8,10375,3016,3524,341,50,31,17337
9/6/2018,9,10378,3474,3238,387,97,29,17603
9/6/2018,10,10385,3141,3810,329,141,31,17837
9/6/2018,11,10389,3504,4071,292,199,60,18515
9/6/2018,12,10387,3483,4086,376,202,79,18613
9/6/2018,13,10385,3557,4249,481,218,79,18969
9/6/2018,14,10382,3694,4183,612,195,79,19145
9/6/2018,15,10367,3937,4323,707,210,79,19623
9/6/2018,16,10363,4229,4339,815,162,79,19987
9/6/2018,17,10346,3997,4370,955,122,79,19869
9/6/2018,18,10332,3613,4317,821,38,78,19199
9/6/2018,19,10334,3490,4463,588,4,78,18957
9/6/2018,20,10340,2963,4464,664,0,78,18509
9/6/2018,21,10360,2519,4158,714,0,55,17806
9/6/2018,22,10368,1992,3683,727,0,27,16797
9/6/2018,23,10390,987,3279,770,0,19,15445
9/6/2018,24,10397,300,3340,798,0,14,14849
9/7/2018,1,10413,203,3120,675,0,13,14424
9/7/2018,2,10401,206,3224,551,0,14,14396
9/7/2018,3,10415,192,3517,433,0,14,14571
9/7/2018,4,10428,322,3498,403,0,13,14664
9/7/2018,5,10425,619,3092,409,0,16,14561
9/7/2018,6,10426,1034,3274,456,1,22,15213
9/7/2018,7,10418,1254,3704,589,13,27,16005
9/7/2018,8,10418,1248,3565,530,67,27,15855
9/7/2018,9,10412,1291,3779,408,135,28,16053
9/7/2018,10,10406,1316,4204,389,181,28,16524
9/7/2018,11,10381,1530,4249,360,213,28,16761
9/7/2018,12,10388,1716,4261,395,206,30,16996
9/7/2018,13,10278,1519,4363,442,205,35,16842
9/7/2018,14,10334,1564,4269,594,198,31,16990
9/7/2018,15,10396,1587,4296,782,172,28,17261
9/7/2018,16,10393,1601,4427,881,132,28,17462
9/7/2018,17,10394,1600,4158,1028,76,28,17284
9/7/2018,18,10403,1598,4317,1024,28,28,17398
9/7/2018,19,10423,1280,4025,1131,3,28,16890
9/7/2018,20,10438,1003,3960,1364,0,27,16792
9/7/2018,21,10446,708,3588,1349,0,27,16118
9/7/2018,22,10453,276,3350,1365,0,27,15471
9/7/2018,23,10454,179,3014,1138,0,20,14805
9/7/2018,24,10458,173,2916,1043,0,10,14600
9/8/2018,1,10506,171,2901,1106,0,1,14685
9/8/2018,2,10513,167,2981,1179,0,1,14841
9/8/2018,3,10511,166,2962,947,0,1,14587
9/8/2018,4,10519,166,2981,891,0,1,14558
9/8/2018,5,10518,165,2904,517,0,1,14105
9/8/2018,6,10523,169,2940,1067,1,1,14701
9/8/2018,7,10521,169,2896,1442,17,1,15046
9/8/2018,8,10518,168,2872,1730,65,1,15354
9/8/2018,9,10471,166,2966,1932,131,1,15667
9/8/2018,10,10451,165,2981,1830,158,1,15586
9/8/2018,11,10449,164,3024,1938,201,1,15777
9/8/2018,12,10442,164,3337,1595,202,1,15741
9/8/2018,13,10446,165,3346,1374,247,1,15579
9/8/2018,14,10408,166,3423,1184,222,1,15404
9/8/2018,15,10451,166,3585,1199,192,1,15594
9/8/2018,16,10453,165,3606,1152,137,1,15514
9/8/2018,17,10480,165,4047,1170,87,1,15950
9/8/2018,18,10493,165,3967,1249,36,1,15911
9/8/2018,19,10494,166,3946,1313,4,1,15924
9/8/2018,20,10491,166,4179,1548,0,1,16385
9/8/2018,21,10498,166,3757,1772,0,1,16194
9/8/2018,22,10500,167,3251,1818,0,1,15737
9/8/2018,23,10498,168,2819,1448,0,1,14934
9/8/2018,24,10504,169,2768,879,0,1,14321
9/9/2018,1,10435,168,2697,477,0,1,13778
9/9/2018,2,10211,169,2696,363,0,1,13440
9/9/2018,3,9938,168,2690,552,0,1,13349
9/9/2018,4,9907,168,2730,710,0,1,13516
9/9/2018,5,9891,168,2921,446,0,1,13427
9/9/2018,6,9888,167,2949,697,0,1,13702
9/9/2018,7,9865,168,2979,840,11,1,13864
9/9/2018,8,9874,166,2902,1429,48,1,14420
9/9/2018,9,10130,167,2950,1639,99,1,14986
9/9/2018,10,10281,165,2797,2014,124,1,15382
9/9/2018,11,10283,165,2888,2036,145,1,15518
9/9/2018,12,10402,164,3234,1537,145,1,15483
9/9/2018,13,10430,134,3289,1498,143,1,15495
9/9/2018,14,10367,77,3329,1554,141,1,15469
9/9/2018,15,10235,72,3382,1859,130,1,15679
9/9/2018,16,10175,75,3330,2590,110,1,16281
9/9/2018,17,10150,77,3391,2972,69,1,16660
9/9/2018,18,10149,77,3578,2518,29,1,16352
9/9/2018,19,10149,78,3517,2471,2,1,16218
9/9/2018,20,10140,79,3348,2608,0,1,16176
9/9/2018,21,10118,79,3467,2511,0,1,16176
9/9/2018,22,10115,79,2966,2823,0,1,15984
9/9/2018,23,10122,157,2989,2062,0,1,15331
9/9/2018,24,10122,121,2946,1400,0,1,14590
9/10/2018,1,10122,105,3035,1167,0,1,14430
9/10/2018,2,10130,102,2976,1144,0,4,14356
9/10/2018,3,10127,138,3016,1129,0,13,14423
9/10/2018,4,10124,111,2937,1468,0,13,14653
9/10/2018,5,10118,92,2967,1862,0,13,15052
9/10/2018,6,10113,163,3211,2581,0,19,16087
9/10/2018,7,10111,227,3643,2784,2,26,16793
9/10/2018,8,10104,394,3461,2664,23,26,16672
9/10/2018,9,10102,697,3303,2393,66,26,16587
9/10/2018,10,10106,962,3723,2131,88,26,17036
9/10/2018,11,10107,1081,3754,1690,95,26,16753
9/10/2018,12,10093,1125,4240,1301,93,26,16878
9/10/2018,13,10093,956,3949,1077,95,26,16196
9/10/2018,14,10080,1183,3518,854,110,26,15771
9/10/2018,15,10080,1203,3644,1027,97,27,16078
9/10/2018,16,10082,1215,3803,924,83,27,16134
9/10/2018,17,10085,1258,3929,804,50,27,16153
9/10/2018,18,10091,1293,4129,710,18,27,16268
9/10/2018,19,10094,1406,4311,667,2,26,16506
9/10/2018,20,10095,1366,4286,609,0,27,16383
9/10/2018,21,10108,1349,3897,533,0,27,15914
9/10/2018,22,10115,886,3868,495,0,26,15390
9/10/2018,23,10130,543,3815,420,0,17,14925
9/10/2018,24,10156,495,3611,373,0,12,14647
9/11/2018,1,10157,259,3223,393,0,11,14043
9/11/2018,2,10154,215,2935,391,0,11,13706
9/11/2018,3,10173,227,2917,333,0,12,13662
9/11/2018,4,10188,312,2870,264,0,11,13645
9/11/2018,5,10191,628,3009,275,0,12,14115
9/11/2018,6,10203,1059,3303,219,0,19,14803
9/11/2018,7,10205,1285,3504,329,3,27,15353
9/11/2018,8,10201,1262,3597,354,33,27,15474
9/11/2018,9,10197,1352,3765,349,60,27,15750
9/11/2018,10,10197,1613,3683,263,120,27,15903
9/11/2018,11,10190,1630,3584,184,157,27,15772
9/11/2018,12,10192,1645,3723,158,178,43,15939
9/11/2018,13,10061,1491,3901,136,191,70,15850
9/11/2018,14,10035,1485,4083,153,171,74,16001
9/11/2018,15,10129,1631,3946,161,161,74,16102
9/11/2018,16,10195,1507,4088,146,129,74,16139
9/11/2018,17,10196,1730,4045,148,88,74,16281
9/11/2018,18,10196,1793,4155,145,34,74,16397
9/11/2018,19,10193,1827,4309,135,2,77,16543
9/11/2018,20,10192,1892,4298,205,0,80,16667
9/11/2018,21,10191,1652,3868,296,0,82,16089
9/11/2018,22,10191,450,3766,313,0,82,14802
9/11/2018,23,10204,215,3526,295,0,32,14272
9/11/2018,24,10212,215,3161,356,0,13,13957
9/12/2018,1,10236,216,3147,415,0,13,14027
9/12/2018,2,10250,223,3455,363,0,12,14303
9/12/2018,3,10274,332,3185,382,0,11,14184
9/12/2018,4,10301,511,3171,284,0,11,14278
9/12/2018,5,10322,885,2981,190,0,12,14390
9/12/2018,6,10361,1394,3431,149,0,19,15354
9/12/2018,7,10363,1648,3593,266,5,28,15903
9/12/2018,8,10361,1750,3472,289,46,28,15946
9/12/2018,9,10358,1732,3579,219,99,28,16015
9/12/2018,10,10323,1795,3364,112,151,30,15775
9/12/2018,11,10345,1872,3481,135,235,57,16125
9/12/2018,12,10368,1796,3495,131,258,76,16124
9/12/2018,13,10220,1858,3613,158,294,88,16231
9/12/2018,14,10294,1887,3621,170,251,85,16308
9/12/2018,15,10355,2026,3670,165,220,78,16514
9/12/2018,16,10349,2059,4076,178,201,79,16942
9/12/2018,17,10343,2063,4327,178,119,85,17115
9/12/2018,18,10347,2112,4398,150,35,104,17146
9/12/2018,19,10345,2073,4385,200,2,134,17139
9/12/2018,20,10348,2090,4344,263,0,151,17196
9/12/2018,21,10352,1854,4034,266,0,176,16682
9/12/2018,22,10355,996,3665,274,0,209,15499
9/12/2018,23,10361,441,3256,349,0,151,14558
9/12/2018,24,10358,205,3095,402,0,69,14129
9/13/2018,1,10344,199,3171,375,0,21,14110
9/13/2018,2,10324,199,3373,531,0,11,14438
9/13/2018,3,10333,202,3307,626,0,10,14478
9/13/2018,4,10356,211,3336,549,0,10,14462
9/13/2018,5,10368,333,3137,480,0,16,14334
9/13/2018,6,10391,686,3348,418,1,21,14865
9/13/2018,7,10398,942,3380,681,10,27,15438
9/13/2018,8,10398,1043,3503,576,73,27,15620
9/13/2018,9,10396,1169,3872,524,145,29,16135
9/13/2018,10,10406,1533,3498,491,224,46,16198
9/13/2018,11,10413,2023,3497,344,247,77,16601
9/13/2018,12,10382,2171,3492,355,239,82,16721
9/13/2018,13,10364,2204,3773,499,254,90,17184
9/13/2018,14,10345,2286,3832,466,229,88,17246
9/13/2018,15,10308,2298,4112,344,207,94,17363
9/13/2018,16,10329,2259,3462,354,187,92,16683
9/13/2018,17,10351,2362,4347,428,118,122,17728
9/13/2018,18,10328,2793,4638,392,40,208,18399
9/13/2018,19,10325,2502,4408,377,2,226,17840
9/13/2018,20,10332,2805,4277,536,0,227,18177
9/13/2018,21,10309,2415,4137,804,0,177,17842
9/13/2018,22,10318,1648,3805,808,0,124,16703
9/13/2018,23,10328,592,3964,672,0,45,15601
9/13/2018,24,10347,400,3808,531,0,15,15101
9/14/2018,1,10358,414,3833,503,0,12,15120
9/14/2018,2,10362,405,3767,513,0,12,15059
9/14/2018,3,10365,404,3863,407,0,12,15051
9/14/2018,4,10393,524,3829,385,0,12,15143
9/14/2018,5,10431,856,3443,258,0,16,15004
9/14/2018,6,10429,1502,3530,252,0,22,15735
9/14/2018,7,10423,1917,3716,227,8,27,16318
9/14/2018,8,10419,2019,3767,182,76,26,16489
9/14/2018,9,10410,2416,4088,94,150,27,17185
9/14/2018,10,10382,2924,4199,57,192,27,17781
9/14/2018,11,10369,3393,4101,77,249,27,18216
9/14/2018,12,10365,3572,4098,80,266,27,18408
9/14/2018,13,10364,3948,4176,40,288,42,18858
9/14/2018,14,10376,4010,4235,28,293,89,19031
9/14/2018,15,10378,3928,4153,29,269,179,18936
9/14/2018,16,10381,4088,4426,25,208,220,19348
9/14/2018,17,10379,4006,4708,18,111,224,19446
9/14/2018,18,10378,3862,4767,10,32,225,19274
9/14/2018,19,10373,3849,4535,20,2,222,19001
9/14/2018,20,10377,3644,4426,73,0,139,18659
9/14/2018,21,10383,3590,4297,91,0,74,18435
9/14/2018,22,10384,2524,4197,69,0,73,17247
9/14/2018,23,10369,1665,3835,54,0,63,15986
9/14/2018,24,10363,720,3941,49,0,54,15127
9/15/2018,1,10364,491,3793,70,0,46,14764
9/15/2018,2,10368,435,3556,102,0,46,14507
9/15/2018,3,10370,393,3571,142,0,47,14523
9/15/2018,4,10376,448,3586,141,0,46,14597
9/15/2018,5,10373,719,3687,130,0,46,14955
9/15/2018,6,10379,1138,3715,101,0,24,15357
9/15/2018,7,10375,1274,3591,76,8,1,15325
9/15/2018,8,10371,1391,3695,84,50,1,15592
9/15/2018,9,10359,1931,4061,45,97,1,16494
9/15/2018,10,10360,2723,4117,37,152,1,17390
9/15/2018,11,10351,3195,4132,24,213,1,17916
9/15/2018,12,10339,3643,4267,39,242,1,18531
9/15/2018,13,10334,3887,4366,91,275,1,18954
9/15/2018,14,10344,3678,4268,161,281,2,18734
9/15/2018,15,10349,4094,4370,188,241,2,19244
9/15/2018,16,10342,4463,4635,148,169,1,19758
9/15/2018,17,10346,4483,4686,84,117,1,19717
9/15/2018,18,10353,4198,4598,73,28,1,19251
9/15/2018,19,10362,4393,4633,78,1,1,19468
9/15/2018,20,10366,4222,4357,147,0,1,19093
9/15/2018,21,10362,3518,4072,168,0,1,18121
9/15/2018,22,10365,2462,3840,141,0,1,16809
9/15/2018,23,10359,1933,3691,112,0,1,16096
9/15/2018,24,10356,811,3572,96,0,1,14836
9/16/2018,1,10356,313,3613,150,0,1,14433
9/16/2018,2,10352,181,3723,166,0,3,14425
9/16/2018,3,10345,171,3338,173,0,3,14030
9/16/2018,4,10332,263,3450,130,0,1,14176
9/16/2018,5,10347,534,3489,95,0,1,14466
9/16/2018,6,10348,769,3367,157,0,1,14642
9/16/2018,7,10350,909,2955,178,7,1,14400
9/16/2018,8,10342,1243,3178,242,65,1,15071
9/16/2018,9,10344,2136,3159,85,111,2,15837
9/16/2018,10,10348,2566,3771,117,230,1,17033
9/16/2018,11,10355,3139,4187,223,266,1,18171
9/16/2018,12,10363,3858,4223,281,290,1,19016
9/16/2018,13,10350,4114,4246,300,294,1,19305
9/16/2018,14,10363,4127,4269,327,301,1,19388
9/16/2018,15,10359,4441,4372,357,264,1,19794
9/16/2018,16,10359,4584,4591,336,204,1,20075
9/16/2018,17,10370,4714,4671,299,119,1,20174
9/16/2018,18,10395,4627,4583,292,39,1,19937
9/16/2018,19,10398,4464,4468,377,1,1,19709
9/16/2018,20,10390,4318,4301,612,0,1,19622
9/16/2018,21,10386,3994,3979,881,0,1,19241
9/16/2018,22,10389,2486,3672,1123,0,1,17671
9/16/2018,23,10387,2041,3423,934,0,1,16786
9/16/2018,24,10380,738,3505,657,0,1,15281
9/17/2018,1,10374,245,3403,1183,0,1,15206
9/17/2018,2,10372,257,3467,1219,0,9,15324
9/17/2018,3,10366,271,3528,1154,0,14,15333
9/17/2018,4,10378,365,3391,1013,0,13,15160
9/17/2018,5,10375,967,3010,590,0,13,14955
9/17/2018,6,10381,1512,3378,690,0,23,15984
9/17/2018,7,10374,2088,3363,825,9,27,16686
9/17/2018,8,10368,2564,3563,607,79,28,17209
9/17/2018,9,10376,3141,3537,391,163,28,17636
9/17/2018,10,10376,4056,3569,273,216,28,18518
9/17/2018,11,10365,4451,3612,252,224,29,18933
9/17/2018,12,10359,5055,3546,291,264,30,19545
9/17/2018,13,10355,4916,3512,315,244,28,19370
9/17/2018,14,10350,4820,3733,373,249,29,19554
9/17/2018,15,10335,4739,4077,292,202,30,19675
9/17/2018,16,10330,4651,4307,259,124,42,19713
9/17/2018,17,10332,4499,4129,316,84,44,19404
9/17/2018,18,10341,4851,4070,287,28,47,19624
9/17/2018,19,10346,4856,3987,297,1,44,19531
9/17/2018,20,10339,5007,3753,375,0,37,19511
9/17/2018,21,10333,4835,3553,456,0,28,19205
9/17/2018,22,10326,3385,3421,524,0,28,17684
9/17/2018,23,10329,1995,3183,444,0,17,15968
9/17/2018,24,10324,1238,3120,530,0,12,15224
9/18/2018,1,10326,928,3146,499,0,11,14910
9/18/2018,2,10339,896,3306,419,0,11,14971
9/18/2018,3,10337,912,3331,357,0,11,14948
9/18/2018,4,10339,1081,3204,379,0,11,15014
9/18/2018,5,10335,1489,3160,266,0,13,15263
9/18/2018,6,10334,1992,3233,608,0,22,16189
9/18/2018,7,10337,2874,3449,413,5,28,17106
9/18/2018,8,10343,3470,3398,246,50,28,17535
9/18/2018,9,10339,3616,3468,109,140,28,17700
9/18/2018,10,10341,3402,3460,118,224,28,17573
9/18/2018,11,10346,3416,3473,170,287,28,17720
9/18/2018,12,10351,3667,3562,177,257,28,18042
9/18/2018,13,10359,4019,3671,240,296,30,18615
9/18/2018,14,10361,4220,3690,326,281,42,18920
9/18/2018,15,10362,4309,3842,406,246,76,19241
9/18/2018,16,10361,4478,4033,438,162,85,19557
9/18/2018,17,10368,5043,3979,382,95,104,19971
9/18/2018,18,10372,4748,4034,393,29,101,19677
9/18/2018,19,10363,4022,4027,432,0,79,18923
9/18/2018,20,10368,4109,3830,670,0,38,19015
9/18/2018,21,10378,2937,3420,778,0,28,17541
9/18/2018,22,10397,2068,3533,415,0,28,16441
9/18/2018,23,10406,1037,3582,274,0,19,15318
9/18/2018,24,10405,584,3393,334,0,11,14727
9/19/2018,1,10412,343,3403,325,0,11,14494
9/19/2018,2,10412,325,3510,254,0,11,14512
9/19/2018,3,10405,342,3207,308,0,11,14273
9/19/2018,4,10400,484,3212,545,0,11,14652
9/19/2018,5,10399,817,2965,307,0,14,14502
9/19/2018,6,10404,1247,3178,451,0,23,15303
9/19/2018,7,10408,1432,3477,520,7,28,15872
9/19/2018,8,10403,1694,3537,362,67,28,16091
9/19/2018,9,10335,1945,3527,226,164,28,16225
9/19/2018,10,10321,2116,3685,176,220,28,16546
9/19/2018,11,10322,2458,3549,118,261,28,16736
9/19/2018,12,10347,2475,3545,117,246,112,16842
9/19/2018,13,10405,2474,3476,152,257,179,16943
9/19/2018,14,10396,2448,3520,177,250,78,16869
9/19/2018,15,10395,2562,3661,206,229,79,17132
9/19/2018,16,10393,2466,4002,191,175,84,17311
9/19/2018,17,10383,2804,4300,217,102,108,17914
9/19/2018,18,10380,2992,4128,191,41,109,17841
9/19/2018,19,10376,2961,4040,180,1,108,17666
9/19/2018,20,10381,2622,3944,200,0,109,17256
9/19/2018,21,10377,2467,3634,267,0,107,16852
9/19/2018,22,10380,1391,3267,243,0,59,15340
9/19/2018,23,10376,425,3221,302,0,20,14344
9/19/2018,24,10372,255,3099,272,0,12,14010
9/20/2018,1,10388,252,3096,295,0,11,14042
9/20/2018,2,10402,258,3107,534,0,11,14312
9/20/2018,3,10397,385,3110,276,0,10,14178
9/20/2018,4,10399,697,3054,390,0,10,14550
9/20/2018,5,10403,1121,3117,414,0,14,15069
9/20/2018,6,10409,1555,3023,284,0,22,15293
9/20/2018,7,10405,1638,3131,624,10,28,15836
9/20/2018,8,10403,1664,3274,510,44,28,15923
9/20/2018,9,10395,1669,3207,588,51,28,15938
9/20/2018,10,10395,1830,3653,629,114,28,16649
9/20/2018,11,10392,1947,3689,523,164,33,16748
9/20/2018,12,10384,2020,3287,541,138,36,16406
9/20/2018,13,10260,1869,3440,348,124,60,16101
9/20/2018,14,10225,1839,3351,543,125,79,16162
9/20/2018,15,10251,1842,3312,462,113,78,16058
9/20/2018,16,10373,1688,3441,327,59,77,15965
9/20/2018,17,10374,1657,3562,668,44,77,16382
9/20/2018,18,10369,1551,3662,1044,11,77,16714
9/20/2018,19,10350,1311,3931,1353,0,79,17024
9/20/2018,20,10343,1088,3697,1677,0,44,16849
9/20/2018,21,10339,717,3321,1650,0,27,16054
9/20/2018,22,10319,305,3042,2006,0,33,15705
9/20/2018,23,10312,256,2926,1705,0,22,15221
9/20/2018,24,10291,254,2874,1226,0,11,14656
9/21/2018,1,10273,254,2922,1162,0,10,14621
9/21/2018,2,10273,259,2869,1207,0,10,14618
9/21/2018,3,10276,264,2824,1258,0,10,14632
9/21/2018,4,10283,262,2982,1057,0,12,14596
9/21/2018,5,10291,262,3003,1515,0,17,15088
9/21/2018,6,10248,274,3084,2897,0,20,16523
9/21/2018,7,10215,365,3335,3458,1,27,17401
9/21/2018,8,10148,769,3220,3909,34,28,18108
9/21/2018,9,10137,1212,3275,3602,112,28,18366
9/21/2018,10,10129,1627,3283,3644,210,28,18921
9/21/2018,11,10091,1979,3361,3949,191,28,19599
9/21/2018,12,10138,2346,3562,3857,226,28,20157
9/21/2018,13,10151,2393,3635,4028,231,28,20466
9/21/2018,14,10151,2395,3682,3794,227,28,20277
9/21/2018,15,10149,2386,3910,3956,151,28,20580
9/21/2018,16,10111,2392,3971,3545,144,28,20191
9/21/2018,17,10104,2386,3793,3385,78,28,19774
9/21/2018,18,10084,2536,3956,2369,22,29,18996
9/21/2018,19,10108,1897,3811,2750,1,28,18595
9/21/2018,20,10110,1341,3384,3631,0,28,18494
9/21/2018,21,10085,749,3371,3357,0,28,17590
9/21/2018,22,10105,232,3509,2801,0,28,16675
9/21/2018,23,10113,126,3537,1690,0,22,15488
9/21/2018,24,10130,118,3118,925,0,11,14302
9/22/2018,1,10186,119,2830,552,0,1,13688
9/22/2018,2,9927,119,2812,505,0,1,13364
9/22/2018,3,9628,119,2815,590,0,1,13153
9/22/2018,4,9668,118,2875,421,0,1,13083
9/22/2018,5,9713,119,2956,383,0,1,13172
9/22/2018,6,10067,137,3320,667,0,1,14192
9/22/2018,7,10390,135,3250,659,14,1,14449
9/22/2018,8,10392,203,3211,529,84,1,14420
9/22/2018,9,10384,276,3363,553,165,1,14742
9/22/2018,10,10363,483,3473,385,243,1,14948
9/22/2018,11,10356,693,3436,295,250,1,15031
9/22/2018,12,10348,867,3381,156,231,1,14984
9/22/2018,13,10344,955,3465,76,130,1,14971
9/22/2018,14,10198,1207,3458,96,11,1,14971
9/22/2018,15,10042,1312,3473,104,28,1,14960
9/22/2018,16,10039,1397,3655,155,118,1,15365
9/22/2018,17,10190,1341,4002,140,75,1,15749
9/22/2018,18,10365,1282,4134,96,22,1,15900
9/22/2018,19,10363,1177,3938,74,0,1,15553
9/22/2018,20,10360,552,3950,93,0,1,14956
9/22/2018,21,10354,350,4105,103,0,1,14913
9/22/2018,22,10380,365,3908,123,0,1,14777
9/22/2018,23,10439,166,3417,94,0,1,14117
9/22/2018,24,10159,124,3086,93,0,1,13463
9/23/2018,1,9866,124,3427,119,0,1,13537
9/23/2018,2,9838,124,3176,107,0,1,13246
9/23/2018,3,9734,124,3082,82,0,1,13023
9/23/2018,4,9496,123,3307,125,0,1,13052
9/23/2018,5,9489,123,3360,183,0,1,13156
9/23/2018,6,9492,124,3574,289,1,1,13481
9/23/2018,7,9782,124,3512,318,15,1,13752
9/23/2018,8,10144,124,3344,326,95,1,14034
9/23/2018,9,10384,124,3419,149,155,1,14232
9/23/2018,10,10387,128,3409,187,284,1,14396
9/23/2018,11,10406,178,3478,194,313,1,14570
9/23/2018,12,10406,174,3552,217,324,1,14674
9/23/2018,13,10408,122,3726,253,329,1,14839
9/23/2018,14,10385,124,3567,341,329,1,14747
9/23/2018,15,10440,174,3890,366,296,1,15167
9/23/2018,16,10477,254,4042,385,222,1,15381
9/23/2018,17,10513,362,4435,535,120,1,15966
9/23/2018,18,10521,332,4348,651,35,1,15888
9/23/2018,19,10499,315,4017,912,0,1,15744
9/23/2018,20,10472,312,3684,1257,0,1,15726
9/23/2018,21,10469,316,3419,1357,0,1,15562
9/23/2018,22,10481,316,3270,1413,0,1,15481
9/23/2018,23,10486,152,2921,1663,0,1,15223
9/23/2018,24,10481,109,2875,1313,0,2,14780
9/24/2018,1,10483,109,2789,836,0,11,14228
9/24/2018,2,10476,108,2841,516,0,11,13952
9/24/2018,3,10467,109,2821,400,0,12,13809
9/24/2018,4,10462,109,2754,709,0,12,14046
9/24/2018,5,10473,112,2804,1086,0,16,14491
9/24/2018,6,10473,132,3122,1556,1,24,15308
9/24/2018,7,10481,289,3183,2344,10,28,16335
9/24/2018,8,10487,362,3308,2126,66,30,16379
9/24/2018,9,10472,438,3285,1888,106,29,16218
9/24/2018,10,10465,632,3247,1947,147,28,16466
9/24/2018,11,10460,842,3297,1834,158,28,16619
9/24/2018,12,10451,871,3175,2270,193,28,16988
9/24/2018,13,10441,869,3197,2041,214,28,16790
9/24/2018,14,10427,868,3431,2025,224,28,17003
9/24/2018,15,10422,865,3573,1955,163,28,17006
9/24/2018,16,10400,868,3469,2829,99,28,17693
9/24/2018,17,10385,874,3617,2838,54,28,17796
9/24/2018,18,10380,873,3711,2924,11,28,17927
9/24/2018,19,10376,544,3730,3136,0,28,17814
9/24/2018,20,10374,278,3661,3234,0,28,17575
9/24/2018,21,10382,249,3598,3160,0,28,17417
9/24/2018,22,10383,248,3318,2876,0,28,16853
9/24/2018,23,10390,248,3127,2098,0,18,15881
9/24/2018,24,10406,247,3050,1143,0,12,14858
9/25/2018,1,10408,247,2872,1049,0,8,14584
9/25/2018,2,10402,248,2844,711,0,9,14214
9/25/2018,3,10388,248,2842,706,0,10,14194
9/25/2018,4,10386,249,2857,708,0,11,14211
9/25/2018,5,10374,248,3049,1051,0,12,14734
9/25/2018,6,10373,247,2987,1994,0,23,15624
9/25/2018,7,10368,244,3578,2660,0,28,16878
9/25/2018,8,10374,274,4278,2245,2,28,17201
9/25/2018,9,10369,426,4169,2173,15,28,17180
9/25/2018,10,10379,416,3437,2313,38,32,16615
9/25/2018,11,10386,504,3401,2137,45,49,16522
9/25/2018,12,10385,579,3576,2214,40,105,16899
9/25/2018,13,10389,778,3451,2094,43,119,16874
9/25/2018,14,10386,890,3651,1939,52,85,17003
9/25/2018,15,10381,988,3680,2271,62,124,17506
9/25/2018,16,10390,986,3929,2032,36,101,17474
9/25/2018,17,10403,992,3933,1967,26,146,17467
9/25/2018,18,10422,990,3987,1984,7,199,17589
9/25/2018,19,10424,991,3900,2200,0,186,17701
9/25/2018,20,10420,988,3721,2484,0,180,17793
9/25/2018,21,10417,797,3740,2279,0,109,17342
9/25/2018,22,10443,649,3431,2351,0,80,16954
9/25/2018,23,10443,647,3258,1759,0,30,16137
9/25/2018,24,10446,645,3213,865,0,11,15180
9/26/2018,1,10438,315,2999,739,0,10,14501
9/26/2018,2,10428,245,2968,750,0,10,14401
9/26/2018,3,10433,245,2990,935,0,10,14613
9/26/2018,4,10460,246,3103,1045,0,11,14865
9/26/2018,5,10477,267,3037,1597,0,15,15393
9/26/2018,6,10482,350,3298,1780,0,25,15935
9/26/2018,7,10489,520,4035,2063,1,28,17136
9/26/2018,8,10488,603,3648,2398,5,28,17170
9/26/2018,9,10494,675,3300,2447,23,29,16968
9/26/2018,10,10483,661,3494,2622,86,32,17378
9/26/2018,11,10479,652,3623,2558,114,55,17481
9/26/2018,12,10484,655,3362,2407,122,83,17113
9/26/2018,13,10336,715,3743,2245,172,164,17375
9/26/2018,14,10374,793,3343,2263,217,209,17199
9/26/2018,15,10510,794,3402,1599,211,147,16663
9/26/2018,16,10474,700,3515,2259,191,93,17232
9/26/2018,17,10452,526,4096,1947,106,155,17282
9/26/2018,18,10561,597,4508,1194,30,209,17099
9/26/2018,19,10559,637,4441,931,0,210,16778
9/26/2018,20,10566,504,4324,906,0,210,16510
9/26/2018,21,10566,348,3909,1209,0,210,16242
9/26/2018,22,10559,257,3525,948,0,169,15458
9/26/2018,23,10559,202,3435,767,0,58,15021
9/26/2018,24,10560,199,3639,502,0,14,14914
9/27/2018,1,10563,199,3319,322,0,13,14416
9/27/2018,2,10568,202,3236,212,0,13,14231
9/27/2018,3,10569,203,3136,195,0,13,14116
9/27/2018,4,10573,281,3082,229,0,13,14178
9/27/2018,5,10572,299,3216,225,0,15,14327
9/27/2018,6,10573,409,3692,326,0,23,15023
9/27/2018,7,10572,736,3763,353,9,28,15461
9/27/2018,8,10507,851,3530,384,51,28,15351
9/27/2018,9,10486,821,3540,322,90,32,15291
9/27/2018,10,10500,816,3792,263,156,49,15576
9/27/2018,11,10497,813,3883,336,193,92,15814
9/27/2018,12,10545,718,4100,352,155,150,16020
9/27/2018,13,10577,624,4379,435,148,157,16320
9/27/2018,14,10580,605,4005,545,158,162,16055
9/27/2018,15,10576,607,3771,651,105,135,15845
9/27/2018,16,10582,644,4211,517,52,149,16155
9/27/2018,17,10583,760,4636,281,24,159,16443
9/27/2018,18,10591,697,4359,241,4,158,16050
9/27/2018,19,10585,657,4346,335,0,158,16081
9/27/2018,20,10575,654,4137,591,0,193,16150
9/27/2018,21,10563,326,4085,751,0,204,15929
9/27/2018,22,10543,252,3841,666,0,168,15470
9/27/2018,23,10544,201,3449,636,0,128,14958
9/27/2018,24,10555,196,3283,730,0,74,14838
9/28/2018,1,10558,196,3158,750,0,31,14693
9/28/2018,2,10564,194,3007,870,0,15,14650
9/28/2018,3,10563,194,2823,666,0,14,14260
9/28/2018,4,10558,196,2826,848,0,14,14442
9/28/2018,5,10582,195,3203,866,0,15,14861
9/28/2018,6,10591,207,3463,1036,0,23,15320
9/28/2018,7,10592,248,3419,1758,8,28,16053
9/28/2018,8,10595,248,3549,1627,41,28,16088
9/28/2018,9,10585,247,3710,1684,85,28,16339
9/28/2018,10,10582,247,3735,1945,106,28,16643
9/28/2018,11,10571,249,3652,1682,110,28,16292
9/28/2018,12,10551,246,3732,2042,154,28,16753
9/28/2018,13,10568,247,3613,2137,173,28,16766
9/28/2018,14,10572,248,3805,1825,153,28,16631
9/28/2018,15,10562,248,4317,1571,179,28,16905
9/28/2018,16,10552,247,4541,1291,110,28,16769
9/28/2018,17,10555,248,4670,1218,56,32,16779
9/28/2018,18,10557,225,4215,1445,10,32,16484
9/28/2018,19,10558,197,3989,1659,0,31,16434
9/28/2018,20,10556,196,3908,1853,0,30,16543
9/28/2018,21,10565,199,3959,1732,0,28,16483
9/28/2018,22,10569,200,3848,1449,0,28,16094
9/28/2018,23,10573,122,3764,1073,0,20,15552
9/28/2018,24,10569,115,2900,992,0,11,14587
9/29/2018,1,10561,114,2928,432,0,1,14036
9/29/2018,2,10155,114,2924,405,0,1,13599
9/29/2018,3,9832,114,2975,305,0,1,13227
9/29/2018,4,9676,114,2966,421,0,1,13178
9/29/2018,5,9679,114,2982,561,0,1,13337
9/29/2018,6,9938,114,3065,1272,0,1,14390
9/29/2018,7,10336,112,3306,1094,11,1,14860
9/29/2018,8,10597,112,3500,921,91,1,15222
9/29/2018,9,10594,113,3503,600,187,1,14998
9/29/2018,10,10584,114,3538,422,212,1,14871
9/29/2018,11,10587,114,3540,465,211,2,14919
9/29/2018,12,10584,112,3576,450,217,2,14941
9/29/2018,13,10601,113,3588,334,167,1,14804
9/29/2018,14,10612,114,3635,289,139,1,14790
9/29/2018,15,10577,113,3691,305,86,1,14773
9/29/2018,16,10623,115,3623,511,148,1,15021
9/29/2018,17,10628,115,4021,686,89,1,15540
9/29/2018,18,10641,119,4262,537,18,1,15578
9/29/2018,19,10656,114,4124,315,0,1,15210
9/29/2018,20,10656,114,3908,195,0,1,14874
9/29/2018,21,10666,114,4019,118,0,1,14918
9/29/2018,22,10677,113,4047,89,0,1,14927
9/29/2018,23,10679,114,3691,72,0,1,14557
9/29/2018,24,10390,117,3522,112,0,1,14142
9/30/2018,1,10076,123,3654,162,0,1,14016
9/30/2018,2,10074,123,3271,215,0,1,13684
9/30/2018,3,10069,119,2958,305,0,1,13452
9/30/2018,4,10069,119,2985,203,0,1,13377
9/30/2018,5,10065,113,3082,291,0,1,13552
9/30/2018,6,10064,111,3714,271,0,1,14161
9/30/2018,7,10057,112,3907,306,1,1,14384
9/30/2018,8,10117,130,4426,322,16,1,15012
9/30/2018,9,10506,210,4512,288,42,1,15559
9/30/2018,10,10663,275,4630,241,63,1,15873
9/30/2018,11,10661,210,4467,298,78,1,15715
9/30/2018,12,10661,229,4391,284,74,1,15640
9/30/2018,13,10657,162,4346,225,70,1,15461
9/30/2018,14,10654,127,4121,222,50,1,15175
9/30/2018,15,10659,126,4322,139,34,1,15281
9/30/2018,16,10659,171,4728,119,19,1,15697
9/30/2018,17,10658,139,4481,133,15,1,15427
9/30/2018,18,10651,117,4397,99,2,1,15267
9/30/2018,19,10668,117,4482,111,0,1,15379
9/30/2018,20,10686,116,4157,198,0,1,15158
9/30/2018,21,10689,115,4068,317,0,1,15190
9/30/2018,22,10695,117,3885,351,0,1,15049
9/30/2018,23,10677,116,3554,475,0,1,14823
9/30/2018,24,10449,116,3599,604,0,1,14769
10/1/2018,1,10372,232,3285,650,0,1,14540
10/1/2018,2,10373,277,3124,623,0,3,14400
10/1/2018,3,10349,278,2990,754,0,9,14380
10/1/2018,4,10359,277,3062,749,0,9,14456
10/1/2018,5,10454,278,3364,376,0,10,14482
10/1/2018,6,10685,354,3766,661,0,18,15484
10/1/2018,7,10687,741,4582,861,0,27,16898
10/1/2018,8,10687,1041,4368,1026,7,27,17156
10/1/2018,9,10691,666,4144,1219,19,28,16767
10/1/2018,10,10692,643,4008,1229,36,27,16635
10/1/2018,11,10684,669,4072,1203,65,28,16721
10/1/2018,12,10693,737,4262,1120,71,28,16911
10/1/2018,13,10686,921,4245,1279,78,28,17237
10/1/2018,14,10682,803,4261,1332,69,28,17175
10/1/2018,15,10689,1113,4208,1270,49,28,17357
10/1/2018,16,10686,1191,4239,1272,31,28,17447
10/1/2018,17,10685,1183,4210,1539,18,28,17663
10/1/2018,18,10690,1182,3790,1352,4,28,17046
10/1/2018,19,10689,1185,3910,1436,0,28,17248
10/1/2018,20,10684,1176,3930,1447,0,28,17265
10/1/2018,21,10679,1178,3839,1410,0,28,17134
10/1/2018,22,10683,969,3642,1233,0,28,16555
10/1/2018,23,10682,408,3458,1153,0,22,15723
10/1/2018,24,10673,267,3064,820,0,13,14837
10/2/2018,1,10658,262,2980,846,0,12,14758
10/2/2018,2,10399,267,2877,728,0,12,14283
10/2/2018,3,10368,266,2873,576,0,13,14096
10/2/2018,4,10354,266,2992,679,0,13,14304
10/2/2018,5,10500,354,3165,667,0,18,14704
10/2/2018,6,10660,494,3934,749,0,22,15859
10/2/2018,7,10666,1119,4495,818,0,28,17126
10/2/2018,8,10665,1244,4229,860,3,29,17030
10/2/2018,9,10672,1188,4299,783,30,29,17001
10/2/2018,10,10673,1301,4208,835,46,28,17091
10/2/2018,11,10666,1302,3860,1172,51,28,17079
10/2/2018,12,10663,1258,3887,1014,58,28,16908
10/2/2018,13,10648,1303,3893,1019,79,28,16970
10/2/2018,14,10643,1255,3823,1275,79,28,17103
10/2/2018,15,10638,1018,3904,1261,74,28,16923
10/2/2018,16,10638,1100,3981,1379,74,28,17200
10/2/2018,17,10639,1104,4410,1408,31,28,17620
10/2/2018,18,10639,832,4337,1378,3,28,17217
10/2/2018,19,10646,955,4556,932,0,28,17117
10/2/2018,20,10646,1223,4487,727,0,28,17111
10/2/2018,21,10644,1293,4406,606,0,28,16977
10/2/2018,22,10655,1051,3964,406,0,28,16104
10/2/2018,23,10678,720,3534,303,0,23,15258
10/2/2018,24,10457,488,3373,224,0,15,14557
10/3/2018,1,10166,317,3405,211,0,13,14112
10/3/2018,2,9870,340,3419,243,0,13,13885
10/3/2018,3,9798,395,3538,190,0,13,13934
10/3/2018,4,9796,493,3346,221,0,13,13869
10/3/2018,5,10067,692,3346,226,0,15,14346
10/3/2018,6,10553,918,3684,196,0,21,15372
10/3/2018,7,10697,1400,4252,297,0,27,16673
10/3/2018,8,10690,1428,4210,359,13,28,16728
10/3/2018,9,10692,1095,4235,376,34,29,16461
10/3/2018,10,10684,1099,4239,524,51,27,16624
10/3/2018,11,10683,1077,4122,855,63,31,16831
10/3/2018,12,10680,752,3988,920,78,28,16446
10/3/2018,13,10537,813,4174,1211,75,27,16837
10/3/2018,14,10588,818,4088,1546,105,27,17172
10/3/2018,15,10669,820,3710,1772,121,27,17119
10/3/2018,16,10676,818,3845,1668,99,27,17133
10/3/2018,17,10669,822,4117,1847,38,26,17519
10/3/2018,18,10668,820,4020,1953,9,27,17497
10/3/2018,19,10667,819,4087,2598,0,28,18199
10/3/2018,20,10659,817,4036,2661,0,28,18201
10/3/2018,21,10651,501,3635,2687,0,28,17502
10/3/2018,22,10617,258,3424,2165,0,28,16492
10/3/2018,23,10624,257,3123,1478,0,19,15501
10/3/2018,24,10622,257,3044,775,0,12,14710
10/4/2018,1,10620,257,3014,644,0,11,14546
10/4/2018,2,10369,255,3093,288,0,11,14016
10/4/2018,3,10059,251,2969,216,0,11,13506
10/4/2018,4,9773,250,2983,495,0,11,13512
10/4/2018,5,10057,247,3067,829,0,14,14214
10/4/2018,6,10521,253,3173,1859,0,19,15825
10/4/2018,7,10591,257,3479,3065,0,27,17419
10/4/2018,8,10591,262,3912,3112,2,29,17908
10/4/2018,9,10585,175,3711,2988,17,27,17503
10/4/2018,10,10588,217,3428,2850,50,29,17162
10/4/2018,11,10595,247,3411,2257,100,29,16639
10/4/2018,12,10595,362,3363,1826,144,28,16318
10/4/2018,13,10588,437,3523,1353,226,28,16155
10/4/2018,14,10582,682,3473,974,289,27,16027
10/4/2018,15,10575,796,3509,873,291,27,16071
10/4/2018,16,10582,844,3800,1012,195,28,16461
10/4/2018,17,10584,859,3960,1319,109,28,16859
10/4/2018,18,10587,1002,4044,1474,19,28,17154
10/4/2018,19,10586,984,4235,2095,0,28,17928
10/4/2018,20,10583,838,4265,2083,0,28,17797
10/4/2018,21,10586,536,4339,1721,0,28,17210
10/4/2018,22,10594,307,4418,1433,0,28,16780
10/4/2018,23,10592,219,3530,1104,0,19,15464
10/4/2018,24,10595,247,3346,255,0,12,14455
10/5/2018,1,10203,223,3110,501,0,11,14048
10/5/2018,2,9929,223,3043,771,0,11,13977
10/5/2018,3,9778,223,3083,1229,0,11,14324
10/5/2018,4,9783,232,3159,1154,0,11,14339
10/5/2018,5,9951,235,3251,1309,0,13,14759
10/5/2018,6,10460,266,3543,1071,0,23,15363
10/5/2018,7,10615,418,3749,1249,8,28,16067
10/5/2018,8,10612,439,3959,1287,73,28,16398
10/5/2018,9,10619,552,4298,1217,145,28,16859
10/5/2018,10,10621,563,4486,1162,141,28,17001
10/5/2018,11,10626,703,4738,961,156,28,17212
10/5/2018,12,10625,773,4670,931,154,28,17181
10/5/2018,13,10616,589,3941,1160,116,28,16450
10/5/2018,14,10617,646,4272,1454,112,28,17129
10/5/2018,15,10619,656,4273,1487,104,28,17167
10/5/2018,16,10615,665,4374,1141,60,28,16883
10/5/2018,17,10615,779,4867,977,23,28,17289
10/5/2018,18,10620,726,4606,1009,4,27,16992
10/5/2018,19,10618,716,4347,987,0,27,16695
10/5/2018,20,10626,777,4110,1062,0,29,16604
10/5/2018,21,10632,627,4345,1080,0,29,16713
10/5/2018,22,10639,356,4345,1147,0,28,16515
10/5/2018,23,10619,276,3621,1000,0,18,15534
10/5/2018,24,10596,271,3348,697,0,7,14919
10/6/2018,1,10593,272,2959,648,0,8,14480
10/6/2018,2,10585,271,2927,428,0,17,14228
10/6/2018,3,10324,271,2926,481,0,20,14022
10/6/2018,4,10309,270,2989,510,0,14,14092
10/6/2018,5,10310,269,3059,637,0,15,14290
10/6/2018,6,10347,269,3115,922,0,14,14667
10/6/2018,7,10612,270,3636,855,0,9,15382
10/6/2018,8,10631,321,4420,648,4,4,16028
10/6/2018,9,10631,309,4300,576,10,2,15828
10/6/2018,10,10635,268,4498,600,25,3,16029
10/6/2018,11,10627,268,4434,879,35,2,16245
10/6/2018,12,10620,268,4471,944,31,4,16338
10/6/2018,13,10617,268,4583,1006,73,6,16553
10/6/2018,14,10574,268,3837,1180,80,5,15944
10/6/2018,15,10617,267,3836,1465,67,3,16255
10/6/2018,16,10627,269,4238,1047,35,2,16218
10/6/2018,17,10624,326,4824,707,12,2,16495
10/6/2018,18,10620,326,4439,541,0,1,15927
10/6/2018,19,10627,279,4668,617,0,1,16192
10/6/2018,20,10621,281,4587,616,0,1,16106
10/6/2018,21,10621,280,4834,548,0,1,16284
10/6/2018,22,10622,280,4595,739,0,1,16237
10/6/2018,23,10633,280,4263,630,0,1,15807
10/6/2018,24,10653,266,3504,722,0,1,15146
10/7/2018,1,10660,265,2917,806,0,1,14649
10/7/2018,2,10679,265,3022,757,0,1,14724
10/7/2018,3,10683,265,2936,669,0,1,14554
10/7/2018,4,10677,266,2902,670,0,1,14516
10/7/2018,5,10677,266,2887,681,0,1,14512
10/7/2018,6,10680,266,2983,594,0,1,14524
10/7/2018,7,10686,265,3228,461,0,1,14641
10/7/2018,8,10685,188,3484,313,12,1,14683
10/7/2018,9,10679,182,3984,559,39,1,15444
10/7/2018,10,10686,189,4400,499,47,1,15822
10/7/2018,11,10694,193,4276,487,62,1,15713
10/7/2018,12,10695,186,4301,472,90,1,15745
10/7/2018,13,10696,184,4393,321,83,1,15678
10/7/2018,14,10695,184,4603,298,56,2,15838
10/7/2018,15,10695,184,4620,341,39,1,15880
10/7/2018,16,10694,185,4525,368,32,1,15805
10/7/2018,17,10692,186,4126,462,16,1,15483
10/7/2018,18,10689,186,4108,472,2,1,15458
10/7/2018,19,10694,186,4308,544,0,1,15733
10/7/2018,20,10691,184,4183,559,0,1,15618
10/7/2018,21,10684,184,4237,551,0,1,15657
10/7/2018,22,10687,185,4028,634,0,1,15535
10/7/2018,23,10694,185,3490,595,0,1,14965
10/7/2018,24,10688,185,3159,456,0,1,14489
10/8/2018,1,10451,186,3050,277,0,1,13965
10/8/2018,2,10145,185,2985,287,0,1,13603
10/8/2018,3,9917,184,3004,282,0,1,13388
10/8/2018,4,9841,184,2981,378,0,1,13385
10/8/2018,5,9843,184,2987,514,0,1,13529
10/8/2018,6,9866,184,3147,658,1,1,13857
10/8/2018,7,10278,183,3305,408,1,1,14176
10/8/2018,8,10676,183,3255,590,9,1,14714
10/8/2018,9,10688,184,3331,1129,27,1,15360
10/8/2018,10,10690,182,3445,1456,43,1,15817
10/8/2018,11,10682,183,3930,1176,66,1,16038
10/8/2018,12,10684,183,3778,876,86,1,15608
10/8/2018,13,10689,182,3983,845,97,1,15797
10/8/2018,14,10687,182,4259,648,79,1,15856
10/8/2018,15,10691,184,4372,525,74,1,15847
10/8/2018,16,10689,183,4495,509,67,1,15944
10/8/2018,17,10690,183,4724,564,36,1,16198
10/8/2018,18,10696,184,4690,691,5,1,16267
10/8/2018,19,10701,183,4719,929,0,1,16533
10/8/2018,20,10700,194,4189,1312,0,1,16396
10/8/2018,21,10697,199,3658,1423,0,1,15978
10/8/2018,22,10693,181,3400,1344,0,1,15619
10/8/2018,23,10697,183,3174,408,0,1,14463
10/8/2018,24,10697,182,3068,351,0,1,14299
10/9/2018,1,10414,183,3120,208,0,1,13926
10/9/2018,2,10080,184,3233,213,0,3,13713
10/9/2018,3,9834,182,3211,284,0,10,13521
10/9/2018,4,9840,182,3253,345,0,10,13630
10/9/2018,5,9865,183,3333,664,0,13,14058
10/9/2018,6,10269,184,3569,1254,0,21,15297
10/9/2018,7,10676,299,3774,1351,4,30,16134
10/9/2018,8,10685,336,3872,1259,46,45,16243
10/9/2018,9,10685,355,3896,1548,80,72,16636
10/9/2018,10,10682,375,3733,1730,165,93,16778
10/9/2018,11,10684,433,3965,1567,193,135,16977
10/9/2018,12,10688,591,3882,1370,208,183,16922
10/9/2018,13,10684,824,3944,1386,220,203,17261
10/9/2018,14,10675,1101,4007,1078,216,160,17237
10/9/2018,15,10673,1392,4150,1141,156,172,17684
10/9/2018,16,10674,1580,4370,954,103,207,17888
10/9/2018,17,10673,1868,4672,901,44,207,18365
10/9/2018,18,10664,1950,4431,969,5,191,18210
10/9/2018,19,10661,1857,4493,1373,0,194,18578
10/9/2018,20,10662,1543,4151,1777,0,176,18309
10/9/2018,21,10685,1157,3894,2077,0,98,17911
10/9/2018,22,10658,693,3582,2297,0,50,17280
10/9/2018,23,10671,270,3266,2033,0,43,16283
10/9/2018,24,10667,181,3106,1728,0,45,15727
10/10/2018,1,10669,181,3127,897,0,41,14915
10/10/2018,2,10676,180,3222,907,0,39,15024
10/10/2018,3,10670,179,3167,773,0,40,14829
10/10/2018,4,10674,177,3086,842,0,39,14818
10/10/2018,5,10669,179,3189,783,0,42,14862
10/10/2018,6,10663,180,3328,1253,0,49,15473
10/10/2018,7,10663,188,3727,1892,11,60,16541
10/10/2018,8,10660,190,4169,1794,36,68,16917
10/10/2018,9,10655,225,4192,1778,93,66,17009
10/10/2018,10,10610,526,4157,1789,161,64,17307
10/10/2018,11,10649,785,4398,1570,192,90,17684
10/10/2018,12,10656,1015,4785,1443,207,419,18525
10/10/2018,13,10650,1187,4803,1421,195,479,18735
10/10/2018,14,10646,1129,4936,1377,202,209,18499
10/10/2018,15,10653,1045,4921,1463,162,197,18441
10/10/2018,16,10661,1176,4831,1587,92,179,18526
10/10/2018,17,10661,1059,4490,1763,26,141,18140
10/10/2018,18,10655,936,4134,2199,2,161,18087
10/10/2018,19,10646,946,4186,2270,0,103,18151
10/10/2018,20,10642,841,3953,2845,0,60,18341
10/10/2018,21,10643,672,3978,2788,0,61,18142
10/10/2018,22,10648,337,3609,2980,0,62,17636
10/10/2018,23,10651,168,3163,2706,0,50,16738
10/10/2018,24,10649,164,3058,1916,0,44,15831
10/11/2018,1,10643,163,2937,1820,0,40,15603
10/11/2018,2,10645,166,2908,1628,0,36,15383
10/11/2018,3,10646,165,2871,1363,0,34,15079
10/11/2018,4,10648,164,2875,1306,0,33,15026
10/11/2018,5,10645,163,2942,1884,0,33,15667
10/11/2018,6,10636,165,3015,2816,0,36,16668
10/11/2018,7,10634,159,3601,3176,0,48,17618
10/11/2018,8,10636,156,4039,3054,11,44,17940
10/11/2018,9,10647,154,4258,3144,49,45,18297
10/11/2018,10,10625,155,4155,3101,80,45,18161
10/11/2018,11,10577,155,3878,3053,145,47,17855
10/11/2018,12,10575,155,3569,3005,168,46,17518
10/11/2018,13,10559,155,3581,2870,168,46,17379
10/11/2018,14,10573,155,3539,2824,151,43,17285
10/11/2018,15,10629,169,3633,2830,108,29,17398
10/11/2018,16,10631,180,4116,2598,57,28,17610
10/11/2018,17,10629,157,4473,2500,25,28,17812
10/11/2018,18,10631,159,4543,2644,3,28,18008
10/11/2018,19,10638,161,4465,3173,0,28,18465
10/11/2018,20,10639,161,4109,3198,0,28,18135
10/11/2018,21,10644,162,3886,2809,0,28,17529
10/11/2018,22,10633,162,3654,1884,0,28,16361
10/11/2018,23,10635,159,3564,1178,0,19,15555
10/11/2018,24,10651,161,3351,706,0,13,14882
10/12/2018,1,10654,159,3210,639,0,10,14672
10/12/2018,2,10580,160,3190,301,0,11,14242
10/12/2018,3,10356,160,3152,334,0,11,14013
10/12/2018,4,10347,159,3220,437,0,12,14175
10/12/2018,5,10571,159,3279,768,0,16,14793
10/12/2018,6,10673,161,3308,1597,0,21,15760
10/12/2018,7,10680,162,3807,2221,3,27,16900
10/12/2018,8,10683,163,3947,2150,43,27,17013
10/12/2018,9,10683,162,3898,2016,100,28,16887
10/12/2018,10,10689,162,3950,1754,134,27,16716
10/12/2018,11,10688,162,3960,1761,145,27,16743
10/12/2018,12,10684,162,3946,1563,123,27,16505
10/12/2018,13,10530,161,3964,1671,157,44,16527
10/12/2018,14,10528,160,4009,1645,136,89,16567
10/12/2018,15,10537,162,3986,1521,108,165,16479
10/12/2018,16,10549,162,4321,1266,61,180,16539
10/12/2018,17,10561,163,4543,1371,20,180,16838
10/12/2018,18,10640,164,4477,1530,0,180,16991
10/12/2018,19,10654,164,4109,1510,0,180,16617
10/12/2018,20,10654,164,4605,1351,0,180,16954
10/12/2018,21,10659,164,4754,1098,0,148,16823
10/12/2018,22,10662,164,4412,970,0,46,16254
10/12/2018,23,10662,163,3763,998,0,19,15605
10/12/2018,24,10680,163,3301,768,0,11,14923
10/13/2018,1,10682,164,3069,377,0,3,14295
10/13/2018,2,10558,163,3085,192,0,1,13999
10/13/2018,3,10264,164,3116,300,0,1,13845
10/13/2018,4,10157,164,3178,379,0,1,13879
10/13/2018,5,10162,153,3154,512,0,1,13982
10/13/2018,6,10385,106,3245,739,0,1,14476
10/13/2018,7,10405,107,3328,817,2,1,14660
10/13/2018,8,10624,107,3529,857,30,1,15148
10/13/2018,9,10699,106,3723,782,86,1,15397
10/13/2018,10,10700,107,3687,761,159,1,15415
10/13/2018,11,10705,105,3708,735,178,1,15432
10/13/2018,12,10696,108,3735,806,202,1,15548
10/13/2018,13,10699,108,3466,1050,183,1,15507
10/13/2018,14,10702,107,3510,681,202,1,15203
10/13/2018,15,10700,105,3861,488,153,1,15308
10/13/2018,16,10706,106,3886,731,110,1,15540
10/13/2018,17,10730,108,4119,914,52,1,15924
10/13/2018,18,10736,108,4429,832,5,1,16111
10/13/2018,19,10739,109,4738,773,0,1,16360
10/13/2018,20,10739,109,4538,700,0,1,16087
10/13/2018,21,10734,110,4159,763,0,4,15770
10/13/2018,22,10725,110,3838,805,0,3,15481
10/13/2018,23,10726,109,3148,776,0,1,14760
10/13/2018,24,10730,109,3081,350,0,1,14271
10/14/2018,1,10618,109,2904,248,0,1,13880
10/14/2018,2,10265,108,2953,185,0,1,13512
10/14/2018,3,9849,110,2978,245,0,1,13183
10/14/2018,4,9585,109,3069,361,0,1,13125
10/14/2018,5,9603,110,3152,454,0,1,13320
10/14/2018,6,9971,110,3097,743,0,1,13922
10/14/2018,7,10297,111,3269,845,2,1,14525
10/14/2018,8,10702,110,3300,749,37,1,14899
10/14/2018,9,10728,109,3273,668,91,1,14870
10/14/2018,10,10725,110,3249,782,139,1,15006
10/14/2018,11,10725,110,3147,656,162,1,14801
10/14/2018,12,10721,111,3188,809,209,1,15039
10/14/2018,13,10724,110,3414,394,238,1,14881
10/14/2018,14,10715,107,3560,368,216,1,14967
10/14/2018,15,10708,106,3650,515,204,1,15184
10/14/2018,16,10700,106,3957,495,143,1,15402
10/14/2018,17,10702,152,4748,528,66,2,16198
10/14/2018,18,10702,185,5053,410,6,2,16358
10/14/2018,19,10708,244,4685,304,0,2,15943
10/14/2018,20,10718,165,4523,473,0,1,15880
10/14/2018,21,10719,165,4213,741,0,1,15839
10/14/2018,22,10711,166,3946,646,0,1,15470
10/14/2018,23,10714,164,3660,253,0,1,14792
10/14/2018,24,10218,164,3521,206,0,1,14110
10/15/2018,1,9844,164,3096,641,0,1,13746
10/15/2018,2,9839,163,3193,275,0,7,13477
10/15/2018,3,9812,164,3188,356,0,12,13532
10/15/2018,4,9840,165,3205,446,0,11,13667
10/15/2018,5,9919,166,3519,530,0,14,14148
10/15/2018,6,10433,167,3705,652,0,23,14980
10/15/2018,7,10744,168,4506,1067,0,28,16513
10/15/2018,8,10741,167,4671,1361,0,28,16968
10/15/2018,9,10736,164,4828,1595,4,29,17356
10/15/2018,10,10729,163,4484,2166,9,29,17580
10/15/2018,11,10731,163,4165,2798,17,28,17902
10/15/2018,12,10732,163,3993,2709,49,28,17674
10/15/2018,13,10733,163,3798,3098,52,29,17873
10/15/2018,14,10731,164,3888,2771,51,28,17633
10/15/2018,15,10727,164,3843,2694,61,29,17518
10/15/2018,16,10719,165,3567,3315,31,28,17825
10/15/2018,17,10716,169,3728,3456,24,28,18121
10/15/2018,18,10713,171,4120,3344,5,27,18380
10/15/2018,19,10714,170,4333,3524,0,28,18769
10/15/2018,20,10711,168,4084,3539,0,28,18530
10/15/2018,21,10705,168,4004,2857,0,28,17762
10/15/2018,22,10705,170,3561,2381,0,28,16845
10/15/2018,23,10704,170,3433,1534,0,18,15859
10/15/2018,24,10691,168,3205,888,0,15,14967
10/16/2018,1,10686,170,3004,415,0,16,14291
10/16/2018,2,10318,169,2994,438,0,13,13932
10/16/2018,3,10139,169,2989,525,0,14,13836
10/16/2018,4,10141,168,3035,575,0,13,13932
10/16/2018,5,10154,173,3188,1069,0,16,14600
10/16/2018,6,10531,176,3677,1754,0,23,16161
10/16/2018,7,10620,170,4318,2151,3,28,17290
10/16/2018,8,10622,168,4383,2360,63,28,17624
10/16/2018,9,10623,171,4313,2233,127,29,17496
10/16/2018,10,10624,172,3938,2306,162,32,17234
10/16/2018,11,10619,172,3753,1953,251,52,16800
10/16/2018,12,10613,173,3656,1858,222,119,16641
10/16/2018,13,10672,188,3637,1769,213,129,16608
10/16/2018,14,10692,199,3587,1293,222,127,16120
10/16/2018,15,10695,200,3612,1529,168,128,16332
10/16/2018,16,10706,201,3435,2692,106,126,17266
10/16/2018,17,10702,201,3693,3056,53,128,17833
10/16/2018,18,10702,201,4132,3174,5,127,18341
10/16/2018,19,10705,203,4143,3319,0,127,18497
10/16/2018,20,10720,202,3919,3401,0,127,18369
10/16/2018,21,10761,201,3715,2856,0,181,17714
10/16/2018,22,10761,200,3445,2137,0,175,16718
10/16/2018,23,10762,201,3236,1307,0,82,15588
10/16/2018,24,10763,199,3148,676,0,22,14808
10/17/2018,1,10553,199,3083,316,0,16,14167
10/17/2018,2,10415,200,3000,458,0,15,14088
10/17/2018,3,10270,199,2988,538,0,15,14010
10/17/2018,4,10273,200,3069,589,0,16,14147
10/17/2018,5,10290,201,3148,1084,0,16,14739
10/17/2018,6,10674,201,3395,1909,0,24,16203
10/17/2018,7,10762,202,4249,2327,0,35,17575
10/17/2018,8,10766,200,4383,2464,25,60,17898
10/17/2018,9,10760,276,4172,2368,62,113,17751
10/17/2018,10,10755,305,3736,2578,94,133,17601
10/17/2018,11,10758,305,3710,2273,121,130,17297
10/17/2018,12,10750,305,3630,2137,116,130,17068
10/17/2018,13,10613,306,3489,2264,158,130,16960
10/17/2018,14,10598,346,3526,2176,173,130,16949
10/17/2018,15,10750,418,3579,1939,142,130,16958
10/17/2018,16,10763,418,3916,2193,111,129,17530
10/17/2018,17,10777,420,3915,2810,44,129,18095
10/17/2018,18,10785,424,4032,3109,2,129,18481
10/17/2018,19,10776,423,4521,3062,0,124,18906
10/17/2018,20,10775,420,4464,2903,0,70,18632
10/17/2018,21,10777,293,4120,3043,0,28,18261
10/17/2018,22,10782,204,3663,2566,0,28,17243
10/17/2018,23,10788,203,3323,1754,0,22,16090
10/17/2018,24,10784,203,3259,1085,0,15,15346
10/18/2018,1,10786,204,3089,973,0,11,15063
10/18/2018,2,10785,204,3049,846,0,11,14895
10/18/2018,3,10790,204,3002,807,0,11,14814
10/18/2018,4,10790,204,3029,855,0,12,14890
10/18/2018,5,10790,203,3353,980,0,18,15344
10/18/2018,6,10790,203,3956,1215,0,23,16187
10/18/2018,7,10791,204,4849,1137,3,37,17021
10/18/2018,8,10788,271,4815,847,63,66,16850
10/18/2018,9,10784,351,4852,648,127,125,16887
10/18/2018,10,10788,429,4880,665,173,207,17142
10/18/2018,11,10785,427,4554,833,199,198,16996
10/18/2018,12,10787,450,4123,903,213,164,16640
10/18/2018,13,10782,450,4049,1047,224,113,16665
10/18/2018,14,10779,454,4121,519,216,47,16136
10/18/2018,15,10781,454,4080,1192,214,29,16750
10/18/2018,16,10777,449,4226,1393,176,28,17049
10/18/2018,17,10771,449,4440,1698,74,28,17460
10/18/2018,18,10773,446,4510,2174,5,28,17936
10/18/2018,19,10778,446,4441,2705,0,28,18398
10/18/2018,20,10777,445,4442,2741,0,28,18433
10/18/2018,21,10771,312,3856,3109,0,28,18076
10/18/2018,22,10773,223,3349,2692,0,28,17065
10/18/2018,23,10778,226,3207,1764,0,22,15997
10/18/2018,24,10778,242,3220,870,0,14,15124
10/19/2018,1,10784,245,2981,613,0,13,14636
10/19/2018,2,10574,246,3024,511,0,12,14367
10/19/2018,3,10498,245,3011,594,0,11,14359
10/19/2018,4,10499,245,2997,636,0,12,14389
10/19/2018,5,10564,244,3109,1018,0,16,14951
10/19/2018,6,10797,245,3221,2069,0,20,16352
10/19/2018,7,10798,244,3568,3006,2,28,17646
10/19/2018,8,10794,243,3575,3023,58,28,17721
10/19/2018,9,10796,243,3464,2644,134,28,17309
10/19/2018,10,10791,242,3405,2381,213,28,17060
10/19/2018,11,10780,241,3450,2000,218,27,16716
10/19/2018,12,10795,241,3429,1687,218,27,16397
10/19/2018,13,10790,239,3322,2044,182,12,16589
10/19/2018,14,10793,235,3304,2363,124,4,16823
10/19/2018,15,10798,161,3410,2562,69,23,17023
10/19/2018,16,10791,178,3430,3027,30,27,17483
10/19/2018,17,10788,186,3474,3257,8,28,17741
10/19/2018,18,10790,186,3647,3297,0,28,17948
10/19/2018,19,10799,184,3618,3361,0,27,17989
10/19/2018,20,10781,182,3523,3234,0,28,17748
10/19/2018,21,10796,182,3310,2914,0,28,17230
10/19/2018,22,10800,181,3359,1814,0,29,16183
10/19/2018,23,10795,129,3264,876,0,20,15084
10/19/2018,24,10738,126,3093,654,0,8,14619
10/20/2018,1,10244,125,2963,345,0,1,13678
10/20/2018,2,9727,125,3049,453,0,1,13355
10/20/2018,3,9549,127,3086,493,0,1,13256
10/20/2018,4,9550,126,3096,508,0,1,13281
10/20/2018,5,9570,127,3102,963,0,1,13763
10/20/2018,6,9999,127,3130,1210,0,1,14467
10/20/2018,7,10579,127,3210,1300,1,1,15218
10/20/2018,8,10750,127,3656,1247,46,1,15827
10/20/2018,9,10752,127,3762,1299,132,1,16073
10/20/2018,10,10752,126,3789,1283,172,1,16123
10/20/2018,11,10751,127,3789,1319,215,1,16202
10/20/2018,12,10750,126,3659,1397,178,1,16111
10/20/2018,13,10746,127,3468,920,189,1,15451
10/20/2018,14,10746,127,3313,990,142,1,15319
10/20/2018,15,10748,129,3401,1012,72,1,15363
10/20/2018,16,10750,128,3519,1488,43,1,15929
10/20/2018,17,10756,128,3960,1809,16,1,16670
10/20/2018,18,10757,127,4132,2325,0,1,17342
10/20/2018,19,10750,126,3967,2558,0,1,17402
10/20/2018,20,10744,128,3532,2543,0,1,16948
10/20/2018,21,10740,126,3400,1946,0,1,16213
10/20/2018,22,10744,126,3294,1306,0,1,15471
10/20/2018,23,10741,124,3060,916,0,1,14842
10/20/2018,24,10455,127,3022,776,0,1,14381
10/21/2018,1,9995,127,3047,768,0,1,13938
10/21/2018,2,9844,127,3036,709,0,1,13717
10/21/2018,3,9841,127,3044,586,0,1,13599
10/21/2018,4,9848,127,3087,611,0,1,13674
10/21/2018,5,9853,127,2989,891,0,1,13861
10/21/2018,6,9868,127,3052,1237,0,1,14285
10/21/2018,7,10296,130,3201,857,1,1,14486
10/21/2018,8,10721,134,3084,1160,36,1,15136
10/21/2018,9,10747,131,3114,1574,93,1,15660
10/21/2018,10,10743,125,3333,1469,139,1,15810
10/21/2018,11,10739,144,3528,1390,150,1,15952
10/21/2018,12,10742,147,3560,1362,186,2,15999
10/21/2018,13,10746,159,3484,1435,177,2,16003
10/21/2018,14,10709,177,3597,1295,115,1,15894
10/21/2018,15,10744,202,3782,1199,105,1,16033
10/21/2018,16,10745,326,4364,1033,75,1,16544
10/21/2018,17,10750,335,4982,952,24,1,17044
10/21/2018,18,10750,352,5325,712,1,1,17141
10/21/2018,19,10747,352,5010,742,0,1,16852
10/21/2018,20,10753,323,5085,860,0,1,17022
10/21/2018,21,10760,165,4827,1052,0,1,16805
10/21/2018,22,10760,132,3994,1049,0,1,15936
10/21/2018,23,10757,130,3330,819,0,1,15037
10/21/2018,24,10759,129,3024,1038,0,1,14951
10/22/2018,1,10758,128,2923,452,0,1,14262
10/22/2018,2,10756,128,2870,285,0,1,14040
10/22/2018,3,10792,126,2887,228,0,8,14041
10/22/2018,4,10799,130,2906,355,0,13,14203
10/22/2018,5,10802,131,2947,841,0,14,14735
10/22/2018,6,10805,131,3434,1308,0,21,15699
10/22/2018,7,10803,132,4289,1369,0,28,16621
10/22/2018,8,10806,134,4816,1271,19,28,17074
10/22/2018,9,10807,158,4924,1019,68,28,17004
10/22/2018,10,10809,174,4938,828,134,28,16911
10/22/2018,11,10803,181,4606,627,156,28,16401
10/22/2018,12,10802,218,4631,644,168,28,16491
10/22/2018,13,10800,293,4831,762,163,28,16877
10/22/2018,14,10803,474,4776,848,155,28,17084
10/22/2018,15,10751,745,4590,905,125,28,17144
10/22/2018,16,10748,778,4422,918,89,29,16984
10/22/2018,17,10738,936,4267,699,37,29,16706
10/22/2018,18,10737,1072,4689,620,3,28,17149
10/22/2018,19,10734,1010,5124,627,0,28,17523
10/22/2018,20,10734,922,4804,729,0,28,17217
10/22/2018,21,10728,440,4425,905,0,28,16526
10/22/2018,22,10733,311,3934,1117,0,28,16123
10/22/2018,23,10728,313,3333,1127,0,19,15520
10/22/2018,24,10731,296,3047,710,0,11,14795
10/23/2018,1,10733,116,3024,548,0,11,14432
10/23/2018,2,10736,107,2893,443,0,11,14190
10/23/2018,3,10736,110,2848,503,0,11,14208
10/23/2018,4,10737,110,2902,614,0,11,14374
10/23/2018,5,10740,107,2929,998,0,12,14786
10/23/2018,6,10746,108,3524,1387,0,23,15788
10/23/2018,7,10750,108,4144,2003,0,28,17033
10/23/2018,8,10746,108,4043,2404,22,28,17351
10/23/2018,9,10751,107,4093,2600,81,28,17660
10/23/2018,10,10693,107,3673,2852,134,28,17487
10/23/2018,11,10685,106,3620,2683,121,27,17242
10/23/2018,12,10720,125,3613,2604,146,28,17236
10/23/2018,13,10749,140,3563,2620,90,34,17196
10/23/2018,14,10746,158,3640,2465,125,35,17169
10/23/2018,15,10741,149,3680,2516,105,36,17227
10/23/2018,16,10725,162,3908,2845,58,36,17734
10/23/2018,17,10726,281,4492,2427,33,36,17995
10/23/2018,18,10731,302,4960,2214,1,36,18244
10/23/2018,19,10727,301,4819,2231,0,36,18114
10/23/2018,20,10722,302,4596,2179,0,36,17835
10/23/2018,21,10727,204,4365,2354,0,37,17687
10/23/2018,22,10730,111,3621,2380,0,40,16882
10/23/2018,23,10726,137,2980,2100,0,25,15968
10/23/2018,24,10727,148,2971,1640,0,18,15504
10/24/2018,1,10728,147,3004,1400,0,15,15294
10/24/2018,2,10732,177,2976,1126,0,16,15027
10/24/2018,3,10733,183,2962,1135,0,16,15029
10/24/2018,4,10736,183,2974,1190,0,16,15099
10/24/2018,5,10750,189,3045,1397,0,20,15401
10/24/2018,6,10749,205,3753,1107,0,29,15843
10/24/2018,7,10750,315,4722,1111,0,39,16937
10/24/2018,8,10749,362,4756,991,33,37,16928
10/24/2018,9,10749,342,4636,829,90,32,16678
10/24/2018,10,10749,312,4411,839,128,28,16467
10/24/2018,11,10746,369,4425,901,133,28,16602
10/24/2018,12,10745,414,4516,877,128,28,16708
10/24/2018,13,10742,509,4619,914,123,28,16935
10/24/2018,14,10740,611,4680,940,104,28,17103
10/24/2018,15,10738,881,4630,943,73,28,17293
10/24/2018,16,10735,1235,4871,909,45,28,17823
10/24/2018,17,10736,1401,5049,734,22,29,17971
10/24/2018,18,10737,1750,5150,520,1,29,18187
10/24/2018,19,10738,1861,5155,386,0,28,18168
10/24/2018,20,10736,1554,5242,369,0,28,17929
10/24/2018,21,10731,1204,4886,347,0,28,17196
10/24/2018,22,10731,733,4589,313,0,28,16394
10/24/2018,23,10740,561,4324,253,0,20,15898
10/24/2018,24,10750,230,4521,211,0,13,15725
10/25/2018,1,10758,147,4359,207,0,10,15481
10/25/2018,2,10759,155,4246,206,0,10,15376
10/25/2018,3,10753,177,4069,230,0,10,15239
10/25/2018,4,10756,346,4046,251,0,10,15409
10/25/2018,5,10756,693,3894,264,0,14,15621
10/25/2018,6,10758,1009,4244,232,0,22,16265
10/25/2018,7,10756,1315,4970,211,0,28,17280
10/25/2018,8,10753,1551,4974,144,13,28,17463
10/25/2018,9,10757,1630,4724,115,45,28,17299
10/25/2018,10,10750,1340,4677,84,79,28,16958
10/25/2018,11,10746,1209,4437,88,133,28,16641
10/25/2018,12,10749,1182,4206,117,198,28,16480
10/25/2018,13,10591,1186,4213,134,170,28,16322
10/25/2018,14,10604,1208,4311,120,166,28,16437
10/25/2018,15,10746,1256,4088,111,127,28,16356
10/25/2018,16,10748,1421,4306,154,96,29,16754
10/25/2018,17,10243,1764,5041,108,22,28,17206
10/25/2018,18,10009,1915,5424,92,0,28,17468
10/25/2018,19,10010,1699,5249,98,0,28,17084
10/25/2018,20,10010,1693,5305,87,0,28,17123
10/25/2018,21,10003,1386,5255,53,0,28,16725
10/25/2018,22,9982,813,4921,46,0,28,15790
10/25/2018,23,9989,277,4830,50,0,18,15164
10/25/2018,24,9997,180,4759,70,0,11,15017
10/26/2018,1,9997,181,4843,75,0,10,15106
10/26/2018,2,9998,186,4585,110,0,10,14889
10/26/2018,3,9997,189,4433,205,0,10,14834
10/26/2018,4,9997,297,4554,269,0,9,15126
10/26/2018,5,10004,522,4349,338,0,15,15228
10/26/2018,6,10001,906,4452,345,0,23,15727
10/26/2018,7,10001,1197,5058,605,0,28,16889
10/26/2018,8,9994,1299,4836,912,7,28,17076
10/26/2018,9,9992,1242,4956,1097,30,28,17345
10/26/2018,10,9993,1447,5115,1085,64,28,17732
10/26/2018,11,9991,1293,4907,1223,99,28,17541
10/26/2018,12,9988,930,4485,1307,109,28,16847
10/26/2018,13,9982,866,4724,1191,98,28,16889
10/26/2018,14,9970,1034,4704,1215,105,28,17056
10/26/2018,15,9973,1085,4591,1423,95,28,17195
10/26/2018,16,9986,1273,4386,1661,56,28,17390
10/26/2018,17,9984,1036,4611,1717,18,28,17394
10/26/2018,18,9989,861,5058,1854,0,29,17791
10/26/2018,19,9986,800,4936,1932,0,28,17682
10/26/2018,20,9987,778,4556,2158,0,28,17507
10/26/2018,21,9986,650,4441,2312,0,29,17418
10/26/2018,22,9984,535,4085,2305,0,28,16937
10/26/2018,23,9987,384,3638,2163,0,21,16193
10/26/2018,24,9986,215,3285,1756,0,12,15254
10/27/2018,1,9982,170,2789,1786,0,1,14728
10/27/2018,2,9982,179,2724,1637,0,1,14523
10/27/2018,3,9974,177,2687,1672,0,1,14511
10/27/2018,4,9953,177,2747,1745,0,1,14623
10/27/2018,5,9969,174,2725,2052,0,1,14921
10/27/2018,6,9978,172,2801,2332,0,1,15284
10/27/2018,7,9980,190,3374,2601,1,1,16147
10/27/2018,8,9983,236,3960,2771,7,1,16958
10/27/2018,9,9984,314,4357,2755,22,1,17433
10/27/2018,10,9983,327,4561,2590,36,1,17498
10/27/2018,11,9980,473,4902,2297,44,1,17697
10/27/2018,12,9979,608,4788,2085,67,1,17528
10/27/2018,13,9982,689,4638,2000,69,1,17379
10/27/2018,14,9982,702,4659,1930,65,1,17339
10/27/2018,15,9942,816,4876,1703,55,1,17393
10/27/2018,16,9967,1033,5172,1555,26,1,17754
10/27/2018,17,9960,916,5133,1505,8,1,17523
10/27/2018,18,9962,849,4947,1379,0,1,17138
10/27/2018,19,9962,783,4717,1344,0,1,16807
10/27/2018,20,9960,774,4411,1284,0,1,16430
10/27/2018,21,9956,419,4591,1200,0,1,16167
10/27/2018,22,9960,169,4537,971,0,1,15638
10/27/2018,23,9960,169,4615,748,0,1,15493
10/27/2018,24,9959,173,4794,595,0,1,15522
10/28/2018,1,9972,175,4557,447,0,1,15152
10/28/2018,2,9966,174,4499,298,0,1,14938
10/28/2018,3,9957,173,4523,210,0,1,14864
10/28/2018,4,9952,168,4585,162,0,1,14868
10/28/2018,5,9934,167,4395,128,0,1,14625
10/28/2018,6,9893,173,4517,177,0,1,14761
10/28/2018,7,9884,265,4541,233,0,1,14924
10/28/2018,8,9887,298,4564,195,4,1,14949
10/28/2018,9,9884,510,5091,198,23,1,15707
10/28/2018,10,9882,824,5059,280,47,1,16093
10/28/2018,11,9881,839,4942,240,65,1,15968
10/28/2018,12,9876,874,4941,317,62,1,16071
10/28/2018,13,9875,944,4936,419,52,1,16227
10/28/2018,14,9912,983,4604,582,49,1,16131
10/28/2018,15,9926,1029,4635,763,48,1,16402
10/28/2018,16,9925,1189,4823,717,20,1,16675
10/28/2018,17,9908,1323,5177,308,3,1,16720
10/28/2018,18,9920,1674,5192,126,0,1,16913
10/28/2018,19,9919,1553,5143,123,0,1,16739
10/28/2018,20,9914,1311,5102,167,0,1,16495
10/28/2018,21,9918,1059,4887,247,0,1,16112
10/28/2018,22,9910,680,4409,524,0,1,15524
10/28/2018,23,9905,241,3776,990,0,1,14913
10/28/2018,24,9908,166,3553,1136,0,1,14764
10/29/2018,1,9911,165,3684,1348,0,1,15109
10/29/2018,2,9913,169,3223,1618,0,1,14924
10/29/2018,3,9926,179,2971,1715,0,12,14803
10/29/2018,4,9928,257,2906,1763,0,14,14868
10/29/2018,5,9926,475,3084,1905,0,15,15405
10/29/2018,6,9925,698,3447,2255,0,21,16346
10/29/2018,7,9924,797,3918,2298,0,28,16965
10/29/2018,8,9924,820,4602,2163,2,30,17541
10/29/2018,9,9919,1142,4800,2096,17,28,18002
10/29/2018,10,9917,953,4696,2348,37,28,17979
10/29/2018,11,9912,879,4588,2485,54,27,17945
10/29/2018,12,9908,820,4522,2567,80,28,17925
10/29/2018,13,9908,895,4489,2537,108,28,17965
10/29/2018,14,9909,1144,3543,2637,150,13,17396
10/29/2018,15,9904,866,3660,2493,134,1,17058
10/29/2018,16,9904,907,4284,2679,102,1,17877
10/29/2018,17,9911,1004,4806,2163,35,3,17922
10/29/2018,18,9909,1499,5138,1837,0,23,18406
10/29/2018,19,9910,1618,5110,1717,0,27,18382
10/29/2018,20,9907,1208,5070,1712,0,27,17924
10/29/2018,21,9908,888,4679,1729,0,27,17231
10/29/2018,22,9910,462,4154,1605,0,27,16158
10/29/2018,23,9915,197,4254,1368,0,18,15752
10/29/2018,24,9907,168,4481,1160,0,14,15730
10/30/2018,1,9910,168,4391,877,0,13,15359
10/30/2018,2,9917,167,4324,776,0,13,15197
10/30/2018,3,9914,180,4368,698,0,13,15173
10/30/2018,4,9921,273,4349,656,0,14,15213
10/30/2018,5,9923,542,4175,562,0,15,15217
10/30/2018,6,9924,1143,4734,457,0,22,16280
10/30/2018,7,9924,1913,5167,378,0,28,17410
10/30/2018,8,9925,1898,4985,260,40,12,17120
10/30/2018,9,9923,1775,4768,187,126,2,16781
10/30/2018,10,9925,1679,4893,175,181,5,16858
10/30/2018,11,9929,1250,4881,231,231,1,16523
10/30/2018,12,9929,1215,4653,417,275,21,16510
10/30/2018,13,9928,1353,4431,596,267,29,16604
10/30/2018,14,9925,1456,4073,765,237,28,16484
10/30/2018,15,9925,1001,4076,912,162,28,16104
10/30/2018,16,9926,725,4500,1060,112,28,16351
10/30/2018,17,9925,869,5240,1202,25,28,17289
10/30/2018,18,9922,927,5212,1674,0,28,17763
10/30/2018,19,9919,894,4802,2068,0,27,17710
10/30/2018,20,9923,727,4211,2519,0,28,17408
10/30/2018,21,9920,370,4568,2492,0,27,17377
10/30/2018,22,9922,198,4567,2285,0,28,17000
10/30/2018,23,9927,200,4125,2326,0,17,16595
10/30/2018,24,9928,198,3097,2463,0,14,15700
10/31/2018,1,9929,195,2695,2630,0,13,15462
10/31/2018,2,9932,198,2784,2184,0,15,15113
10/31/2018,3,9925,199,2673,2237,0,15,15049
10/31/2018,4,9925,195,2716,2305,0,14,15155
10/31/2018,5,9993,194,2774,2630,0,15,15606
10/31/2018,6,10151,265,3522,2495,0,23,16456
10/31/2018,7,10145,346,4490,2408,0,28,17417
10/31/2018,8,10143,690,4420,2230,1,28,17512
10/31/2018,9,10252,851,4121,2280,4,28,17536
10/31/2018,10,10349,966,4312,2073,14,28,17742
10/31/2018,11,10319,1138,4290,2087,23,28,17885
10/31/2018,12,10346,1150,3843,2228,24,167,17758
10/31/2018,13,10494,1101,4059,2405,22,272,18353
10/31/2018,14,10453,1121,4132,2196,31,34,17967
10/31/2018,15,10496,1122,4399,1823,41,29,17910
10/31/2018,16,10495,1103,4981,1436,21,28,18064
10/31/2018,17,10497,1062,5005,842,5,28,17439
10/31/2018,18,10489,1212,5016,501,0,28,17246
10/31/2018,19,10493,1224,4950,367,0,28,17062
10/31/2018,20,10491,1244,5124,391,0,30,17280
10/31/2018,21,10501,1197,4726,421,0,28,16873
10/31/2018,22,10492,413,4690,406,0,30,16031
10/31/2018,23,10490,195,4367,509,0,18,15579
10/31/2018,24,10499,195,3784,558,0,14,15050
11/1/2018,1,10498,178,3348,537,0,13,14574
11/1/2018,2,10506,176,3457,427,0,13,14579
11/1/2018,3,10082,219,4032,315,0,13,14661
11/1/2018,4,9713,331,4341,195,0,13,14593
11/1/2018,5,9735,555,3990,130,0,16,14426
11/1/2018,6,9838,924,4225,149,0,24,15160
11/1/2018,7,9842,1505,5256,189,0,28,16820
11/1/2018,8,9829,1526,5344,228,0,28,16955
11/1/2018,9,9828,1416,5491,311,13,28,17087
11/1/2018,10,9833,1401,5346,280,28,28,16916
11/1/2018,11,9827,1733,5297,260,37,33,17187
11/1/2018,12,9833,1700,5259,303,52,29,17176
11/1/2018,13,9822,2110,5046,460,61,27,17526
11/1/2018,14,9005,2262,5253,615,42,28,17205
11/1/2018,15,9005,2318,5205,774,30,29,17361
11/1/2018,16,9007,2014,5108,1389,10,29,17557
11/1/2018,17,9013,1853,4911,1678,2,28,17485
11/1/2018,18,9011,1812,4988,1812,0,28,17651
11/1/2018,19,9011,1807,4971,2236,0,28,18053
11/1/2018,20,9013,1534,4862,2592,0,27,18028
11/1/2018,21,9009,648,4747,2884,0,27,17315
11/1/2018,22,9000,196,4270,2985,0,27,16478
11/1/2018,23,9003,172,3852,2887,0,19,15933
11/1/2018,24,8995,173,3422,2750,0,14,15354
11/2/2018,1,8996,173,2965,2774,0,14,14922
11/2/2018,2,9021,173,3124,2384,0,14,14716
11/2/2018,3,9016,184,3133,2402,0,14,14749
11/2/2018,4,9002,191,2935,2573,0,14,14715
11/2/2018,5,8999,304,3133,2621,0,15,15072
11/2/2018,6,9001,624,3889,2411,0,22,15947
11/2/2018,7,9001,1002,4707,2362,0,28,17100
11/2/2018,8,8994,1336,5305,2032,2,28,17697
11/2/2018,9,8989,1940,5265,1475,11,28,17708
11/2/2018,10,8989,2200,5285,1140,28,28,17670
11/2/2018,11,8987,2565,5233,798,46,28,17657
11/2/2018,12,8990,2780,4901,602,46,28,17347
11/2/2018,13,8993,2575,4746,547,57,28,16946
11/2/2018,14,8994,2698,4874,565,43,28,17202
11/2/2018,15,8993,2559,4943,524,30,28,17077
11/2/2018,16,8989,2705,5122,408,18,28,17270
11/2/2018,17,9000,2654,5315,507,4,28,17508
11/2/2018,18,8991,2474,5583,521,0,28,17597
11/2/2018,19,8989,2455,5597,500,0,28,17569
11/2/2018,20,8987,2316,5586,442,0,28,17359
11/2/2018,21,8988,2179,5276,448,0,28,16919
11/2/2018,22,8995,1564,4779,559,0,28,15925
11/2/2018,23,8994,979,4481,595,0,22,15071
11/2/2018,24,9000,437,4286,564,0,12,14299
11/3/2018,1,9005,229,4574,511,0,1,14320
11/3/2018,2,9009,164,4549,470,0,1,14193
11/3/2018,3,9013,211,4597,435,0,2,14258
11/3/2018,4,9178,206,4591,480,0,1,14456
11/3/2018,5,9212,113,4241,562,0,1,14129
11/3/2018,6,9220,117,4221,796,0,1,14355
11/3/2018,7,9201,134,4718,777,0,1,14831
11/3/2018,8,9269,231,5283,880,6,1,15670
11/3/2018,9,9401,279,5193,1143,29,1,16046
11/3/2018,10,9392,181,4380,1598,76,1,15628
11/3/2018,11,9489,211,3895,2277,92,1,15965
11/3/2018,12,9552,229,3881,2595,104,1,16362
11/3/2018,13,9545,429,4007,2691,95,1,16768
11/3/2018,14,9506,657,4217,2688,93,1,17162
11/3/2018,15,9545,767,4035,2612,90,1,17050
11/3/2018,16,9555,747,4278,2553,54,1,17188
11/3/2018,17,9550,752,5100,2118,12,1,17533
11/3/2018,18,9556,809,5664,1646,0,1,17676
11/3/2018,19,9539,745,5630,1425,0,1,17340
11/3/2018,20,9534,741,5551,1137,0,1,16964
11/3/2018,21,9544,765,5600,817,0,1,16727
11/3/2018,22,9557,971,5446,514,0,1,16489
11/3/2018,23,9609,321,5333,372,0,1,15636
11/3/2018,24,9720,119,4949,258,0,1,15047
11/4/2018,1,9729,115,4450,276,0,1,14571
11/4/2018,2,9731,114,4303,202,0,1,14351
11/4/2018,3,9730,113,4433,209,0,1,14486
11/4/2018,4,9729,114,4332,231,0,1,14407
11/4/2018,5,9730,113,4215,249,0,1,14308
11/4/2018,6,9747,113,4339,430,0,1,14630
11/4/2018,7,9761,114,4504,653,0,1,15033
11/4/2018,8,9762,115,4433,1004,20,1,15335
11/4/2018,9,9761,116,4022,1323,127,1,15350
11/4/2018,10,9763,116,3649,1399,240,1,15168
11/4/2018,11,9760,205,3450,1566,264,3,15248
11/4/2018,12,9870,274,3380,1727,275,2,15528
11/4/2018,13,9894,338,3374,1811,255,1,15673
11/4/2018,14,9794,449,3401,1776,212,1,15633
11/4/2018,15,9950,464,3425,2084,171,1,16095
11/4/2018,16,9956,466,3704,2217,94,1,16438
11/4/2018,17,9958,459,4035,3147,13,1,17613
11/4/2018,18,9963,458,4697,3503,0,1,18622
11/4/2018,19,9996,461,4527,3457,0,1,18442
11/4/2018,20,10159,462,4243,3121,0,1,17986
11/4/2018,21,10353,258,3885,3155,0,1,17652
11/4/2018,22,10408,113,3437,3125,0,1,17084
11/4/2018,23,10400,116,3093,2924,0,1,16534
11/4/2018,24,10394,114,3037,2335,0,1,15881
11/5/2018,1,10403,115,2825,2106,0,1,15450
11/5/2018,2,10404,117,2817,1817,0,1,15156
11/5/2018,3,10410,117,2930,1490,0,9,14956
11/5/2018,4,10414,117,2904,1306,0,11,14752
11/5/2018,5,10409,115,2804,1915,0,11,15254
11/5/2018,6,10415,122,3091,2297,0,16,15941
11/5/2018,7,10429,126,3471,3021,0,25,17072
11/5/2018,8,10430,133,4321,3327,0,28,18239
11/5/2018,9,10432,235,4520,3195,11,28,18421
11/5/2018,10,10429,367,4244,2925,19,28,18012
11/5/2018,11,10434,634,4695,2588,39,28,18418
11/5/2018,12,10498,934,4318,2531,49,28,18358
11/5/2018,13,10546,1162,4267,2568,67,28,18638
11/5/2018,14,10532,1364,4130,2290,48,28,18392
11/5/2018,15,10535,1671,4185,2071,36,28,18526
11/5/2018,16,10530,1952,4237,1694,20,29,18462
11/5/2018,17,10525,2032,4695,1152,9,28,18441
11/5/2018,18,10547,2063,5373,918,0,28,18929
11/5/2018,19,10550,2058,5218,718,0,28,18572
11/5/2018,20,10553,2013,5233,798,0,28,18625
11/5/2018,21,10552,1182,5032,923,0,28,17717
11/5/2018,22,10553,789,4815,1134,0,28,17319
11/5/2018,23,10553,571,4314,1212,0,29,16679
11/5/2018,24,10545,163,3869,1210,0,20,15807
11/6/2018,1,10547,170,3248,1351,0,14,15330
11/6/2018,2,10566,168,2985,1255,0,11,14985
11/6/2018,3,10570,171,2997,1044,0,11,14793
11/6/2018,4,10556,173,3029,908,0,11,14677
11/6/2018,5,10575,164,2999,996,0,12,14746
11/6/2018,6,10575,157,3012,1501,0,15,15260
11/6/2018,7,10521,117,3315,2268,0,24,16245
11/6/2018,8,10513,162,3264,3255,1,27,17222
11/6/2018,9,10501,166,3408,3401,9,28,17513
11/6/2018,10,10493,158,3571,3584,18,28,17852
11/6/2018,11,10502,161,3454,3809,43,28,17997
11/6/2018,12,10509,248,3363,3427,69,29,17645
11/6/2018,13,10489,362,3599,2609,127,30,17216
11/6/2018,14,10500,496,3853,2195,108,28,17180
11/6/2018,15,10526,484,3838,2413,39,27,17327
11/6/2018,16,10513,514,3862,2568,29,28,17514
11/6/2018,17,10464,522,3978,3184,5,27,18180
11/6/2018,18,10488,531,3956,3988,0,28,18991
11/6/2018,19,10530,536,3666,3984,0,30,18746
11/6/2018,20,10531,525,3541,3774,0,29,18400
11/6/2018,21,10513,342,3525,3726,0,28,18134
11/6/2018,22,10519,199,3295,3256,0,28,17297
11/6/2018,23,10519,199,2980,2683,0,28,16409
11/6/2018,24,10506,203,3006,1877,0,20,15612
11/7/2018,1,10517,199,2908,1534,0,14,15172
11/7/2018,2,10514,194,2904,1053,0,11,14676
11/7/2018,3,10497,194,2905,932,0,11,14539
11/7/2018,4,10491,188,2911,901,0,11,14502
11/7/2018,5,10496,191,2973,1023,0,12,14695
11/7/2018,6,10435,214,3014,1490,0,15,15168
11/7/2018,7,10415,348,3238,2253,0,23,16277
11/7/2018,8,10417,420,3632,2953,10,27,17459
11/7/2018,9,10259,426,3686,2851,78,28,17328
11/7/2018,10,10326,439,3647,2830,80,28,17350
11/7/2018,11,10391,422,3548,2840,98,28,17327
11/7/2018,12,10398,414,3381,3253,66,27,17539
11/7/2018,13,10413,472,3344,3493,49,28,17799
11/7/2018,14,10409,420,3672,3315,70,28,17914
11/7/2018,15,10427,338,3576,3314,31,27,17713
11/7/2018,16,10438,442,3744,3155,14,27,17820
11/7/2018,17,10518,540,4260,3231,2,27,18578
11/7/2018,18,10524,543,4675,3326,0,27,19095
11/7/2018,19,10534,541,4997,3093,0,28,19193
11/7/2018,20,10531,536,5093,2918,0,28,19106
11/7/2018,21,10528,529,5144,2716,0,28,18945
11/7/2018,22,10532,532,4618,2651,0,28,18361
11/7/2018,23,10533,350,3909,2615,0,28,17435
11/7/2018,24,10535,199,3344,2245,0,20,16343
11/8/2018,1,10530,195,2967,2046,0,14,15752
11/8/2018,2,10544,199,2916,1999,0,11,15669
11/8/2018,3,10540,198,2894,1811,0,11,15454
11/8/2018,4,10531,196,2968,1530,0,11,15236
11/8/2018,5,10533,200,2851,1478,0,11,15073
11/8/2018,6,10529,261,3275,1541,0,13,15619
11/8/2018,7,10533,356,3963,1737,0,22,16611
11/8/2018,8,10538,502,4503,1740,3,28,17314
11/8/2018,9,10535,609,4476,1537,17,28,17202
11/8/2018,10,10539,833,4423,1465,35,30,17325
11/8/2018,11,10539,1078,4636,1298,84,28,17663
11/8/2018,12,10538,1198,4735,1080,94,28,17673
11/8/2018,13,10542,1331,4713,953,85,28,17652
11/8/2018,14,10542,1428,4651,755,47,28,17451
11/8/2018,15,10546,1570,4727,613,40,29,17525
11/8/2018,16,10547,1835,4606,457,25,28,17498
11/8/2018,17,10548,1952,4793,272,6,28,17599
11/8/2018,18,10543,2204,5317,159,0,28,18251
11/8/2018,19,10546,2035,5565,88,0,28,18262
11/8/2018,20,10550,1985,5579,95,0,28,18237
11/8/2018,21,10544,1751,5503,152,0,28,17978
11/8/2018,22,10534,1147,5488,127,0,29,17325
11/8/2018,23,10543,679,4954,259,0,29,16464
11/8/2018,24,10549,428,4589,398,0,20,15984
11/9/2018,1,10550,181,4387,517,0,14,15649
11/9/2018,2,10545,144,3763,729,0,11,15192
11/9/2018,3,10546,143,3491,850,0,11,15041
11/9/2018,4,10552,108,3323,1058,0,11,15052
11/9/2018,5,10552,131,3327,1217,0,11,15238
11/9/2018,6,10558,265,3469,1401,0,14,15707
11/9/2018,7,10558,355,4274,1631,0,24,16842
11/9/2018,8,10563,426,5090,1832,1,28,17940
11/9/2018,9,10584,589,4742,1727,8,28,17678
11/9/2018,10,10693,666,4860,1575,14,28,17836
11/9/2018,11,10691,491,4651,1241,16,28,17118
11/9/2018,12,10681,559,4838,1154,17,28,17277
11/9/2018,13,10670,693,4879,964,23,28,17257
11/9/2018,14,10669,683,4778,938,19,28,17115
11/9/2018,15,10659,641,5110,986,13,29,17438
11/9/2018,16,10644,791,5053,1021,3,28,17540
11/9/2018,17,10647,857,5437,1215,0,28,18184
11/9/2018,18,10663,857,5337,1370,0,28,18255
11/9/2018,19,10677,762,5243,1919,0,27,18628
11/9/2018,20,10694,741,4931,2495,0,27,18888
11/9/2018,21,10698,578,4754,2910,0,27,18967
11/9/2018,22,10696,416,4146,3350,0,27,18635
11/9/2018,23,10697,412,3328,2900,0,28,17365
11/9/2018,24,10695,267,3300,2026,0,18,16306
11/10/2018,1,10701,213,2980,1992,0,7,15893
11/10/2018,2,10703,213,2917,1915,0,1,15749
11/10/2018,3,10692,213,2888,1743,0,1,15537
11/10/2018,4,10684,213,2914,1711,0,1,15523
11/10/2018,5,10689,213,2985,1838,0,1,15726
11/10/2018,6,10690,157,2961,2174,0,1,15983
11/10/2018,7,10691,157,3117,1966,0,1,15932
11/10/2018,8,10693,214,3716,1844,16,2,16485
11/10/2018,9,10696,214,3872,1966,92,2,16842
11/10/2018,10,10694,214,3902,1883,164,1,16858
11/10/2018,11,10701,214,3776,2541,199,1,17432
11/10/2018,12,10694,225,3610,3109,111,1,17750
11/10/2018,13,10703,171,3510,3095,76,1,17556
11/10/2018,14,10706,178,3619,2836,73,1,17413
11/10/2018,15,10708,329,3633,2407,63,1,17141
11/10/2018,16,10712,543,4107,2070,28,1,17461
11/10/2018,17,10712,612,4711,2049,8,1,18093
11/10/2018,18,10705,611,5328,2171,0,1,18816
11/10/2018,19,10707,612,5184,2013,0,1,18517
11/10/2018,20,10710,555,5212,1958,0,1,18436
11/10/2018,21,10701,593,5154,1836,0,1,18285
11/10/2018,22,10702,588,4614,1593,0,1,17498
11/10/2018,23,10676,255,4258,1536,0,1,16726
11/10/2018,24,10703,162,3818,1488,0,1,16172
11/11/2018,1,10716,231,3192,1444,0,1,15584
11/11/2018,2,10722,228,3290,1075,0,1,15316
11/11/2018,3,10736,230,3407,926,0,1,15300
11/11/2018,4,10734,175,3321,774,0,1,15005
11/11/2018,5,10719,171,3223,638,0,1,14752
11/11/2018,6,10724,170,3502,654,0,1,15051
11/11/2018,7,10732,159,3802,660,0,1,15354
11/11/2018,8,10732,153,3956,780,19,1,15641
11/11/2018,9,10727,185,4139,796,91,2,15940
11/11/2018,10,10732,295,4120,938,134,1,16220
11/11/2018,11,10731,381,3805,1183,150,1,16251
11/11/2018,12,10731,401,3609,1281,215,1,16238
11/11/2018,13,10731,463,4141,1384,194,1,16914
11/11/2018,14,10731,634,4217,1343,178,1,17104
11/11/2018,15,10735,854,4296,1283,135,1,17304
11/11/2018,16,10733,930,4653,1139,71,1,17527
11/11/2018,17,10734,997,5264,788,13,1,17797
11/11/2018,18,10732,1066,5724,642,0,1,18165
11/11/2018,19,10720,1028,5267,697,0,1,17713
11/11/2018,20,10713,1026,5287,727,0,1,17754
11/11/2018,21,10711,863,5275,713,0,1,17563
11/11/2018,22,10727,523,5361,727,0,1,17339
11/11/2018,23,10725,224,4514,779,0,1,16243
11/11/2018,24,10728,192,3757,756,0,1,15434
11/12/2018,1,10728,197,3613,774,0,1,15313
11/12/2018,2,10728,207,3558,702,0,2,15197
11/12/2018,3,10737,206,3433,614,0,2,14992
11/12/2018,4,10732,338,3393,528,0,9,15000
11/12/2018,5,10748,737,3428,323,0,12,15248
11/12/2018,6,10730,1113,3756,327,0,14,15940
11/12/2018,7,10732,1640,4347,237,0,23,16979
11/12/2018,8,10744,2252,4564,266,4,28,17858
11/12/2018,9,10749,2208,4462,258,39,28,17744
11/12/2018,10,10747,1997,4372,294,73,28,17511
11/12/2018,11,10724,2279,4403,273,93,28,17800
11/12/2018,12,10744,2183,4231,340,102,28,17628
11/12/2018,13,10742,2107,4051,459,80,28,17467
11/12/2018,14,10742,2059,4126,561,67,28,17583
11/12/2018,15,10744,2151,4134,487,47,29,17592
11/12/2018,16,10742,2430,4159,437,20,28,17816
11/12/2018,17,10745,2655,4527,403,3,29,18362
11/12/2018,18,10746,3098,4529,300,0,29,18702
11/12/2018,19,10749,3204,4502,274,0,28,18757
11/12/2018,20,10747,3023,4636,267,0,28,18701
11/12/2018,21,10746,2946,4599,252,0,29,18572
11/12/2018,22,10745,2260,4446,299,0,28,17778
11/12/2018,23,10745,1480,3973,351,0,28,16577
11/12/2018,24,10741,455,3876,394,0,21,15487
11/13/2018,1,10747,299,3766,446,0,15,15273
11/13/2018,2,10748,299,3472,439,0,12,14970
11/13/2018,3,10742,299,3295,480,0,12,14828
11/13/2018,4,10751,299,3241,537,0,11,14839
11/13/2018,5,10755,299,3468,504,0,13,15039
11/13/2018,6,10754,372,3452,538,0,15,15131
11/13/2018,7,10752,728,3651,751,0,21,15903
11/13/2018,8,10727,831,3992,1073,1,28,16652
11/13/2018,9,10680,978,4624,1256,12,28,17578
11/13/2018,10,10677,1390,4756,1087,26,28,17964
11/13/2018,11,10673,1940,4827,767,54,28,18289
11/13/2018,12,10676,2141,4424,1015,66,28,18350
11/13/2018,13,10667,2057,4335,1335,54,28,18476
11/13/2018,14,10664,1860,3984,1707,29,28,18272
11/13/2018,15,10641,1894,3660,1977,27,28,18227
11/13/2018,16,10722,2041,3637,1768,19,28,18215
11/13/2018,17,10734,2176,4450,2159,3,28,19550
11/13/2018,18,10736,2417,4683,2355,0,28,20219
11/13/2018,19,10731,2233,4487,2565,0,29,20045
11/13/2018,20,10727,2155,4326,2716,0,29,19953
11/13/2018,21,10729,1622,4270,2822,0,29,19472
11/13/2018,22,10730,952,4140,2725,0,29,18576
11/13/2018,23,10728,454,3815,2587,0,25,17609
11/13/2018,24,10727,257,3373,2634,0,4,16995
11/14/2018,1,10733,206,3213,2368,0,9,16529
11/14/2018,2,10729,206,3132,2260,0,10,16337
11/14/2018,3,10731,213,3095,2171,0,10,16220
11/14/2018,4,10735,209,3050,2035,0,9,16038
11/14/2018,5,10735,210,3146,1718,0,9,15818
11/14/2018,6,10737,290,3409,1784,0,9,16229
11/14/2018,7,10730,602,4173,1715,0,10,17230
11/14/2018,8,10727,1399,4658,1716,11,11,18522
11/14/2018,9,10728,1479,4779,1387,61,11,18445
11/14/2018,10,10725,1690,4553,1290,146,11,18415
11/14/2018,11,10724,1512,4394,1165,167,11,17973
11/14/2018,12,10725,1562,4270,961,192,12,17722
11/14/2018,13,10706,1819,4129,801,190,12,17657
11/14/2018,14,10549,2292,4226,657,171,11,17906
11/14/2018,15,10553,2336,4440,532,119,13,17993
11/14/2018,16,10708,2646,4560,323,57,11,18305
11/14/2018,17,10715,3056,4714,238,8,11,18742
11/14/2018,18,10715,3932,4979,216,0,9,19851
11/14/2018,19,10702,3779,5212,247,0,11,19951
11/14/2018,20,10703,3429,5274,347,0,11,19764
11/14/2018,21,10703,3107,5154,526,0,11,19501
11/14/2018,22,10698,2343,4913,689,0,11,18654
11/14/2018,23,10701,1205,4681,825,0,11,17423
11/14/2018,24,10703,339,4281,955,0,11,16289
11/15/2018,1,10722,203,4159,1106,0,10,16200
11/15/2018,2,10682,201,3840,1348,0,10,16081
11/15/2018,3,10693,204,3562,1458,0,11,15928
11/15/2018,4,10690,219,3231,1863,0,11,16014
11/15/2018,5,10694,306,3291,1807,0,11,16109
11/15/2018,6,10697,617,3556,1927,0,11,16808
11/15/2018,7,10690,1143,3911,2055,0,11,17810
11/15/2018,8,10658,1383,4791,2268,2,10,19112
11/15/2018,9,10604,1379,4811,2324,15,11,19144
11/15/2018,10,10606,1385,4613,2212,30,11,18857
11/15/2018,11,10595,1409,5056,1816,47,11,18934
11/15/2018,12,10592,1871,5035,1490,60,11,19059
11/15/2018,13,10595,1860,4853,1491,64,11,18874
11/15/2018,14,10659,1986,4756,1529,38,11,18979
11/15/2018,15,10676,2039,4862,1451,19,11,19058
11/15/2018,16,10677,2198,4945,1417,7,11,19255
11/15/2018,17,10680,2837,5105,1412,0,11,20045
11/15/2018,18,10682,3343,5095,1438,0,11,20569
11/15/2018,19,10683,3203,5172,1294,0,12,20364
11/15/2018,20,10680,2999,5240,1237,0,11,20167
11/15/2018,21,10683,2821,5173,1144,0,11,19832
11/15/2018,22,10681,2235,4861,1084,0,11,18872
11/15/2018,23,10670,1468,4636,1008,0,14,17796
11/15/2018,24,10673,765,4346,937,0,12,16733
11/16/2018,1,10673,234,4760,851,0,13,16531
11/16/2018,2,10676,200,4293,1000,0,14,16183
11/16/2018,3,10679,199,3658,1323,0,11,15870
11/16/2018,4,10684,199,3436,1493,0,10,15822
11/16/2018,5,10681,201,3463,1639,0,10,15994
11/16/2018,6,10683,285,3597,1868,0,11,16444
11/16/2018,7,10688,561,3947,2097,0,11,17304
11/16/2018,8,10689,568,4544,2422,0,10,18233
11/16/2018,9,10690,565,4745,2531,2,10,18543
11/16/2018,10,10689,565,4723,2826,5,10,18818
11/16/2018,11,10689,565,4767,2762,7,10,18800
11/16/2018,12,10689,592,4782,2938,11,10,19022
11/16/2018,13,10686,274,4461,3036,11,11,18479
11/16/2018,14,10682,293,4179,3198,11,10,18373
11/16/2018,15,10686,384,4469,3210,5,10,18764
11/16/2018,16,10678,560,4478,3403,2,11,19132
11/16/2018,17,10671,1118,4687,3325,0,11,19812
11/16/2018,18,10664,1214,5103,3226,0,11,20218
11/16/2018,19,10669,1230,4668,3296,0,11,19874
11/16/2018,20,10670,1180,4245,3216,0,11,19322
11/16/2018,21,10666,1058,4065,3165,0,11,18965
11/16/2018,22,10669,857,3661,3095,0,11,18293
11/16/2018,23,10665,523,3439,2699,0,10,17336
11/16/2018,24,10664,198,3370,2539,0,8,16779
11/17/2018,1,10663,198,2964,2098,0,2,15925
11/17/2018,2,10659,198,2961,2063,0,1,15882
11/17/2018,3,10659,198,2944,1731,0,1,15533
11/17/2018,4,10665,200,2847,1811,0,1,15524
11/17/2018,5,10668,202,2842,1744,0,1,15457
11/17/2018,6,10673,241,2903,1748,0,1,15566
11/17/2018,7,10672,285,3027,1787,0,1,15772
11/17/2018,8,10672,345,3387,1811,2,1,16218
11/17/2018,9,10668,362,3893,1742,17,2,16684
11/17/2018,10,10663,464,4738,1432,54,2,17353
11/17/2018,11,10661,759,4812,1367,99,1,17699
11/17/2018,12,10663,833,4663,1295,87,1,17542
11/17/2018,13,10664,801,4445,1335,58,1,17304
11/17/2018,14,10665,814,4677,1299,37,1,17493
11/17/2018,15,10669,816,4583,1308,39,1,17416
11/17/2018,16,10665,819,4673,1110,23,1,17291
11/17/2018,17,10663,820,4674,1074,1,1,17233
11/17/2018,18,10664,823,4906,891,0,1,17285
11/17/2018,19,10670,857,5127,703,0,1,17358
11/17/2018,20,10668,818,5226,547,0,2,17261
11/17/2018,21,10662,424,5240,473,0,1,16800
11/17/2018,22,10663,287,5043,352,0,1,16346
11/17/2018,23,10661,279,5085,305,0,1,16331
11/17/2018,24,10666,261,4696,282,0,1,15906
11/18/2018,1,10667,211,4340,231,0,1,15450
11/18/2018,2,10665,199,3939,206,0,1,15010
11/18/2018,3,10669,200,3700,245,0,1,14815
11/18/2018,4,10666,199,3580,198,0,1,14644
11/18/2018,5,10665,199,3608,237,0,2,14711
11/18/2018,6,10671,198,3996,319,0,4,15188
11/18/2018,7,10677,200,4334,371,0,4,15586
11/18/2018,8,10678,201,4547,466,1,5,15898
11/18/2018,9,10672,292,4901,455,12,2,16334
11/18/2018,10,10668,402,5143,406,27,5,16651
11/18/2018,11,10671,579,5132,358,39,7,16786
11/18/2018,12,10670,851,4967,324,23,2,16837
11/18/2018,13,10668,867,4817,331,30,1,16714
11/18/2018,14,10667,875,4928,319,27,1,16817
11/18/2018,15,10631,924,4776,299,25,1,16656
11/18/2018,16,10670,997,4996,282,9,1,16955
11/18/2018,17,10668,1376,5031,316,1,1,17393
11/18/2018,18,10671,1732,5387,351,0,1,18142
11/18/2018,19,10672,1512,5100,547,0,1,17832
11/18/2018,20,10672,1430,4611,560,0,1,17274
11/18/2018,21,10670,909,4690,523,0,1,16793
11/18/2018,22,10670,775,4436,745,0,1,16627
11/18/2018,23,10665,476,4326,830,0,1,16298
11/18/2018,24,10663,206,4157,937,0,1,15964
11/19/2018,1,10666,198,4084,1007,0,1,15956
11/19/2018,2,10664,200,3928,811,0,1,15604
11/19/2018,3,10667,211,3950,580,0,1,15409
11/19/2018,4,10671,293,3950,529,0,1,15444
11/19/2018,5,10670,569,3741,311,0,11,15302
11/19/2018,6,10672,893,3854,337,0,14,15770
11/19/2018,7,10673,1364,4410,353,0,22,16822
11/19/2018,8,10670,1483,4737,350,7,30,17277
11/19/2018,9,10673,1592,4750,317,60,28,17420
11/19/2018,10,10678,1637,4361,251,114,29,17070
11/19/2018,11,10678,1670,4323,183,141,28,17023
11/19/2018,12,10680,1734,4557,216,154,31,17372
11/19/2018,13,10678,1970,4225,208,124,28,17233
11/19/2018,14,10677,2303,4376,210,108,28,17702
11/19/2018,15,10676,2374,4587,240,90,28,17995
11/19/2018,16,10603,2559,4535,140,27,28,17892
11/19/2018,17,10546,2812,4773,178,6,31,18346
11/19/2018,18,10552,3396,5264,166,0,31,19409
11/19/2018,19,10553,3555,5324,223,0,28,19683
11/19/2018,20,10551,2810,5033,327,0,28,18749
11/19/2018,21,10548,2408,5238,420,0,27,18641
11/19/2018,22,10544,1958,4848,477,0,27,17854
11/19/2018,23,10538,1347,4276,424,0,28,16613
11/19/2018,24,10538,1052,3836,247,0,19,15692
11/20/2018,1,10545,397,3699,532,0,15,15188
11/20/2018,2,10547,263,3910,671,0,12,15403
11/20/2018,3,10540,273,3840,638,0,13,15304
11/20/2018,4,10539,285,3834,690,0,13,15361
11/20/2018,5,10538,477,3809,256,0,12,15092
11/20/2018,6,10542,977,3969,523,0,13,16024
11/20/2018,7,10545,1297,4305,1277,0,18,17442
11/20/2018,8,10546,1616,4594,1570,2,27,18355
11/20/2018,9,10546,1705,4924,1623,7,28,18833
11/20/2018,10,10546,1698,4870,1736,24,28,18902
11/20/2018,11,10539,1926,4739,1467,48,28,18747
11/20/2018,12,10537,1807,4342,1281,102,28,18097
11/20/2018,13,10541,1726,4285,1020,149,28,17749
11/20/2018,14,10541,1883,4168,1274,164,28,18058
11/20/2018,15,10541,2068,4277,1201,126,28,18241
11/20/2018,16,10543,2093,4330,1088,53,29,18136
11/20/2018,17,10531,3181,4687,1138,10,29,19576
11/20/2018,18,10314,3997,4876,1024,0,30,20241
11/20/2018,19,9653,4091,5073,1405,0,28,20250
11/20/2018,20,9651,3291,5045,1899,0,28,19914
11/20/2018,21,9653,2742,4779,2112,0,28,19314
11/20/2018,22,9647,1191,4371,2772,0,28,18009
11/20/2018,23,9646,388,4001,3308,0,28,17371
11/20/2018,24,9647,274,3757,3264,0,21,16963
11/21/2018,1,9651,269,3362,3239,0,15,16536
11/21/2018,2,9651,267,3278,3425,0,14,16635
11/21/2018,3,9637,267,3313,3255,0,13,16485
11/21/2018,4,9647,265,3408,3214,0,12,16546
11/21/2018,5,9637,264,3473,3317,0,13,16704
11/21/2018,6,9641,269,3639,3258,0,14,16821
11/21/2018,7,9640,294,4230,3134,0,17,17315
11/21/2018,8,9637,533,4489,3442,0,24,18125
11/21/2018,9,9636,663,4626,3253,9,32,18219
11/21/2018,10,9630,908,4417,3241,33,32,18261
11/21/2018,11,9632,1501,4212,2551,102,28,18026
11/21/2018,12,9636,1934,4062,2679,134,26,18471
11/21/2018,13,9638,2124,3970,2830,155,26,18743
11/21/2018,14,9493,2359,3748,3170,159,28,18957
11/21/2018,15,9473,2442,3754,3340,139,27,19175
11/21/2018,16,9628,2511,4077,2575,45,29,18865
11/21/2018,17,9627,2791,4179,2764,6,27,19394
11/21/2018,18,9632,2899,5024,2665,0,27,20247
11/21/2018,19,9636,2818,4966,2409,0,27,19856
11/21/2018,20,9635,3161,5215,1903,0,27,19941
11/21/2018,21,9632,3486,5166,1445,0,27,19756
11/21/2018,22,9631,2929,4894,1217,0,27,18698
11/21/2018,23,9621,1879,4575,1085,0,27,17187
11/21/2018,24,9616,1682,4406,924,0,18,16646
11/22/2018,1,9618,1519,4145,677,0,14,15973
11/22/2018,2,9617,1585,4223,528,0,13,15966
11/22/2018,3,9618,1437,4022,493,0,13,15583
11/22/2018,4,9619,1503,4105,544,0,13,15784
11/22/2018,5,9623,1719,4018,533,0,13,15906
11/22/2018,6,9622,2129,3924,527,0,16,16218
11/22/2018,7,9630,2597,4842,622,0,21,17712
11/22/2018,8,9604,3522,5093,710,8,27,18964
11/22/2018,9,9563,3527,4883,677,69,26,18745
11/22/2018,10,9560,3218,4750,652,144,27,18351
11/22/2018,11,9555,2431,4479,750,213,27,17455
11/22/2018,12,9599,2158,4295,933,269,27,17281
11/22/2018,13,9624,2069,4210,891,273,29,17096
11/22/2018,14,9626,2094,3937,881,274,29,16841
11/22/2018,15,9626,2119,4182,887,212,26,17052
11/22/2018,16,9626,2195,4565,939,94,27,17446
11/22/2018,17,9622,2511,5025,919,9,27,18113
11/22/2018,18,9627,3187,5101,1017,0,27,18959
11/22/2018,19,9625,3029,5120,1471,0,27,19272
11/22/2018,20,9632,2562,5024,1981,0,27,19226
11/22/2018,21,9626,2367,4785,2241,0,27,19046
11/22/2018,22,9622,1276,4237,2403,0,29,17567
11/22/2018,23,9620,568,4233,2274,0,27,16722
11/22/2018,24,9620,466,3906,2275,0,18,16285
11/23/2018,1,9622,306,3799,2310,0,13,16050
11/23/2018,2,9669,244,3881,2207,0,13,16014
11/23/2018,3,9844,237,4016,2052,0,12,16161
11/23/2018,4,9857,368,4113,2057,0,12,16407
11/23/2018,5,9883,844,3946,2181,0,13,16867
11/23/2018,6,9891,1585,3564,2184,0,15,17239
11/23/2018,7,9897,1772,4142,2407,0,18,18236
11/23/2018,8,9891,1864,4825,2506,1,27,19114
11/23/2018,9,9891,1729,4870,2453,22,28,18993
11/23/2018,10,9851,1679,4684,2369,98,27,18708
11/23/2018,11,9842,1480,4685,2279,187,27,18500
11/23/2018,12,9892,1089,4339,2102,198,27,17647
11/23/2018,13,10117,1006,4441,1965,195,36,17760
11/23/2018,14,10304,876,4309,1992,177,41,17699
11/23/2018,15,10322,455,4354,2044,134,40,17349
11/23/2018,16,10319,559,4081,2212,67,46,17284
11/23/2018,17,10321,593,4084,2621,10,41,17670
11/23/2018,18,10320,595,4378,3138,0,44,18475
11/23/2018,19,10345,594,4238,3391,0,42,18610
11/23/2018,20,10345,463,4200,3586,0,42,18636
11/23/2018,21,10343,400,4090,3716,0,40,18589
11/23/2018,22,10361,361,3896,3716,0,28,18362
11/23/2018,23,10480,205,3779,3440,0,28,17932
11/23/2018,24,10500,204,3563,3134,0,18,17419
11/24/2018,1,10498,204,3146,2867,0,1,16716
11/24/2018,2,10497,204,3101,2730,0,0,16532
11/24/2018,3,10490,204,3106,2459,0,0,16259
11/24/2018,4,10498,203,3133,2223,0,0,16057
11/24/2018,5,10500,204,3166,2334,0,0,16204
11/24/2018,6,10499,204,2986,2731,0,0,16420
11/24/2018,7,10508,203,3089,2818,0,0,16618
11/24/2018,8,10507,204,3362,3123,1,4,17201
11/24/2018,9,10508,205,3752,3143,5,1,17614
11/24/2018,10,10507,205,3969,3316,76,0,18073
11/24/2018,11,10514,204,4037,3350,87,0,18192
11/24/2018,12,10527,202,4361,3315,99,0,18504
11/24/2018,13,10531,200,4418,3247,65,0,18461
11/24/2018,14,10547,200,4497,3131,43,0,18418
11/24/2018,15,10553,199,4354,2933,16,0,18055
11/24/2018,16,10507,200,4226,2717,6,0,17656
11/24/2018,17,10543,201,4216,2582,1,0,17543
11/24/2018,18,10566,202,4524,2223,0,0,17515
11/24/2018,19,10583,202,4386,2423,0,1,17595
11/24/2018,20,10581,197,4355,2461,0,1,17595
11/24/2018,21,10578,196,4335,2656,0,0,17765
11/24/2018,22,10576,185,4095,2774,0,0,17630
11/24/2018,23,10579,147,3674,2782,0,0,17182
11/24/2018,24,10586,176,3220,2517,0,0,16499
11/25/2018,1,10579,198,2967,2263,0,0,16007
11/25/2018,2,10594,198,2916,2280,0,0,15988
11/25/2018,3,10616,198,2878,2040,0,0,15732
11/25/2018,4,10615,198,2868,1239,0,0,14920
11/25/2018,5,10615,198,2959,1195,0,0,14967
11/25/2018,6,10612,198,2983,1442,0,0,15235
11/25/2018,7,10613,198,3115,1715,0,0,15641
11/25/2018,8,10616,201,3409,1667,1,0,15894
11/25/2018,9,10614,206,4052,1668,6,1,16547
11/25/2018,10,10614,243,4728,1418,33,1,17037
11/25/2018,11,10622,297,4978,1374,47,4,17322
11/25/2018,12,10619,381,4751,1221,64,4,17040
11/25/2018,13,10615,544,4820,1120,52,9,17160
11/25/2018,14,10618,626,4957,957,36,15,17209
11/25/2018,15,10615,619,5249,810,34,20,17347
11/25/2018,16,10614,606,5061,704,10,21,17016
11/25/2018,17,10608,668,5301,484,0,18,17079
11/25/2018,18,10607,837,5485,389,0,14,17332
11/25/2018,19,10609,638,5436,354,0,10,17047
11/25/2018,20,10612,611,5346,436,0,7,17012
11/25/2018,21,10606,610,5096,564,0,10,16886
11/25/2018,22,10619,290,5056,720,0,12,16697
11/25/2018,23,10625,213,4684,1063,0,20,16605
11/25/2018,24,10622,199,4198,1223,0,5,16247
11/26/2018,1,10624,180,3904,1486,0,1,16195
11/26/2018,2,10625,144,3140,1794,0,1,15704
11/26/2018,3,10632,186,3068,1836,0,11,15733
11/26/2018,4,10627,180,3108,1811,0,0,15726
11/26/2018,5,10634,199,3122,1902,0,1,15858
11/26/2018,6,10640,199,3185,2225,0,3,16252
11/26/2018,7,10631,199,3845,2540,0,1,17216
11/26/2018,8,10637,202,4262,2857,0,1,17959
11/26/2018,9,10627,311,4476,2828,2,0,18244
11/26/2018,10,10608,361,4788,2696,10,1,18464
11/26/2018,11,10568,359,4734,2692,14,3,18370
11/26/2018,12,10578,363,4510,2774,19,0,18244
11/26/2018,13,10592,364,4656,2857,26,1,18496
11/26/2018,14,10325,425,4751,2957,22,0,18480
11/26/2018,15,10311,552,4693,3148,17,0,18721
11/26/2018,16,10329,549,4413,3168,6,0,18465
11/26/2018,17,10339,552,4627,3177,1,7,18703
11/26/2018,18,10340,555,4777,3517,0,26,19215
11/26/2018,19,10342,554,4761,3482,0,27,19166
11/26/2018,20,10572,552,5051,3339,0,28,19542
11/26/2018,21,10645,340,5127,3278,0,27,19417
11/26/2018,22,10646,203,4530,3360,0,27,18766
11/26/2018,23,10643,203,3759,3484,0,27,18116
11/26/2018,24,10650,190,3102,2922,0,18,16882
11/27/2018,1,10649,202,2939,2578,0,11,16379
11/27/2018,2,10643,202,2822,2430,0,11,16108
11/27/2018,3,10641,208,2775,2410,0,11,16045
11/27/2018,4,10656,208,2806,2253,0,11,15934
11/27/2018,5,10657,207,2913,2646,0,11,16434
11/27/2018,6,10654,217,3066,2706,0,12,16655
11/27/2018,7,10664,235,3597,2758,0,28,17282
11/27/2018,8,10670,250,3805,2721,0,52,17498
11/27/2018,9,10670,273,4090,2966,3,57,18059
11/27/2018,10,10666,281,4619,3067,9,87,18729
11/27/2018,11,10667,335,4497,3063,17,133,18712
11/27/2018,12,10677,397,4545,3088,22,184,18913
11/27/2018,13,10674,408,4714,3082,19,198,19095
11/27/2018,14,10675,453,4830,3072,14,201,19245
11/27/2018,15,10678,504,4945,2998,7,202,19334
11/27/2018,16,10676,559,4721,2950,1,203,19110
11/27/2018,17,10686,572,5227,2978,0,202,19665
11/27/2018,18,10675,645,5160,3114,0,202,19796
11/27/2018,19,10676,715,4989,3178,0,201,19759
11/27/2018,20,10672,650,5062,3207,0,194,19785
11/27/2018,21,10666,570,5176,3270,0,144,19826
11/27/2018,22,10671,402,4518,3285,0,104,18980
11/27/2018,23,10662,225,4211,3258,0,78,18434
11/27/2018,24,10667,210,3871,3001,0,27,17776
11/28/2018,1,10666,209,3165,2928,0,12,16980
11/28/2018,2,10667,209,3010,2951,0,11,16848
11/28/2018,3,10674,209,3030,2744,0,11,16668
11/28/2018,4,10687,209,2999,2811,0,12,16718
11/28/2018,5,10687,208,3101,2893,0,12,16901
11/28/2018,6,10690,208,3205,2909,0,12,17024
11/28/2018,7,10689,215,3707,3118,0,21,17750
11/28/2018,8,10688,215,4189,3298,0,28,18418
11/28/2018,9,10688,235,4655,3298,1,31,18908
11/28/2018,10,10684,241,4435,3345,5,32,18742
11/28/2018,11,10687,269,4574,3381,11,34,18956
11/28/2018,12,10687,361,4595,3160,16,45,18864
11/28/2018,13,10693,519,4533,3046,24,83,18898
11/28/2018,14,10686,780,4581,2959,28,84,19118
11/28/2018,15,10687,1019,4548,2836,23,79,19192
11/28/2018,16,10683,1082,4513,2715,9,79,19081
11/28/2018,17,10686,1104,4685,2609,1,80,19165
11/28/2018,18,10684,1105,5347,2649,0,80,19865
11/28/2018,19,10687,878,5143,2530,0,80,19318
11/28/2018,20,10686,821,5559,2139,0,80,19285
11/28/2018,21,10686,619,5743,1849,0,80,18977
11/28/2018,22,10684,379,5433,1629,0,78,18203
11/28/2018,23,10675,209,4932,1486,0,35,17337
11/28/2018,24,10685,208,4278,1487,0,17,16675
11/29/2018,1,10683,209,3971,1292,0,11,16166
11/29/2018,2,10685,207,3870,1219,0,9,15990
11/29/2018,3,10683,211,3626,1207,0,9,15736
11/29/2018,4,10684,211,3501,1067,0,7,15470
11/29/2018,5,10688,208,3487,1089,0,11,15483
11/29/2018,6,10689,279,3798,823,0,13,15602
11/29/2018,7,10696,373,4626,772,0,52,16519
11/29/2018,8,10694,654,5352,660,0,91,17451
11/29/2018,9,10695,787,5275,529,7,173,17466
11/29/2018,10,10697,797,5298,392,18,204,17406
11/29/2018,11,10694,745,5242,423,26,155,17285
11/29/2018,12,10696,866,5106,510,42,130,17350
11/29/2018,13,10691,1126,4894,545,58,83,17397
11/29/2018,14,10687,1524,5054,452,57,83,17857
11/29/2018,15,10692,1657,5364,320,29,83,18145
11/29/2018,16,10696,1726,5186,217,9,88,17922
11/29/2018,17,10698,2172,5385,212,1,170,18638
11/29/2018,18,10691,2331,5580,230,0,202,19034
11/29/2018,19,10685,2120,5530,328,0,185,18848
11/29/2018,20,10690,1943,5625,356,0,165,18779
11/29/2018,21,10687,1848,5478,346,0,90,18449
11/29/2018,22,10687,1353,5355,281,0,80,17756
11/29/2018,23,10677,530,5161,267,0,38,16673
11/29/2018,24,10679,234,4508,246,0,19,15686
11/30/2018,1,10687,214,4120,185,0,13,15219
11/30/2018,2,10689,205,4093,136,0,11,15134
11/30/2018,3,10704,217,4034,80,0,9,15044
11/30/2018,4,10708,272,4068,37,0,7,15092
11/30/2018,5,10716,497,3926,14,0,9,15162
11/30/2018,6,10710,848,4179,12,0,41,15790
11/30/2018,7,10716,1212,4575,29,0,75,16607
11/30/2018,8,10715,1244,5455,58,0,104,17576
11/30/2018,9,10715,1221,5552,53,5,180,17726
11/30/2018,10,10716,1158,5327,33,20,172,17426
11/30/2018,11,10715,1183,5287,14,31,189,17419
11/30/2018,12,10763,1423,5204,25,44,201,17660
11/30/2018,13,10766,1540,5088,14,35,201,17644
11/30/2018,14,10768,1519,5015,23,50,196,17571
11/30/2018,15,10765,1558,4892,29,55,148,17447
11/30/2018,16,10763,1623,5107,18,27,92,17630
11/30/2018,17,10736,1822,5481,14,2,163,18218
11/30/2018,18,10703,1924,5446,9,0,201,18283
11/30/2018,19,10707,1831,5452,9,0,183,18182
11/30/2018,20,10706,1673,5385,14,0,134,17912
11/30/2018,21,10704,1195,5519,37,0,151,17606
11/30/2018,22,10703,702,5197,84,0,158,16844
11/30/2018,23,10705,270,4877,137,0,101,16090
11/30/2018,24,10707,194,4300,168,0,79,15448
12/1/2018,1,10709,154,4110,188,0,70,15231
12/1/2018,2,10689,186,3594,134,0,58,14661
12/1/2018,3,10676,202,3735,132,0,18,14763
12/1/2018,4,10679,202,3815,165,0,0,14861
12/1/2018,5,10690,201,3803,318,0,0,15012
12/1/2018,6,10692,201,3990,529,0,0,15412
12/1/2018,7,10692,200,4056,819,0,0,15767
12/1/2018,8,10698,202,4094,1068,2,0,16064
12/1/2018,9,10699,202,4359,1329,25,0,16614
12/1/2018,10,10699,203,4206,1550,66,0,16724
12/1/2018,11,10694,285,4131,1640,99,0,16849
12/1/2018,12,10698,309,4641,1666,89,0,17403
12/1/2018,13,10554,377,4377,2074,76,0,17458
12/1/2018,14,10526,426,4087,2363,56,0,17458
12/1/2018,15,10494,460,4032,2470,30,0,17486
12/1/2018,16,10629,604,4022,2610,11,0,17876
12/1/2018,17,10691,616,4688,2483,0,0,18478
12/1/2018,18,10684,633,5085,2785,0,0,19187
12/1/2018,19,10686,617,4293,3153,0,0,18749
12/1/2018,20,10685,450,4131,3244,0,0,18510
12/1/2018,21,10681,280,4576,3259,0,0,18796
12/1/2018,22,10678,202,4434,3127,0,0,18441
12/1/2018,23,10677,202,3773,2965,0,0,17617
12/1/2018,24,10677,202,3170,2656,0,0,16705
12/2/2018,1,10680,203,3036,2331,0,0,16250
12/2/2018,2,10688,201,2872,2184,0,0,15945
12/2/2018,3,10686,201,2897,2027,0,0,15811
12/2/2018,4,10684,201,2860,1924,0,0,15669
12/2/2018,5,10686,202,2855,2075,0,0,15818
12/2/2018,6,10693,201,2928,2075,0,0,15897
12/2/2018,7,10698,200,2967,2459,0,0,16324
12/2/2018,8,10698,201,3194,2703,0,0,16796
12/2/2018,9,10700,202,3578,2997,4,0,17481
12/2/2018,10,10701,202,3702,3084,29,0,17718
12/2/2018,11,10703,202,3909,3115,54,0,17983
12/2/2018,12,10704,204,3868,3138,87,0,18001
12/2/2018,13,10709,292,4235,2846,84,1,18167
12/2/2018,14,10704,414,4367,2689,60,3,18237
12/2/2018,15,10709,537,4208,2530,110,0,18094
12/2/2018,16,10708,542,4355,2479,47,0,18131
12/2/2018,17,10712,549,4236,2757,1,0,18255
12/2/2018,18,10707,551,4695,2847,0,0,18800
12/2/2018,19,10716,583,5134,2745,0,0,19178
12/2/2018,20,10714,618,5509,2376,0,0,19217
12/2/2018,21,10710,411,5201,2146,0,0,18468
12/2/2018,22,10716,259,4431,2354,0,0,17760
12/2/2018,23,10712,259,3950,2498,0,0,17419
12/2/2018,24,10695,260,3406,2420,0,0,16781
12/3/2018,1,10687,259,3130,1873,0,1,15950
12/3/2018,2,10692,259,3090,1670,0,11,15722
12/3/2018,3,10708,260,3082,1503,0,13,15566
12/3/2018,4,10697,259,3056,1869,0,13,15894
12/3/2018,5,10704,257,3154,2101,0,13,16229
12/3/2018,6,10715,260,3247,2238,0,16,16476
12/3/2018,7,10714,260,3860,2313,0,27,17174
12/3/2018,8,10716,319,4648,2212,0,52,17947
12/3/2018,9,10720,345,4503,2040,3,65,17676
12/3/2018,10,10719,504,4326,2156,26,90,17821
12/3/2018,11,10715,789,4784,1800,35,105,18228
12/3/2018,12,10712,896,4864,1716,35,104,18327
12/3/2018,13,10711,857,4742,1856,33,106,18305
12/3/2018,14,10716,889,4576,1959,20,102,18262
12/3/2018,15,10721,1061,4936,1851,14,102,18685
12/3/2018,16,10727,1066,5186,1586,5,107,18677
12/3/2018,17,10723,1070,5279,1492,0,98,18662
12/3/2018,18,10719,1126,5577,1626,0,134,19182
12/3/2018,19,10734,1234,5508,1675,0,143,19294
12/3/2018,20,10734,1210,5401,1592,0,89,19026
12/3/2018,21,10734,764,5661,1555,0,95,18809
12/3/2018,22,10723,540,5611,1509,0,97,18480
12/3/2018,23,10729,330,5246,1588,0,58,17951
12/3/2018,24,10722,248,4660,1527,0,30,17187
12/4/2018,1,10727,214,4178,1569,0,19,16707
12/4/2018,2,10731,214,3772,1539,0,15,16271
12/4/2018,3,10733,226,3756,1367,0,16,16098
12/4/2018,4,10726,278,3745,1293,0,16,16058
12/4/2018,5,10729,296,3404,1378,0,18,15825
12/4/2018,6,10728,416,3617,1003,0,23,15787
12/4/2018,7,10727,679,4368,879,0,27,16680
12/4/2018,8,10729,1174,5080,747,1,35,17766
12/4/2018,9,10729,1321,5165,602,12,47,17876
12/4/2018,10,10751,1316,5127,485,58,85,17822
12/4/2018,11,10783,1317,5072,372,70,90,17704
12/4/2018,12,10785,1361,4998,316,154,90,17704
12/4/2018,13,10789,1408,4818,322,219,86,17642
12/4/2018,14,10786,1494,4737,343,218,90,17668
12/4/2018,15,10785,1570,4262,276,163,90,17146
12/4/2018,16,10769,1685,4604,218,78,90,17444
12/4/2018,17,10723,2028,5462,159,9,90,18471
12/4/2018,18,10727,2151,5822,146,0,119,18965
12/4/2018,19,10731,2245,5800,187,0,190,19153
12/4/2018,20,10732,2182,5820,208,0,197,19139
12/4/2018,21,10724,1933,5794,219,0,197,18867
12/4/2018,22,10718,1756,5564,221,0,190,18449
12/4/2018,23,10722,927,5292,193,0,157,17291
12/4/2018,24,10720,297,5078,143,0,105,16343
12/5/2018,1,10727,214,4647,128,0,115,15831
12/5/2018,2,10728,220,4596,163,0,63,15770
12/5/2018,3,10719,243,4389,162,0,49,15562
12/5/2018,4,10733,250,4300,136,0,58,15477
12/5/2018,5,10738,324,4720,181,0,54,16017
12/5/2018,6,10737,693,4322,239,0,71,16062
12/5/2018,7,10737,1083,5065,247,0,122,17254
12/5/2018,8,10734,1691,5441,228,0,193,18287
12/5/2018,9,10733,1974,5228,277,13,206,18431
12/5/2018,10,10733,1808,5220,260,46,212,18279
12/5/2018,11,10730,1424,5145,255,74,224,17852
12/5/2018,12,10732,1198,5017,335,99,180,17561
12/5/2018,13,10708,1373,4827,480,85,166,17639
12/5/2018,14,10447,1896,5051,557,57,121,18129
12/5/2018,15,10705,1937,4969,684,35,142,18472
12/5/2018,16,10721,1916,4984,717,15,137,18490
12/5/2018,17,10730,2156,5443,852,2,139,19322
12/5/2018,18,10733,2295,5563,1275,0,200,20066
12/5/2018,19,10734,1886,5337,2007,0,145,20109
12/5/2018,20,10737,1916,5076,2400,0,107,20236
12/5/2018,21,10739,1649,4632,2758,0,109,19887
12/5/2018,22,10732,811,4773,2844,0,114,19274
12/5/2018,23,10738,321,4366,2753,0,84,18262
12/5/2018,24,10739,243,3462,2856,0,64,17364
12/6/2018,1,10735,212,3113,3000,0,49,17109
12/6/2018,2,10728,213,3312,2836,0,50,17139
12/6/2018,3,10728,221,3101,2970,0,53,17073
12/6/2018,4,10732,221,2977,3027,0,49,17006
12/6/2018,5,10735,248,2952,2918,0,53,16906
12/6/2018,6,10748,401,3145,2903,0,46,17243
12/6/2018,7,10757,411,3573,3234,0,44,18019
12/6/2018,8,10760,492,4155,3449,0,43,18899
12/6/2018,9,10762,499,4474,3296,18,39,19088
12/6/2018,10,10758,595,4490,3034,48,36,18961
12/6/2018,11,10757,768,4527,2871,54,41,19018
12/6/2018,12,10756,904,4585,2827,60,45,19177
12/6/2018,13,10758,953,4808,2721,47,68,19355
12/6/2018,14,10755,1239,4962,2502,30,116,19604
12/6/2018,15,10755,1972,5007,2208,18,178,20138
12/6/2018,16,10755,1779,4376,2438,12,139,19499
12/6/2018,17,10759,2064,4760,2338,2,98,20021
12/6/2018,18,10756,2091,5019,2617,0,94,20577
12/6/2018,19,10755,2086,4820,2602,0,93,20356
12/6/2018,20,10751,1598,4776,2604,0,94,19823
12/6/2018,21,10755,1215,4912,2600,0,89,19571
12/6/2018,22,10753,616,4588,2484,0,84,18525
12/6/2018,23,10753,292,4212,2255,0,82,17594
12/6/2018,24,10758,269,3721,2082,0,28,16858
12/7/2018,1,10757,269,3397,2169,0,12,16604
12/7/2018,2,10753,267,3743,1853,0,12,16628
12/7/2018,3,10754,271,3741,1698,0,12,16476
12/7/2018,4,10752,293,3697,1460,0,13,16215
12/7/2018,5,10757,509,4035,1227,0,14,16542
12/7/2018,6,10760,1237,3632,1011,0,27,16667
12/7/2018,7,10765,1723,4139,886,0,78,17591
12/7/2018,8,10759,2087,5053,741,0,133,18773
12/7/2018,9,10760,2123,5180,576,10,170,18819
12/7/2018,10,10758,2156,5208,451,37,176,18786
12/7/2018,11,10758,1919,5005,353,79,168,18282
12/7/2018,12,10756,1720,4933,224,146,118,17897
12/7/2018,13,10760,2074,4957,182,179,158,18310
12/7/2018,14,10757,2331,4891,230,133,170,18512
12/7/2018,15,10764,2474,5129,339,105,161,18972
12/7/2018,16,10764,2420,5206,381,40,131,18942
12/7/2018,17,10443,3724,5535,501,3,190,20396
12/7/2018,18,10338,3833,5657,568,0,153,20549
12/7/2018,19,10341,3877,5748,677,0,193,20836
12/7/2018,20,10341,3345,5725,897,0,178,20486
12/7/2018,21,10335,2469,5494,1060,0,145,19503
12/7/2018,22,10346,2089,4711,1269,0,111,18526
12/7/2018,23,10340,1322,4328,1652,0,43,17685
12/7/2018,24,10336,933,3515,1753,0,17,16554
12/8/2018,1,10336,398,3792,1906,0,7,16439
12/8/2018,2,10335,264,3959,1857,0,0,16415
12/8/2018,3,10335,266,3494,2317,0,0,16412
12/8/2018,4,10337,276,3404,2363,0,0,16380
12/8/2018,5,10346,358,3861,2362,0,0,16927
12/8/2018,6,10355,584,3972,2073,0,0,16984
12/8/2018,7,10361,811,4337,1819,0,0,17328
12/8/2018,8,10363,1118,4589,1677,0,0,17747
12/8/2018,9,10364,1432,4803,1937,15,15,18566
12/8/2018,10,10417,1279,4710,1886,39,51,18382
12/8/2018,11,10417,1301,4911,1680,69,59,18437
12/8/2018,12,10421,1500,4744,1454,109,95,18323
12/8/2018,13,10410,1597,4597,1262,129,63,18058
12/8/2018,14,10407,1847,4698,999,98,56,18105
12/8/2018,15,10411,1816,5041,814,64,57,18203
12/8/2018,16,10409,1695,4688,803,46,57,17698
12/8/2018,17,10430,1906,5560,753,5,64,18718
12/8/2018,18,10422,2632,5755,723,0,135,19667
12/8/2018,19,10453,2349,5673,746,0,132,19353
12/8/2018,20,10457,2404,5750,747,0,120,19478
12/8/2018,21,10455,1756,5225,754,0,67,18257
12/8/2018,22,10460,1539,4866,810,0,105,17780
12/8/2018,23,10458,1246,4106,919,0,80,16809
12/8/2018,24,10449,565,3862,965,0,51,15892
12/9/2018,1,10432,383,3895,941,0,56,15707
12/9/2018,2,10449,265,3975,985,0,52,15726
12/9/2018,3,10451,264,3996,1031,0,10,15752
12/9/2018,4,10457,264,3674,1107,0,0,15502
12/9/2018,5,10459,264,3730,1162,0,0,15615
12/9/2018,6,10457,263,3776,1227,0,2,15725
12/9/2018,7,10459,267,3822,1299,0,3,15850
12/9/2018,8,10459,276,4357,1339,0,0,16431
12/9/2018,9,10459,350,4893,1382,14,3,17101
12/9/2018,10,10456,586,4587,1552,48,19,17248
12/9/2018,11,10450,805,4146,1693,84,51,17229
12/9/2018,12,10452,915,4156,1731,141,51,17446
12/9/2018,13,10449,923,4704,1550,154,51,17831
12/9/2018,14,10445,1086,4645,1390,145,86,17797
12/9/2018,15,10446,1226,4382,1195,125,65,17439
12/9/2018,16,10440,1459,4219,1006,60,60,17244
12/9/2018,17,10491,2074,4961,736,8,63,18333
12/9/2018,18,10572,2493,5448,572,0,111,19196
12/9/2018,19,10594,2705,5359,540,0,128,19326
12/9/2018,20,10592,2143,5218,680,0,102,18735
12/9/2018,21,10587,1868,4707,865,0,57,18084
12/9/2018,22,10504,1514,4788,653,0,56,17515
12/9/2018,23,9818,1605,4805,443,0,56,16727
12/9/2018,24,9751,1600,4371,229,0,56,16007
12/10/2018,1,9755,1165,4088,154,0,56,15218
12/10/2018,2,9754,903,3995,111,0,57,14820
12/10/2018,3,9755,1198,4070,119,0,65,15207
12/10/2018,4,9755,1317,4015,154,0,67,15308
12/10/2018,5,9756,1638,3585,141,0,67,15187
12/10/2018,6,9753,1989,3636,181,0,71,15630
12/10/2018,7,9755,2598,4178,195,0,77,16803
12/10/2018,8,9754,3698,4891,277,0,136,18756
12/10/2018,9,9755,3744,4825,370,19,147,18860
12/10/2018,10,9753,3199,4793,391,50,100,18286
12/10/2018,11,9750,3144,4745,347,106,82,18174
12/10/2018,12,9754,3191,4193,400,91,82,17711
12/10/2018,13,9840,3257,4073,367,120,82,17739
12/10/2018,14,9839,3604,4303,377,62,112,18297
12/10/2018,15,9844,3154,4540,402,35,83,18058
12/10/2018,16,9844,3117,4843,494,19,93,18410
12/10/2018,17,9859,3357,5343,570,1,134,19264
12/10/2018,18,9854,4309,5305,532,0,134,20134
12/10/2018,19,9856,4087,5320,557,0,81,19901
12/10/2018,20,9854,3893,5230,722,0,89,19788
12/10/2018,21,9855,3256,5063,1020,0,89,19283
12/10/2018,22,9852,2571,4557,1399,0,87,18466
12/10/2018,23,9848,2436,3802,1581,0,86,17753
12/10/2018,24,9841,2343,3443,1023,0,74,16724
12/11/2018,1,9838,1152,3506,1692,0,21,16209
12/11/2018,2,9835,324,3559,2391,0,12,16121
12/11/2018,3,9840,275,3675,2393,0,12,16195
12/11/2018,4,9830,320,3354,2517,0,12,16033
12/11/2018,5,9832,543,3345,2228,0,12,15960
12/11/2018,6,9843,867,3667,2205,0,15,16597
12/11/2018,7,9945,1426,3855,2684,0,20,17930
12/11/2018,8,9956,1890,4720,2713,0,26,19305
12/11/2018,9,9954,2476,4999,2325,1,26,19781
12/11/2018,10,9950,2879,5081,2067,4,26,20007
12/11/2018,11,9947,2857,4925,1906,7,26,19668
12/11/2018,12,9948,2852,4695,1756,8,40,19299
12/11/2018,13,9946,2641,4766,1418,7,83,18861
12/11/2018,14,9946,2787,4756,1210,7,108,18814
12/11/2018,15,9945,2791,4669,1106,7,164,18682
12/11/2018,16,9942,2994,4831,1089,2,165,19023
12/11/2018,17,9935,3658,5255,946,0,175,19969
12/11/2018,18,9936,4097,5220,830,0,161,20244
12/11/2018,19,9943,4165,5222,912,0,123,20365
12/11/2018,20,9938,3985,5236,906,0,158,20223
12/11/2018,21,9939,3653,5140,779,0,179,19690
12/11/2018,22,9940,3503,4796,631,0,178,19048
12/11/2018,23,9939,2189,4469,567,0,121,17285
12/11/2018,24,9943,1216,4194,465,0,40,15858
12/12/2018,1,9936,982,4418,363,0,13,15712
12/12/2018,2,9933,865,4224,365,0,12,15399
12/12/2018,3,9927,968,4176,316,0,12,15399
12/12/2018,4,9927,1104,4173,297,0,15,15516
12/12/2018,5,9930,1421,4092,357,0,19,15819
12/12/2018,6,9934,1798,3801,228,0,26,15787
12/12/2018,7,9936,2502,4475,275,0,28,17216
12/12/2018,8,9929,3355,4813,553,0,32,18682
12/12/2018,9,9931,3106,4707,1016,4,30,18794
12/12/2018,10,9960,2604,4776,1149,19,28,18536
12/12/2018,11,9975,2543,4508,1277,45,32,18380
12/12/2018,12,9976,2476,4369,1503,48,30,18402
12/12/2018,13,9973,2037,3907,1983,57,28,17985
12/12/2018,14,9829,1848,3678,2192,63,30,17640
12/12/2018,15,9766,2076,4000,2189,35,28,18094
12/12/2018,16,9909,2230,4035,2509,16,27,18726
12/12/2018,17,9916,2431,4580,2726,2,28,19683
12/12/2018,18,9915,2955,4737,2796,0,30,20433
12/12/2018,19,9906,2723,4692,2889,0,31,20241
12/12/2018,20,9901,2420,4845,2862,0,29,20057
12/12/2018,21,9899,2426,4711,2613,0,28,19677
12/12/2018,22,9895,2206,4253,2429,0,27,18810
12/12/2018,23,9892,1724,3977,2005,0,27,17625
12/12/2018,24,9898,729,4050,1681,0,15,16373
12/13/2018,1,9895,618,4083,1563,0,12,16171
12/13/2018,2,9909,573,4004,1604,0,12,16102
12/13/2018,3,9904,631,3755,1504,0,12,15806
12/13/2018,4,9905,785,4090,1174,0,13,15967
12/13/2018,5,9910,889,4098,965,0,13,15875
12/13/2018,6,9910,1421,4403,686,0,33,16453
12/13/2018,7,9909,2454,4547,513,0,91,17514
12/13/2018,8,9878,3528,4874,419,1,191,18891
12/13/2018,9,9830,3557,4846,411,5,206,18855
12/13/2018,10,9833,3381,4888,353,27,204,18686
12/13/2018,11,9831,3777,4684,216,48,207,18763
12/13/2018,12,9831,3688,4461,176,107,208,18471
12/13/2018,13,9828,3458,4403,170,109,156,18124
12/13/2018,14,9892,3289,4345,174,63,174,17937
12/13/2018,15,9907,3479,4439,166,31,187,18209
12/13/2018,16,9909,4033,4362,208,31,205,18748
12/13/2018,17,9898,4642,4604,263,4,156,19567
12/13/2018,18,9898,4443,4844,359,0,148,19692
12/13/2018,19,9899,4247,4905,450,0,191,19692
12/13/2018,20,9904,4209,4777,594,0,203,19687
12/13/2018,21,9902,3490,4865,798,0,203,19258
12/13/2018,22,9899,2411,4467,942,0,176,17895
12/13/2018,23,9880,1459,4068,1061,0,94,16562
12/13/2018,24,9877,660,3906,1251,0,32,15726
12/14/2018,1,9882,323,3869,1497,0,13,15584
12/14/2018,2,9889,297,3928,1277,0,13,15404
12/14/2018,3,9895,404,4017,1260,0,13,15589
12/14/2018,4,9883,658,3915,1094,0,13,15563
12/14/2018,5,9880,1084,3767,1145,0,13,15889
12/14/2018,6,9884,1504,3405,936,0,15,15744
12/14/2018,7,9880,1763,3791,935,0,20,16389
12/14/2018,8,9882,1898,4601,939,0,27,17347
12/14/2018,9,9878,2032,4828,963,3,27,17731
12/14/2018,10,9880,2235,4875,738,16,27,17771
12/14/2018,11,9879,2932,5043,637,26,27,18544
12/14/2018,12,9876,3059,5000,779,41,27,18782
12/14/2018,13,9877,2415,4738,731,82,27,17870
12/14/2018,14,9873,2326,4917,541,56,27,17740
12/14/2018,15,9877,2036,4855,564,38,27,17397
12/14/2018,16,9872,1921,5003,589,17,27,17429
12/14/2018,17,9872,1963,5160,720,3,27,17745
12/14/2018,18,9872,1876,5174,806,0,27,17755
12/14/2018,19,9877,1596,5512,717,0,26,17728
12/14/2018,20,9877,1884,5419,520,0,27,17727
12/14/2018,21,9877,2034,4884,394,0,27,17216
12/14/2018,22,9870,1537,4826,520,0,26,16779
12/14/2018,23,9872,824,4351,708,0,27,15782
12/14/2018,24,9856,344,4022,709,0,14,14945
12/15/2018,1,9855,266,4058,457,0,2,14638
12/15/2018,2,9852,310,4221,373,0,0,14756
12/15/2018,3,9824,278,3990,303,0,0,14395
12/15/2018,4,9830,267,3938,304,0,0,14339
12/15/2018,5,9855,266,3690,441,0,0,14252
12/15/2018,6,9854,266,3364,935,0,0,14419
12/15/2018,7,9865,267,3534,945,0,0,14611
12/15/2018,8,9871,267,3693,1243,0,0,15074
12/15/2018,9,9871,265,4370,1474,9,0,15989
12/15/2018,10,9869,277,4687,1397,41,0,16271
12/15/2018,11,9866,349,5002,1105,75,0,16397
12/15/2018,12,9864,411,4960,1095,100,0,16430
12/15/2018,13,9864,368,4836,953,118,0,16139
12/15/2018,14,9860,564,5039,854,108,0,16425
12/15/2018,15,9858,697,5053,934,63,0,16605
12/15/2018,16,9846,857,4526,1264,26,0,16519
12/15/2018,17,9843,860,4743,1509,0,0,16955
12/15/2018,18,9840,860,5105,1878,0,0,17683
12/15/2018,19,9824,866,5010,2078,0,0,17778
12/15/2018,20,9819,866,4609,2131,0,0,17425
12/15/2018,21,9823,867,4686,2215,0,0,17591
12/15/2018,22,9815,703,4726,2110,0,0,17354
12/15/2018,23,9824,677,4147,2060,0,0,16708
12/15/2018,24,9839,353,3900,2097,0,0,16189
12/16/2018,1,9840,268,3648,1897,0,0,15653
12/16/2018,2,9846,268,3644,1771,0,0,15529
12/16/2018,3,9841,267,3437,1836,0,1,15382
12/16/2018,4,9847,257,4032,1370,0,0,15506
12/16/2018,5,9841,307,3804,1300,0,0,15252
12/16/2018,6,9845,254,3423,1426,0,0,14948
12/16/2018,7,9870,241,3677,1395,0,0,15183
12/16/2018,8,9870,305,4255,1130,0,0,15560
12/16/2018,9,9871,384,5098,1056,10,0,16419
12/16/2018,10,9867,585,5047,734,72,0,16305
12/16/2018,11,9862,894,4972,625,100,0,16453
12/16/2018,12,9863,935,4855,431,131,0,16215
12/16/2018,13,9864,961,4825,330,144,0,16124
12/16/2018,14,9874,1077,4920,260,145,0,16276
12/16/2018,15,9818,1168,4917,264,124,0,16291
12/16/2018,16,9875,1321,4708,273,53,0,16230
12/16/2018,17,9881,1525,5100,312,6,0,16824
12/16/2018,18,9880,1679,5626,526,0,0,17711
12/16/2018,19,9879,1827,5443,800,0,0,17949
12/16/2018,20,9877,1715,5204,1305,0,0,18101
12/16/2018,21,9881,921,4619,1565,0,1,16987
12/16/2018,22,9887,316,4230,2024,0,1,16458
12/16/2018,23,9882,261,3768,2034,0,0,15945
12/16/2018,24,9882,260,3245,2204,0,0,15591
12/17/2018,1,9881,261,3119,2307,0,2,15570
12/17/2018,2,9896,259,3156,2383,0,18,15712
12/17/2018,3,9904,261,3403,2370,0,23,15961
12/17/2018,4,9903,261,3140,2665,0,22,15991
12/17/2018,5,9910,262,2962,2821,0,25,15980
12/17/2018,6,9906,262,3124,2772,0,19,16083
12/17/2018,7,9912,265,3694,2850,0,22,16743
12/17/2018,8,9906,268,4171,2879,0,27,17251
12/17/2018,9,9904,343,4723,2955,23,27,17975
12/17/2018,10,9910,410,5166,2848,46,27,18407
12/17/2018,11,9905,817,5201,3025,20,27,18995
12/17/2018,12,9904,967,4987,2851,23,18,18750
12/17/2018,13,9913,1308,4726,2690,27,25,18689
12/17/2018,14,9924,1332,4505,2713,34,27,18535
12/17/2018,15,9928,1462,4576,2847,28,27,18868
12/17/2018,16,9932,1509,4178,2850,14,27,18510
12/17/2018,17,9931,1622,4463,2635,5,27,18683
12/17/2018,18,9937,1640,4753,2751,4,27,19112
12/17/2018,19,9938,1639,4288,2772,4,27,18668
12/17/2018,20,9936,1636,4450,2679,4,27,18732
12/17/2018,21,9934,1317,4864,2539,4,27,18685
12/17/2018,22,9933,994,4852,2212,4,27,18022
12/17/2018,23,9923,439,4390,2145,4,27,16928
12/17/2018,24,9927,290,4204,1969,4,17,16411
12/18/2018,1,9908,273,3758,1913,4,11,15867
12/18/2018,2,9907,272,3518,1971,4,9,15681
12/18/2018,3,9907,274,3529,1770,4,8,15492
12/18/2018,4,9918,425,3643,1439,4,7,15436
12/18/2018,5,9927,937,3409,1102,4,7,15386
12/18/2018,6,9926,1199,3708,929,4,11,15777
12/18/2018,7,9931,1776,4557,710,4,20,16998
12/18/2018,8,9933,2295,4920,580,4,27,17759
12/18/2018,9,9932,2411,4885,414,31,27,17700
12/18/2018,10,9927,1844,4612,337,105,27,16852
12/18/2018,11,9894,1801,4523,247,206,27,16698
12/18/2018,12,9918,1899,4282,228,301,27,16655
12/18/2018,13,9935,2123,4126,225,294,29,16732
12/18/2018,14,9692,2229,4260,238,266,35,16720
12/18/2018,15,9804,1971,4339,246,193,30,16583
12/18/2018,16,9944,2091,4643,331,94,40,17143
12/18/2018,17,9949,2296,5301,431,11,36,18024
12/18/2018,18,9956,2751,5518,653,0,25,18903
12/18/2018,19,9957,2800,5637,723,0,26,19143
12/18/2018,20,9960,2702,5441,858,0,27,18988
12/18/2018,21,9960,2195,5251,1141,0,27,18574
12/18/2018,22,9959,1813,4932,1370,0,27,18101
12/18/2018,23,9956,1039,4359,1697,0,27,17078
12/18/2018,24,9943,447,3641,1869,0,19,15919
12/19/2018,1,9943,260,3379,2109,0,12,15703
12/19/2018,2,9940,262,3209,2226,0,7,15644
12/19/2018,3,9936,269,3110,2307,0,6,15628
12/19/2018,4,9941,352,3136,2263,0,7,15699
12/19/2018,5,9959,637,3163,2054,0,7,15820
12/19/2018,6,9982,1166,3190,2082,0,47,16467
12/19/2018,7,9985,1278,3932,2050,0,61,17306
12/19/2018,8,9989,1305,4821,2320,0,66,18501
12/19/2018,9,9991,1405,4924,2257,24,58,18659
12/19/2018,10,9989,1439,4694,2036,80,51,18289
12/19/2018,11,9986,1457,4789,1810,123,42,18207
12/19/2018,12,9976,1718,4606,1728,165,42,18235
12/19/2018,13,9973,1851,3902,1743,158,41,17668
12/19/2018,14,9840,2012,4120,1651,150,42,17815
12/19/2018,15,9807,1629,4142,1587,94,46,17305
12/19/2018,16,9816,1312,4410,1529,61,46,17174
12/19/2018,17,9930,1539,4954,1634,9,42,18108
12/19/2018,18,9972,1538,5248,1940,0,46,18744
12/19/2018,19,9649,1580,5008,2373,0,38,18648
12/19/2018,20,9608,1366,5062,2558,0,27,18621
12/19/2018,21,9691,919,5062,2778,0,27,18477
12/19/2018,22,9729,673,4829,2760,0,26,18017
12/19/2018,23,9724,464,3937,2788,0,27,16940
12/19/2018,24,9733,441,3265,2671,0,17,16127
12/20/2018,1,9767,438,3209,2546,0,12,15972
12/20/2018,2,9775,311,3171,2273,0,11,15541
12/20/2018,3,9774,260,3525,2045,0,11,15615
12/20/2018,4,9781,349,3850,1764,0,11,15755
12/20/2018,5,9771,362,3752,1632,0,13,15530
12/20/2018,6,9771,654,3832,1527,0,17,15801
12/20/2018,7,9773,1166,4600,1343,0,19,16901
12/20/2018,8,9774,1399,5283,1360,1,25,17842
12/20/2018,9,9773,1303,4992,1393,17,26,17504
12/20/2018,10,9774,1340,4524,1327,33,25,17023
12/20/2018,11,9777,1463,5220,918,47,26,17451
12/20/2018,12,9777,1824,4919,664,42,25,17251
12/20/2018,13,9778,1936,4694,475,41,26,16950
12/20/2018,14,9782,2162,4694,409,40,27,17114
12/20/2018,15,9779,2003,4630,325,29,26,16792
12/20/2018,16,9775,1985,4856,375,10,26,17027
12/20/2018,17,9769,2080,5219,543,1,27,17639
12/20/2018,18,9771,2226,5816,681,0,27,18521
12/20/2018,19,9778,2146,5716,802,0,27,18469
12/20/2018,20,9783,1752,5420,1185,0,27,18167
12/20/2018,21,9780,1091,5440,1516,0,27,17854
12/20/2018,22,9782,848,5375,1282,0,27,17314
12/20/2018,23,9776,454,4664,1258,0,27,16179
12/20/2018,24,9783,282,3969,1384,0,17,15435
12/21/2018,1,9777,265,3520,1811,0,13,15386
12/21/2018,2,9774,257,3271,2079,0,11,15392
12/21/2018,3,9778,259,3048,2055,0,10,15150
12/21/2018,4,9782,259,3102,1908,0,10,15061
12/21/2018,5,9788,256,3069,2150,0,12,15275
12/21/2018,6,9780,254,3210,2219,0,16,15479
12/21/2018,7,9786,256,3650,2291,0,20,16003
12/21/2018,8,9782,267,4892,2255,0,27,17223
12/21/2018,9,9781,256,5252,2185,2,27,17503
12/21/2018,10,9779,260,5405,2062,10,27,17543
12/21/2018,11,9780,283,5081,2184,24,27,17379
12/21/2018,12,9781,228,4750,2356,29,27,17171
12/21/2018,13,9777,215,4173,2697,27,27,16916
12/21/2018,14,9777,233,3956,2817,16,27,16826
12/21/2018,15,9815,259,4209,3009,15,27,17334
12/21/2018,16,9969,260,4039,2872,6,27,17173
12/21/2018,17,9965,259,4819,2956,1,27,18027
12/21/2018,18,9965,260,5515,3076,0,27,18843
12/21/2018,19,9968,260,5417,3188,0,26,18859
12/21/2018,20,9968,282,5319,2924,0,25,18518
12/21/2018,21,9966,293,5186,2981,0,26,18452
12/21/2018,22,9964,260,4130,3109,0,26,17489
12/21/2018,23,9960,260,3961,3018,0,26,17225
12/21/2018,24,9951,259,3687,2907,0,17,16821
12/22/2018,1,9963,260,3183,2710,0,9,16125
12/22/2018,2,9957,259,3052,2342,0,3,15613
12/22/2018,3,9951,258,2950,2259,0,0,15418
12/22/2018,4,9941,256,2948,2207,0,0,15352
12/22/2018,5,9937,263,2963,2149,0,0,15312
12/22/2018,6,9948,262,3177,2362,0,0,15749
12/22/2018,7,10046,305,3731,2567,0,0,16649
12/22/2018,8,10166,357,4312,2493,0,0,17328
12/22/2018,9,10161,495,4709,2360,1,0,17726
12/22/2018,10,10160,836,5068,2273,6,0,18343
12/22/2018,11,10160,1067,5057,2080,15,0,18379
12/22/2018,12,10259,1077,4600,1919,17,0,17872
12/22/2018,13,10158,1187,4730,1835,13,0,17923
12/22/2018,14,10370,1252,4581,1893,14,0,18110
12/22/2018,15,10474,1616,4285,1834,11,0,18220
12/22/2018,16,10451,1651,4372,1577,4,0,18055
12/22/2018,17,10492,1659,5038,1224,0,0,18413
12/22/2018,18,10503,1678,5916,908,0,0,19005
12/22/2018,19,10508,1715,5938,672,0,0,18833
12/22/2018,20,10512,1211,5820,525,0,0,18068
12/22/2018,21,10507,720,5817,449,0,0,17493
12/22/2018,22,10510,575,5132,416,0,0,16633
12/22/2018,23,10483,403,4637,406,0,0,15929
12/22/2018,24,10508,368,4184,401,0,0,15461
12/23/2018,1,10513,293,4013,442,0,0,15261
12/23/2018,2,10513,262,3840,390,0,0,15005
12/23/2018,3,10515,263,3898,255,0,0,14931
12/23/2018,4,10520,263,3930,217,0,0,14930
12/23/2018,5,10519,264,3864,210,0,0,14857
12/23/2018,6,10569,267,3794,294,0,0,14924
12/23/2018,7,10703,269,3625,369,0,5,14971
12/23/2018,8,10717,338,4009,358,0,5,15427
12/23/2018,9,10719,380,4415,328,1,0,15843
12/23/2018,10,10716,625,4797,367,18,0,16523
12/23/2018,11,10740,886,5078,400,33,0,17137
12/23/2018,12,10726,1489,5183,412,46,0,17856
12/23/2018,13,10720,1518,4883,355,56,0,17532
12/23/2018,14,10721,1638,4673,285,51,0,17368
12/23/2018,15,10723,1654,4539,307,31,0,17254
12/23/2018,16,10708,1662,4168,332,5,0,16875
12/23/2018,17,10704,1667,4562,263,0,0,17196
12/23/2018,18,10715,1806,5200,313,0,0,18034
12/23/2018,19,10746,1490,5558,441,0,0,18235
12/23/2018,20,10776,791,5689,570,0,0,17826
12/23/2018,21,10773,649,5325,828,0,0,17575
12/23/2018,22,10765,515,4771,917,0,0,16968
12/23/2018,23,10768,291,4642,1120,0,0,16821
12/23/2018,24,10764,266,4397,1095,0,0,16522
12/24/2018,1,10775,280,3995,1189,0,0,16239
12/24/2018,2,10774,265,3448,1267,0,0,15754
12/24/2018,3,10784,266,3347,1405,0,9,15811
12/24/2018,4,10796,266,3260,1482,0,12,15816
12/24/2018,5,10804,265,3177,1555,0,12,15813
12/24/2018,6,10802,265,3280,1751,0,14,16112
12/24/2018,7,10817,264,3353,1626,0,24,16084
12/24/2018,8,10803,265,3672,1969,0,27,16736
12/24/2018,9,10807,270,3692,2066,1,27,16863
12/24/2018,10,10815,359,4475,2072,12,27,17760
12/24/2018,11,10803,467,4598,2291,46,27,18232
12/24/2018,12,10802,463,4179,2463,45,27,17979
12/24/2018,13,10805,690,4115,2509,48,27,18194
12/24/2018,14,10807,916,4178,2429,53,28,18411
12/24/2018,15,10810,1037,4378,2111,48,27,18411
12/24/2018,16,10775,1116,4117,2039,27,31,18105
12/24/2018,17,10829,1111,4585,1489,4,30,18048
12/24/2018,18,10871,1095,4880,1536,0,27,18409
12/24/2018,19,10870,1091,5030,1299,0,27,18317
12/24/2018,20,10868,1090,4946,1177,0,27,18108
12/24/2018,21,10866,1085,4643,972,0,27,17593
12/24/2018,22,10864,953,4685,802,0,26,17330
12/24/2018,23,10864,384,4710,660,0,27,16645
12/24/2018,24,10855,270,4725,522,0,13,16385
12/25/2018,1,10853,267,4092,430,0,1,15643
12/25/2018,2,10854,267,3703,354,0,0,15178
12/25/2018,3,10859,267,3640,285,0,0,15051
12/25/2018,4,10860,266,3658,233,0,0,15017
12/25/2018,5,10865,267,3698,200,0,0,15030
12/25/2018,6,10873,267,3554,154,0,0,14848
12/25/2018,7,10951,268,3892,124,0,0,15235
12/25/2018,8,10985,267,3965,141,1,0,15359
12/25/2018,9,11018,277,4300,149,5,0,15749
12/25/2018,10,11026,274,4502,97,26,0,15925
12/25/2018,11,11030,265,4403,83,61,0,15842
12/25/2018,12,11031,264,4398,133,70,0,15896
12/25/2018,13,11015,264,4136,269,78,0,15762
12/25/2018,14,11029,264,4353,350,84,0,16080
12/25/2018,15,11023,294,4946,348,45,0,16656
12/25/2018,16,11027,272,4710,337,15,0,16361
12/25/2018,17,11029,287,5206,285,1,0,16808
12/25/2018,18,11032,281,5089,234,0,0,16636
12/25/2018,19,11016,267,5085,180,0,0,16548
12/25/2018,20,11006,266,5380,178,0,0,16830
12/25/2018,21,11002,333,5292,160,0,0,16787
12/25/2018,22,11022,275,4843,182,0,0,16322
12/25/2018,23,11022,265,4590,195,0,0,16072
12/25/2018,24,11017,270,4052,182,0,0,15521
12/26/2018,1,11013,262,3749,218,0,0,15242
12/26/2018,2,11020,264,3567,291,0,2,15144
12/26/2018,3,11013,264,3469,310,0,1,15057
12/26/2018,4,11011,265,3319,331,0,0,14926
12/26/2018,5,10997,265,3460,342,0,0,15064
12/26/2018,6,10997,264,3591,357,0,0,15209
12/26/2018,7,11011,264,3751,344,0,0,15370
12/26/2018,8,11013,266,4110,429,0,0,15818
12/26/2018,9,11008,359,4482,463,4,0,16316
12/26/2018,10,11007,388,4534,488,22,0,16439
12/26/2018,11,10998,493,4604,337,34,4,16470
12/26/2018,12,10999,488,4259,310,73,9,16138
12/26/2018,13,11001,462,4034,331,102,10,15940
12/26/2018,14,10995,514,4480,353,90,14,16446
12/26/2018,15,10995,656,4959,293,66,17,16986
12/26/2018,16,10999,670,4779,296,28,13,16785
12/26/2018,17,10995,665,4976,286,1,1,16924
12/26/2018,18,10993,667,5666,284,0,0,17610
12/26/2018,19,10997,687,5621,333,0,0,17638
12/26/2018,20,11000,677,5518,424,0,0,17619
12/26/2018,21,11004,512,5295,345,0,0,17156
12/26/2018,22,10992,459,4670,459,0,0,16580
12/26/2018,23,10991,458,4191,736,0,0,16376
12/26/2018,24,10983,298,3773,1027,0,0,16081
12/27/2018,1,10997,266,3368,1398,0,2,16031
12/27/2018,2,10995,264,3028,1621,0,11,15919
12/27/2018,3,10998,266,2922,1806,0,11,16003
12/27/2018,4,10999,266,2898,1656,0,11,15830
12/27/2018,5,11002,266,2858,1958,0,13,16097
12/27/2018,6,10995,267,2840,2382,0,15,16499
12/27/2018,7,11004,267,3138,2459,0,20,16888
12/27/2018,8,11004,267,3854,3285,1,27,18438
12/27/2018,9,11002,267,4314,3347,12,27,18969
12/27/2018,10,11027,266,4469,3295,49,27,19133
12/27/2018,11,11089,267,4543,3188,42,27,19156
12/27/2018,12,11142,267,4621,3147,48,27,19252
12/27/2018,13,11140,268,3986,3259,53,27,18733
12/27/2018,14,11135,267,4138,3447,54,27,19068
12/27/2018,15,11124,267,4118,3542,26,27,19104
12/27/2018,16,11111,268,4152,3716,8,27,19282
12/27/2018,17,11120,269,4412,3722,1,27,19551
12/27/2018,18,11122,269,5384,3743,0,27,20545
12/27/2018,19,11130,267,5246,3723,0,28,20394
12/27/2018,20,11127,263,5125,3611,0,28,20154
12/27/2018,21,11129,264,4841,3677,0,28,19939
12/27/2018,22,11159,265,4359,3647,0,28,19458
12/27/2018,23,11167,264,3500,3527,0,27,18485
12/27/2018,24,11168,237,3222,3075,0,19,17721
12/28/2018,1,11171,242,2941,2661,0,11,17026
12/28/2018,2,11188,260,2951,1996,0,10,16405
12/28/2018,3,11192,262,2954,1701,0,10,16119
12/28/2018,4,11198,262,2867,1598,0,11,15936
12/28/2018,5,11201,262,2937,1453,0,11,15864
12/28/2018,6,11197,261,3093,1588,0,14,16153
12/28/2018,7,11201,261,3208,2103,0,20,16793
12/28/2018,8,11205,259,3463,3052,0,27,18006
12/28/2018,9,11203,260,3644,3149,1,27,18284
12/28/2018,10,11206,261,3578,3333,11,26,18415
12/28/2018,11,11199,334,3847,3473,21,26,18900
12/28/2018,12,11202,365,3881,3684,21,26,19179
12/28/2018,13,11219,365,3785,3368,23,27,18787
12/28/2018,14,11221,367,3795,3622,32,27,19064
12/28/2018,15,11228,368,3808,3514,35,26,18979
12/28/2018,16,11240,408,3741,3044,38,25,18496
12/28/2018,17,11237,475,3950,2798,6,26,18492
12/28/2018,18,11229,480,4195,3415,0,27,19346
12/28/2018,19,11230,484,4116,3710,0,27,19567
12/28/2018,20,11230,484,4073,3725,0,27,19539
12/28/2018,21,11232,487,3956,3546,0,27,19248
12/28/2018,22,11231,483,3333,3768,0,27,18842
12/28/2018,23,11229,353,3175,2715,0,27,17499
12/28/2018,24,11237,236,3062,2472,0,17,17024
12/29/2018,1,11222,234,2977,1947,0,15,16395
12/29/2018,2,11211,234,2937,1603,0,2,15987
12/29/2018,3,11213,234,2955,1332,0,0,15734
12/29/2018,4,11216,234,3046,1045,0,1,15542
12/29/2018,5,11206,235,3021,1246,0,1,15709
12/29/2018,6,11202,235,3081,1275,0,3,15796
12/29/2018,7,11217,235,3243,1380,0,7,16082
12/29/2018,8,11213,235,3919,1386,0,11,16764
12/29/2018,9,11219,240,4348,1194,1,10,17012
12/29/2018,10,11228,265,4641,991,11,9,17145
12/29/2018,11,11226,315,4802,866,20,2,17231
12/29/2018,12,11227,363,4817,646,28,0,17081
12/29/2018,13,11220,445,4980,478,50,0,17173
12/29/2018,14,11226,506,5085,387,73,0,17277
12/29/2018,15,11156,718,4932,226,85,0,17117
12/29/2018,16,11221,960,4577,145,48,0,16951
12/29/2018,17,11227,986,4835,150,5,0,17203
12/29/2018,18,11231,987,5492,204,0,0,17914
12/29/2018,19,11253,994,5440,282,0,0,17969
12/29/2018,20,11245,996,5680,235,0,0,18156
12/29/2018,21,11248,839,5631,202,0,0,17920
12/29/2018,22,11235,677,5142,185,0,0,17239
12/29/2018,23,11236,471,4912,184,0,3,16806
12/29/2018,24,11011,260,4528,340,0,1,16140
12/30/2018,1,10813,282,4552,429,0,0,16076
12/30/2018,2,10815,232,4278,588,0,0,15913
12/30/2018,3,10808,238,4293,676,0,0,16015
12/30/2018,4,10808,174,3947,941,0,0,15870
12/30/2018,5,10807,168,3841,1220,0,0,16036
12/30/2018,6,10815,167,3488,1298,0,0,15768
12/30/2018,7,10815,168,3770,1484,0,0,16237
12/30/2018,8,10817,168,4005,1647,0,0,16637
12/30/2018,9,10818,169,3930,1731,2,0,16650
12/30/2018,10,10823,169,4503,1548,9,0,17052
12/30/2018,11,10822,177,4741,1679,39,0,17458
12/30/2018,12,10818,193,4679,1814,63,0,17567
12/30/2018,13,10817,191,4321,2030,63,0,17422
12/30/2018,14,10817,208,3979,2436,66,0,17506
12/30/2018,15,10823,227,3748,2486,62,1,17347
12/30/2018,16,10826,314,3918,2133,45,1,17237
12/30/2018,17,10822,359,4446,1663,13,0,17303
12/30/2018,18,10820,367,5187,1733,0,0,18107
12/30/2018,19,10823,369,4959,1959,0,0,18110
12/30/2018,20,10821,393,4804,2177,0,0,18195
12/30/2018,21,10827,398,4814,2115,0,0,18154
12/30/2018,22,10824,398,4744,1961,0,0,17927
12/30/2018,23,10819,287,4649,1697,0,0,17452
12/30/2018,24,10826,231,4398,1314,0,0,16769
12/31/2018,1,10822,246,3805,1256,0,4,16133
12/31/2018,2,10816,233,3516,1287,0,10,15862
12/31/2018,3,10813,231,3326,1041,0,9,15420
12/31/2018,4,10819,229,3686,692,0,10,15436
12/31/2018,5,10972,238,3852,561,0,11,15634
12/31/2018,6,11168,230,3513,511,0,14,15436
12/31/2018,7,11192,231,3690,707,0,22,15842
12/31/2018,8,11191,232,4143,944,0,27,16537
12/31/2018,9,11197,232,4465,1287,4,27,17212
12/31/2018,10,11194,230,4666,1471,19,27,17607
12/31/2018,11,11196,230,4798,1508,31,27,17790
12/31/2018,12,11194,231,4708,1446,54,27,17660
12/31/2018,13,11195,230,4188,1537,54,27,17231
12/31/2018,14,11196,229,4042,1711,37,27,17242
12/31/2018,15,11201,226,4315,1820,17,27,17606
12/31/2018,16,11202,217,4824,1685,4,27,17959
12/31/2018,17,11202,217,4570,2090,0,27,18106
12/31/2018,18,11202,227,4575,2381,0,27,18412
12/31/2018,19,11205,228,4585,2218,0,27,18263
12/31/2018,20,11200,229,4094,2303,0,27,17853
12/31/2018,21,11188,230,3710,2581,0,27,17736
12/31/2018,22,11187,232,3482,2299,0,27,17227
12/31/2018,23,11212,233,3254,2506,0,27,17232
12/31/2018,24,11219,232,3136,1897,0,16,16500
