Date,Hour,NUCLEAR,GAS,HYDRO,WIND,SOLAR,BIOFUEL,Total Output
1/1/2019,1,11215,232,3320,1302,0,10,16079
1/1/2019,2,11221,233,3274,1146,0,10,15884
1/1/2019,3,11205,233,3222,992,0,10,15662
1/1/2019,4,11205,234,3205,876,0,10,15530
1/1/2019,5,11214,233,3218,883,0,10,15558
1/1/2019,6,11208,234,3220,975,0,10,15647
1/1/2019,7,11209,237,3651,639,0,10,15746
1/1/2019,8,11214,238,3774,857,0,10,16093
1/1/2019,9,11209,296,3765,699,2,10,15981
1/1/2019,10,11207,317,3780,932,20,11,16267
1/1/2019,11,11218,381,3536,1449,34,11,16629
1/1/2019,12,11219,423,3466,1107,76,13,16304
1/1/2019,13,11215,564,3552,876,116,13,16336
1/1/2019,14,11219,703,3669,670,142,10,16413
1/1/2019,15,11225,710,3744,894,90,10,16673
1/1/2019,16,11222,740,4218,574,41,10,16805
1/1/2019,17,11228,790,4832,970,4,10,17834
1/1/2019,18,11232,1041,5800,745,0,10,18828
1/1/2019,19,11232,1127,5943,503,0,10,18815
1/1/2019,20,11231,1146,6012,345,0,10,18744
1/1/2019,21,11224,1186,5785,316,0,10,18521
1/1/2019,22,11229,721,5294,407,0,10,17661
1/1/2019,23,11234,616,4322,352,0,10,16534
1/1/2019,24,11228,408,4262,216,0,10,16124
1/2/2019,1,11235,250,4217,132,0,10,15844
1/2/2019,2,11244,237,3994,195,0,10,15680
1/2/2019,3,11236,247,4035,192,0,6,15716
1/2/2019,4,11242,325,3762,182,0,4,15515
1/2/2019,5,11243,521,3489,191,0,4,15448
1/2/2019,6,11245,855,3288,183,0,5,15576
1/2/2019,7,11243,1119,3501,275,0,10,16148
1/2/2019,8,11242,1238,4237,428,0,23,17168
1/2/2019,9,11242,1296,4948,513,19,27,18045
1/2/2019,10,11241,1422,5016,546,67,28,18320
1/2/2019,11,11240,1438,5203,622,123,27,18653
1/2/2019,12,11235,1442,5058,667,125,27,18554
1/2/2019,13,11232,1476,5091,788,125,28,18740
1/2/2019,14,11228,1517,4716,795,77,27,18360
1/2/2019,15,11224,1312,4804,960,41,29,18370
1/2/2019,16,11221,1470,4980,984,18,51,18724
1/2/2019,17,11223,1512,5093,1104,1,91,19024
1/2/2019,18,11220,1551,5682,1288,0,159,19900
1/2/2019,19,11227,1566,5637,1405,0,126,19961
1/2/2019,20,11219,1397,5822,1267,0,99,19804
1/2/2019,21,11207,1082,5562,1400,0,180,19431
1/2/2019,22,11219,993,5272,1490,0,188,19162
1/2/2019,23,11214,408,4510,2376,0,111,18619
1/2/2019,24,11222,260,3240,2809,0,29,17560
1/3/2019,1,11218,263,2969,2770,0,12,17232
1/3/2019,2,11215,264,3003,2673,0,9,17164
1/3/2019,3,11206,263,2921,2719,0,10,17119
1/3/2019,4,11202,264,2964,2370,0,10,16810
1/3/2019,5,11205,264,3009,2324,0,11,16813
1/3/2019,6,11198,267,3015,2085,0,14,16579
1/3/2019,7,11209,311,3456,2091,0,21,17088
1/3/2019,8,11203,446,4199,2237,0,26,18111
1/3/2019,9,11216,473,5104,1873,0,27,18693
1/3/2019,10,11228,593,5425,1743,7,27,19023
1/3/2019,11,11229,583,4881,1939,17,27,18676
1/3/2019,12,11240,535,4136,2300,34,28,18273
1/3/2019,13,11236,508,3741,2905,54,27,18471
1/3/2019,14,11225,480,4204,2946,44,28,18927
1/3/2019,15,11218,494,4455,2867,46,27,19107
1/3/2019,16,11232,630,4737,2820,22,27,19468
1/3/2019,17,11232,634,5063,2779,6,27,19741
1/3/2019,18,11235,635,5442,2846,0,33,20191
1/3/2019,19,11237,637,4956,3114,0,29,19973
1/3/2019,20,11239,637,5033,3072,0,27,20008
1/3/2019,21,11224,637,4476,3434,0,27,19798
1/3/2019,22,11230,463,4044,3208,0,27,18972
1/3/2019,23,11234,282,3538,2953,0,27,18034
1/3/2019,24,11218,235,3338,2840,0,16,17647
1/4/2019,1,11211,233,3036,3050,0,10,17540
1/4/2019,2,11219,234,3024,2442,0,10,16929
1/4/2019,3,11224,233,2988,2181,0,10,16636
1/4/2019,4,11227,239,2987,2128,0,10,16591
1/4/2019,5,11212,258,3005,1448,0,10,15933
1/4/2019,6,11210,265,3088,2015,0,14,16592
1/4/2019,7,11211,316,3454,1978,0,20,16979
1/4/2019,8,11211,453,3692,2764,0,28,18148
1/4/2019,9,11215,456,3860,2655,6,27,18219
1/4/2019,10,11212,507,3889,2763,65,28,18464
1/4/2019,11,11210,574,3994,2532,148,27,18485
1/4/2019,12,11213,716,3727,2157,182,28,18023
1/4/2019,13,11207,872,3832,1817,198,27,17953
1/4/2019,14,11208,936,4092,1561,200,27,18024
1/4/2019,15,11214,1075,3930,1216,167,27,17629
1/4/2019,16,11204,1103,4408,795,105,27,17642
1/4/2019,17,11200,1193,4777,959,20,28,18177
1/4/2019,18,11198,1236,5618,902,0,28,18982
1/4/2019,19,11205,1230,5464,958,0,31,18888
1/4/2019,20,11206,1066,5366,870,0,27,18535
1/4/2019,21,11202,881,5765,523,0,28,18399
1/4/2019,22,11204,537,5616,269,0,27,17653
1/4/2019,23,11196,464,4905,213,0,27,16805
1/4/2019,24,11195,258,4429,331,0,19,16232
1/5/2019,1,11194,230,3807,684,0,7,15922
1/5/2019,2,11190,231,3124,851,0,0,15396
1/5/2019,3,11186,230,3177,944,0,0,15537
1/5/2019,4,11174,177,3205,762,0,10,15328
1/5/2019,5,11174,174,3238,857,0,16,15459
1/5/2019,6,11178,174,3419,780,0,18,15569
1/5/2019,7,11185,168,3668,771,0,6,15798
1/5/2019,8,11186,168,4276,662,0,4,16296
1/5/2019,9,11180,146,4945,383,15,0,16669
1/5/2019,10,11177,110,4855,286,38,0,16466
1/5/2019,11,11183,111,5205,141,72,0,16712
1/5/2019,12,11180,179,5457,107,87,0,17010
1/5/2019,13,11185,157,5033,145,104,0,16624
1/5/2019,14,11182,107,4888,392,105,0,16674
1/5/2019,15,11186,107,4884,580,86,0,16843
1/5/2019,16,11194,108,4682,1107,46,0,17137
1/5/2019,17,11198,109,4150,1478,10,0,16945
1/5/2019,18,11198,161,4500,2277,0,0,18136
1/5/2019,19,11195,165,4613,2450,0,0,18423
1/5/2019,20,11199,166,4529,2600,0,0,18494
1/5/2019,21,11190,167,3969,2729,0,0,18055
1/5/2019,22,11183,174,3573,2920,0,0,17850
1/5/2019,23,11186,196,3224,2292,0,0,16898
1/5/2019,24,11170,195,3246,1928,0,0,16539
1/6/2019,1,11171,193,3134,1849,0,0,16347
1/6/2019,2,11184,194,3062,1598,0,0,16038
1/6/2019,3,11179,194,3024,1249,0,0,15646
1/6/2019,4,11185,194,3076,1063,0,0,15518
1/6/2019,5,11176,195,3045,1285,0,0,15701
1/6/2019,6,11178,194,3056,1450,0,0,15878
1/6/2019,7,11175,197,3246,1449,0,0,16067
1/6/2019,8,11178,204,3454,1658,0,0,16494
1/6/2019,9,11177,207,3531,1752,11,0,16678
1/6/2019,10,11179,223,3667,1850,48,0,16967
1/6/2019,11,11217,291,3628,1566,173,0,16875
1/6/2019,12,11174,325,3759,1121,188,0,16567
1/6/2019,13,11173,385,3884,1571,148,0,17161
1/6/2019,14,11174,400,4039,1411,132,0,17156
1/6/2019,15,11171,428,4694,1316,147,0,17756
1/6/2019,16,11136,428,4625,1312,63,0,17564
1/6/2019,17,11153,431,5039,1186,11,0,17820
1/6/2019,18,11179,485,5550,1089,0,0,18303
1/6/2019,19,11159,484,5735,1121,0,0,18499
1/6/2019,20,11153,421,5726,1095,0,0,18395
1/6/2019,21,11145,426,5732,1022,0,0,18325
1/6/2019,22,11147,432,5353,1035,0,0,17967
1/6/2019,23,11148,234,4801,1136,0,0,17319
1/6/2019,24,11158,201,4193,1240,0,0,16792
1/7/2019,1,11157,201,3796,1523,0,2,16679
1/7/2019,2,11163,199,3181,1846,0,11,16400
1/7/2019,3,11163,201,3021,1952,0,10,16347
1/7/2019,4,11165,200,3126,1636,0,10,16137
1/7/2019,5,11164,201,3046,2152,0,11,16574
1/7/2019,6,11162,202,3162,2448,0,13,16987
1/7/2019,7,11171,202,3778,3176,0,2,18329
1/7/2019,8,11170,205,4851,3350,0,0,19576
1/7/2019,9,11166,207,4960,3389,8,0,19730
1/7/2019,10,11165,214,5143,3478,24,0,20024
1/7/2019,11,11167,250,5447,3365,34,0,20263
1/7/2019,12,11160,269,5582,3354,34,0,20399
1/7/2019,13,11154,338,5029,3478,39,0,20038
1/7/2019,14,11142,360,4829,3417,45,0,19793
1/7/2019,15,11162,372,4770,3390,30,0,19724
1/7/2019,16,11168,403,5089,3513,9,0,20182
1/7/2019,17,11174,532,5183,3350,1,0,20240
1/7/2019,18,11174,567,5563,3707,0,0,21011
1/7/2019,19,11174,571,4777,3764,0,0,20286
1/7/2019,20,11171,536,5055,3742,0,3,20507
1/7/2019,21,11177,497,4572,3662,0,21,19929
1/7/2019,22,11170,492,4484,3537,0,26,19709
1/7/2019,23,11167,264,3751,3606,0,26,18814
1/7/2019,24,11169,233,3137,3199,0,16,17754
1/8/2019,1,11167,233,3021,2893,0,12,17326
1/8/2019,2,11183,231,3001,2690,0,12,17117
1/8/2019,3,11191,230,3026,2344,0,12,16803
1/8/2019,4,11188,239,3075,2266,0,13,16781
1/8/2019,5,11196,240,3156,2123,0,15,16730
1/8/2019,6,11196,249,3670,1616,0,15,16746
1/8/2019,7,11199,305,4584,993,0,20,17101
1/8/2019,8,11200,496,5831,650,0,30,18207
1/8/2019,9,11205,910,4807,669,9,34,17634
1/8/2019,10,11205,971,4229,637,42,26,17110
1/8/2019,11,11069,781,5167,521,35,32,17605
1/8/2019,12,11034,934,4975,691,47,29,17710
1/8/2019,13,11041,890,4286,1151,50,27,17445
1/8/2019,14,11127,894,4672,1275,39,27,18034
1/8/2019,15,11193,915,4723,1179,30,26,18066
1/8/2019,16,11201,993,4778,1213,8,26,18219
1/8/2019,17,11196,891,5370,1271,1,27,18756
1/8/2019,18,11206,670,5551,1481,0,25,18933
1/8/2019,19,11211,663,4882,2106,0,26,18888
1/8/2019,20,11215,664,4609,2693,0,26,19207
1/8/2019,21,11210,658,4404,2999,0,27,19298
1/8/2019,22,11205,522,3846,2946,0,26,18545
1/8/2019,23,11197,432,3378,2901,0,26,17934
1/8/2019,24,11195,277,3196,2617,0,16,17301
1/9/2019,1,11195,243,3103,2017,0,13,16571
1/9/2019,2,11195,241,3160,1706,0,13,16315
1/9/2019,3,11191,240,3159,1568,0,14,16172
1/9/2019,4,11202,241,3091,1742,0,13,16289
1/9/2019,5,11203,241,3173,1713,0,14,16344
1/9/2019,6,11211,240,3244,1854,0,16,16565
1/9/2019,7,11211,241,3515,2225,0,39,17231
1/9/2019,8,11213,242,3758,2891,0,80,18184
1/9/2019,9,11210,258,3780,3392,0,92,18732
1/9/2019,10,11215,260,3866,3439,7,127,18914
1/9/2019,11,11206,252,3741,3685,17,174,19075
1/9/2019,12,11206,338,3716,3702,28,212,19202
1/9/2019,13,11208,406,3683,3514,40,202,19053
1/9/2019,14,11075,494,3709,3519,45,193,19035
1/9/2019,15,11040,465,3932,3432,39,193,19101
1/9/2019,16,11114,469,4134,3513,19,187,19436
1/9/2019,17,11197,467,4489,3541,6,131,19831
1/9/2019,18,11203,466,4827,3878,0,91,20465
1/9/2019,19,11200,467,4725,3939,0,40,20371
1/9/2019,20,11203,464,4832,4031,0,26,20556
1/9/2019,21,11198,331,4832,4037,0,26,20424
1/9/2019,22,11189,239,4465,3989,0,26,19908
1/9/2019,23,11183,239,3690,3815,0,26,18953
1/9/2019,24,11190,240,3393,3344,0,17,18184
1/10/2019,1,11192,241,3309,2907,0,13,17662
1/10/2019,2,11189,239,3373,2467,0,13,17281
1/10/2019,3,11188,239,3374,2374,0,13,17188
1/10/2019,4,11188,237,3368,2877,0,13,17683
1/10/2019,5,11192,236,3326,3017,0,12,17783
1/10/2019,6,11193,237,3604,2868,0,17,17919
1/10/2019,7,11189,240,3820,3440,0,1,18690
1/10/2019,8,11186,242,4830,3543,0,18,19819
1/10/2019,9,11186,256,5133,3398,11,26,20010
1/10/2019,10,11184,331,4678,3305,58,27,19583
1/10/2019,11,11177,453,4754,3143,98,12,19637
1/10/2019,12,11180,679,4474,2932,173,27,19465
1/10/2019,13,11182,856,4266,2912,191,27,19434
1/10/2019,14,11177,985,4141,2798,174,27,19302
1/10/2019,15,11181,1110,4215,2758,170,27,19461
1/10/2019,16,11178,1347,4736,2657,81,27,20026
1/10/2019,17,11181,1382,5105,2696,13,27,20404
1/10/2019,18,11178,1605,5878,2450,0,27,21138
1/10/2019,19,11177,1547,5953,2428,0,27,21132
1/10/2019,20,11176,1382,5967,2108,0,27,20660
1/10/2019,21,11170,1399,5947,1811,0,27,20354
1/10/2019,22,11160,970,5758,1567,0,27,19482
1/10/2019,23,11163,644,5165,1396,0,27,18395
1/10/2019,24,11178,565,4868,1257,0,19,17887
1/11/2019,1,11180,367,4734,1268,0,15,17564
1/11/2019,2,11167,315,4736,1007,0,14,17239
1/11/2019,3,11173,319,5178,744,0,15,17429
1/11/2019,4,11166,354,5177,606,0,15,17318
1/11/2019,5,11168,489,4524,531,0,16,16728
1/11/2019,6,11178,976,4573,531,0,37,17295
1/11/2019,7,11187,1292,5288,437,0,83,18287
1/11/2019,8,11183,1966,5636,378,0,153,19316
1/11/2019,9,11185,2228,5131,276,35,159,19014
1/11/2019,10,11183,2256,5143,146,107,89,18924
1/11/2019,11,11178,1919,5187,76,229,83,18672
1/11/2019,12,11182,1652,5136,30,250,87,18337
1/11/2019,13,11186,1529,5053,11,266,87,18132
1/11/2019,14,11189,1597,4978,6,272,87,18129
1/11/2019,15,11192,1615,4913,18,229,87,18054
1/11/2019,16,11194,1789,5100,60,120,87,18350
1/11/2019,17,11188,2086,5733,91,26,87,19211
1/11/2019,18,11187,3069,5691,96,0,108,20151
1/11/2019,19,11184,2927,5814,142,0,97,20164
1/11/2019,20,11186,2523,5810,159,0,87,19765
1/11/2019,21,11179,2290,5544,176,0,87,19276
1/11/2019,22,11136,2061,5323,165,0,84,18769
1/11/2019,23,10993,1968,4848,122,0,48,17979
1/11/2019,24,10982,1463,4225,109,0,17,16796
1/12/2019,1,11001,1057,4228,103,0,4,16393
1/12/2019,2,11007,629,4097,129,0,0,15862
1/12/2019,3,10998,352,4075,161,0,0,15586
1/12/2019,4,11002,321,4170,225,0,0,15718
1/12/2019,5,10999,326,3798,220,0,0,15343
1/12/2019,6,11009,399,4301,255,0,0,15964
1/12/2019,7,11004,482,4093,298,0,0,15877
1/12/2019,8,11005,540,5117,383,0,0,17045
1/12/2019,9,11009,696,5008,499,19,0,17231
1/12/2019,10,11008,758,4824,607,65,0,17262
1/12/2019,11,11005,798,4772,780,123,1,17479
1/12/2019,12,11006,965,4875,802,151,1,17800
1/12/2019,13,11006,1180,4778,845,150,0,17959
1/12/2019,14,11007,1287,4599,929,136,0,17958
1/12/2019,15,11006,1317,4809,976,103,0,18211
1/12/2019,16,11010,1341,4426,1113,43,0,17933
1/12/2019,17,11006,1491,4655,1133,7,0,18292
1/12/2019,18,11008,1637,5620,1057,0,0,19322
1/12/2019,19,11009,1533,5517,1154,0,0,19213
1/12/2019,20,11005,1293,5230,1272,0,0,18800
1/12/2019,21,11000,670,5362,1300,0,0,18332
1/12/2019,22,10995,628,5022,1422,0,15,18082
1/12/2019,23,11002,666,4280,1524,0,11,17483
1/12/2019,24,11001,347,3940,1657,0,11,16956
1/13/2019,1,11003,308,3731,1736,0,10,16788
1/13/2019,2,11004,309,3607,1847,0,10,16777
1/13/2019,3,11009,311,3538,1797,0,11,16666
1/13/2019,4,11008,310,3670,1710,0,0,16698
1/13/2019,5,11007,314,3386,1888,0,0,16595
1/13/2019,6,11008,319,3191,1990,0,0,16508
1/13/2019,7,11025,321,3471,1888,0,0,16705
1/13/2019,8,11021,324,4103,1857,0,0,17305
1/13/2019,9,11018,403,4512,2065,36,0,18034
1/13/2019,10,11016,410,4330,1951,136,0,17843
1/13/2019,11,11020,589,4401,1753,248,0,18011
1/13/2019,12,11017,858,4273,1527,296,0,17971
1/13/2019,13,11019,1033,4622,1160,314,0,18148
1/13/2019,14,11020,1227,4676,945,308,0,18176
1/13/2019,15,10974,1343,4216,950,259,0,17742
1/13/2019,16,11015,1413,4407,1032,145,0,18012
1/13/2019,17,11011,1631,5184,1033,35,0,18894
1/13/2019,18,11012,2200,5793,1030,0,0,20035
1/13/2019,19,11024,2325,5722,1125,0,0,20196
1/13/2019,20,11020,2200,5718,1101,0,0,20039
1/13/2019,21,11017,2053,5612,995,0,0,19677
1/13/2019,22,11014,1828,5384,748,0,0,18974
1/13/2019,23,11015,1365,4855,558,0,0,17793
1/13/2019,24,11008,910,4229,495,0,0,16642
1/14/2019,1,10988,573,4101,435,0,0,16097
1/14/2019,2,11007,520,3989,470,0,2,15988
1/14/2019,3,11018,427,3974,415,0,11,15845
1/14/2019,4,11015,700,4444,251,0,10,16420
1/14/2019,5,11012,1283,3887,244,0,9,16435
1/14/2019,6,11135,1633,4165,215,0,13,17161
1/14/2019,7,11234,1870,4740,198,0,18,18060
1/14/2019,8,11237,2358,5195,204,0,27,19021
1/14/2019,9,11237,2550,5154,212,35,27,19215
1/14/2019,10,11237,2143,5109,167,125,27,18808
1/14/2019,11,11236,2120,4993,116,194,28,18687
1/14/2019,12,11236,2408,4727,76,242,28,18717
1/14/2019,13,11240,2030,4602,107,253,28,18260
1/14/2019,14,11246,2048,4768,141,248,30,18481
1/14/2019,15,11245,2086,4481,222,217,27,18278
1/14/2019,16,11243,2051,4545,341,116,27,18323
1/14/2019,17,11245,2141,5079,430,31,27,18953
1/14/2019,18,11239,2726,5748,516,0,27,20256
1/14/2019,19,11242,3172,5478,719,0,27,20638
1/14/2019,20,11245,2766,5454,964,0,27,20456
1/14/2019,21,11243,2879,5031,1023,0,27,20203
1/14/2019,22,11239,2729,4854,1139,0,27,19988
1/14/2019,23,11237,2108,4011,854,0,27,18237
1/14/2019,24,11231,1168,4007,675,0,20,17101
1/15/2019,1,11231,406,4102,628,0,15,16382
1/15/2019,2,11219,357,4153,648,0,12,16389
1/15/2019,3,11225,359,4290,611,0,11,16496
1/15/2019,4,11228,370,4086,623,0,11,16318
1/15/2019,5,11236,452,3714,638,0,12,16052
1/15/2019,6,11241,692,3688,742,0,14,16377
1/15/2019,7,11243,1223,3877,799,0,20,17162
1/15/2019,8,11241,1369,4929,846,0,27,18412
1/15/2019,9,11244,1521,5147,932,4,27,18875
1/15/2019,10,11235,1645,5264,914,20,27,19105
1/15/2019,11,11236,1802,5034,996,39,27,19134
1/15/2019,12,11237,1713,4904,1254,49,26,19183
1/15/2019,13,11235,1482,4564,1528,32,26,18867
1/15/2019,14,11232,1258,4521,1844,32,26,18913
1/15/2019,15,11226,1186,4402,2011,22,27,18874
1/15/2019,16,11231,980,4644,2076,8,27,18966
1/15/2019,17,11239,978,4795,2341,0,26,19379
1/15/2019,18,11234,894,4949,2607,0,26,19710
1/15/2019,19,11239,891,4813,2931,0,27,19901
1/15/2019,20,11239,730,4854,3165,0,25,20013
1/15/2019,21,11237,699,4359,3410,0,26,19731
1/15/2019,22,11226,539,3669,3481,0,27,18942
1/15/2019,23,11234,349,3249,3606,0,27,18465
1/15/2019,24,11234,327,3033,3015,0,21,17630
1/16/2019,1,11236,329,3049,2745,0,15,17374
1/16/2019,2,11235,328,3051,2424,0,11,17049
1/16/2019,3,11234,329,3069,2535,0,10,17177
1/16/2019,4,11234,329,2978,2546,0,10,17097
1/16/2019,5,11241,331,3031,2677,0,11,17291
1/16/2019,6,11240,333,3188,2640,0,14,17415
1/16/2019,7,11234,343,3557,2769,0,17,17920
1/16/2019,8,11232,354,4476,2998,0,26,19086
1/16/2019,9,11238,457,4547,2979,8,26,19255
1/16/2019,10,11255,405,4552,2836,36,26,19110
1/16/2019,11,11278,759,4669,2412,64,26,19208
1/16/2019,12,11278,904,3938,2503,128,27,18778
1/16/2019,13,11270,985,3619,2457,258,27,18616
1/16/2019,14,11116,989,3665,2520,246,29,18565
1/16/2019,15,11110,1138,3631,2075,204,31,18189
1/16/2019,16,11115,1429,3830,1749,126,29,18278
1/16/2019,17,11113,1993,4603,1608,31,27,19375
1/16/2019,18,11181,2405,5650,1313,0,27,20576
1/16/2019,19,11294,2687,5720,985,0,26,20712
1/16/2019,20,11292,2852,5726,715,0,26,20611
1/16/2019,21,11294,2997,5447,476,0,26,20240
1/16/2019,22,11289,2869,4937,371,0,26,19492
1/16/2019,23,11156,2133,4451,339,0,27,18106
1/16/2019,24,10584,1744,4270,312,0,18,16928
1/17/2019,1,10560,1183,3937,303,0,14,15997
1/17/2019,2,10574,1019,4050,278,0,16,15937
1/17/2019,3,10577,1132,4183,356,0,12,16260
1/17/2019,4,10438,1014,4009,407,0,15,15883
1/17/2019,5,10418,1211,4090,453,0,16,16188
1/17/2019,6,10419,1452,3932,569,0,18,16390
1/17/2019,7,10417,1892,4627,878,0,50,17864
1/17/2019,8,10427,2649,5229,1233,0,98,19636
1/17/2019,9,10418,3019,5040,1355,26,129,19987
1/17/2019,10,10411,2513,4979,1376,82,97,19458
1/17/2019,11,10412,2156,4534,1404,136,80,18722
1/17/2019,12,10418,2111,4757,1285,178,83,18832
1/17/2019,13,10418,2281,4818,1051,141,83,18792
1/17/2019,14,10426,2566,4738,955,119,82,18886
1/17/2019,15,10419,2655,4853,1079,76,82,19164
1/17/2019,16,10422,2631,4789,1182,38,83,19145
1/17/2019,17,10422,3509,5270,1019,10,107,20337
1/17/2019,18,10425,3769,5850,793,0,121,20958
1/17/2019,19,10427,3827,5747,840,0,140,20981
1/17/2019,20,10427,3299,5812,933,0,112,20583
1/17/2019,21,10420,3678,5458,810,0,43,20409
1/17/2019,22,10421,3473,4999,647,0,27,19567
1/17/2019,23,10411,3241,4176,619,0,26,18473
1/17/2019,24,10425,1793,3965,445,0,18,16646
1/18/2019,1,10422,1519,4074,381,0,15,16411
1/18/2019,2,10424,876,4134,420,0,14,15868
1/18/2019,3,10430,890,4154,512,0,16,16002
1/18/2019,4,10423,904,3866,747,0,14,15954
1/18/2019,5,10414,954,3534,1123,0,16,16041
1/18/2019,6,10416,1131,3423,1189,0,40,16199
1/18/2019,7,10410,1668,4598,1176,0,76,17928
1/18/2019,8,10411,2237,5624,1080,0,132,19484
1/18/2019,9,10408,2413,5567,1159,0,134,19681
1/18/2019,10,10406,2337,5384,1186,3,120,19436
1/18/2019,11,10408,1946,5251,1384,10,102,19101
1/18/2019,12,10404,1880,5256,1457,14,89,19100
1/18/2019,13,10407,1980,5166,1438,19,78,19088
1/18/2019,14,10409,2055,5022,1442,18,83,19029
1/18/2019,15,10409,2009,4779,1883,16,83,19179
1/18/2019,16,10407,2100,4914,1645,13,83,19162
1/18/2019,17,10412,1790,5210,1531,5,83,19031
1/18/2019,18,10413,1835,5840,1373,0,87,19548
1/18/2019,19,10414,1973,5998,1363,0,93,19841
1/18/2019,20,10409,2048,5778,1210,0,85,19530
1/18/2019,21,10413,1991,5435,1060,0,83,18982
1/18/2019,22,10408,1851,5029,833,0,49,18170
1/18/2019,23,10401,1535,4347,895,0,26,17204
1/18/2019,24,10407,1083,4220,1039,0,13,16762
1/19/2019,1,10401,906,4394,988,0,0,16689
1/19/2019,2,10399,787,4341,970,0,0,16497
1/19/2019,3,10398,823,4118,1368,0,0,16707
1/19/2019,4,10399,722,3739,1581,0,0,16441
1/19/2019,5,10404,706,4335,1287,0,0,16732
1/19/2019,6,10401,1030,4763,1161,0,0,17355
1/19/2019,7,10407,860,4537,1385,0,1,17190
1/19/2019,8,10404,918,4543,1848,0,19,17732
1/19/2019,9,10402,971,4943,2260,1,53,18630
1/19/2019,10,10399,1448,5622,2383,7,82,19941
1/19/2019,11,10401,2237,5391,2487,18,159,20693
1/19/2019,12,10401,2662,5102,2304,26,152,20647
1/19/2019,13,10398,2797,5112,2106,33,129,20575
1/19/2019,14,10397,3046,4998,1912,43,130,20526
1/19/2019,15,10391,2852,4958,2303,39,103,20646
1/19/2019,16,10340,2426,4994,2829,23,60,20672
1/19/2019,17,10080,2872,5309,2967,5,84,21317
1/19/2019,18,10077,3254,5762,3040,0,109,22242
1/19/2019,19,10077,3254,5831,2986,0,99,22247
1/19/2019,20,10076,2701,5814,3285,0,87,21963
1/19/2019,21,10067,2499,5743,3297,0,55,21661
1/19/2019,22,10072,2095,5175,3320,0,14,20676
1/19/2019,23,10071,1380,4806,3307,0,0,19564
1/19/2019,24,10073,1104,4268,3392,0,0,18837
1/20/2019,1,10075,811,3973,3476,0,0,18335
1/20/2019,2,10074,691,3846,3584,0,0,18195
1/20/2019,3,10071,703,3862,3713,0,0,18349
1/20/2019,4,10059,788,3851,3757,0,0,18455
1/20/2019,5,10064,950,3693,3764,0,0,18471
1/20/2019,6,10083,1160,3509,3783,0,0,18535
1/20/2019,7,10085,1395,3775,3715,0,0,18970
1/20/2019,8,10091,1564,4146,3639,0,0,19440
1/20/2019,9,10097,1705,4616,3586,9,0,20013
1/20/2019,10,10091,1842,4482,3544,59,0,20018
1/20/2019,11,10092,1875,4531,3660,143,0,20301
1/20/2019,12,10087,1897,4685,3577,196,0,20442
1/20/2019,13,10084,2058,4933,3572,206,0,20853
1/20/2019,14,10082,2209,4977,3669,200,23,21160
1/20/2019,15,10091,2165,4886,3627,157,54,20980
1/20/2019,16,10087,1980,5079,3636,100,56,20938
1/20/2019,17,10090,2429,5538,3533,30,71,21691
1/20/2019,18,10083,3552,5861,3405,0,125,23026
1/20/2019,19,10099,3668,5825,3449,0,110,23151
1/20/2019,20,10092,3636,5911,3362,0,74,23075
1/20/2019,21,10097,2990,5694,3242,0,52,22075
1/20/2019,22,10095,2881,5154,3110,0,14,21254
1/20/2019,23,10097,2087,4585,2994,0,0,19763
1/20/2019,24,10090,1690,4464,2947,0,0,19191
1/21/2019,1,10094,1567,4132,2802,0,0,18595
1/21/2019,2,10101,2030,3878,2712,0,0,18721
1/21/2019,3,10098,1977,3438,2269,0,3,17785
1/21/2019,4,10097,2216,3847,2270,0,15,18445
1/21/2019,5,10099,2227,4060,2093,0,14,18493
1/21/2019,6,10095,2372,3952,1959,0,14,18392
1/21/2019,7,10095,2961,4931,1984,0,15,19986
1/21/2019,8,10100,4079,5381,1796,0,24,21380
1/21/2019,9,10098,4104,5506,1575,30,41,21354
1/21/2019,10,10099,4303,5657,1112,118,46,21335
1/21/2019,11,10097,4400,5238,888,181,59,20863
1/21/2019,12,10095,4449,5156,839,188,99,20826
1/21/2019,13,10094,4734,5190,708,235,188,21149
1/21/2019,14,10098,4790,5017,654,205,213,20977
1/21/2019,15,10091,4520,4953,792,206,189,20751
1/21/2019,16,10103,4542,5125,876,139,146,20931
1/21/2019,17,10099,4956,5552,781,43,178,21609
1/21/2019,18,10102,5530,5984,781,1,216,22614
1/21/2019,19,10098,5503,5987,791,0,180,22559
1/21/2019,20,10105,4753,6055,945,0,133,21991
1/21/2019,21,10094,4918,5975,844,0,146,21977
1/21/2019,22,10094,5084,5383,710,0,166,21437
1/21/2019,23,10088,4630,4999,609,0,146,20472
1/21/2019,24,10115,3666,4473,609,0,88,18951
1/22/2019,1,9646,3692,4169,693,0,70,18270
1/22/2019,2,9589,3401,3995,655,0,69,17709
1/22/2019,3,9592,2680,4049,646,0,68,17035
1/22/2019,4,9592,2586,4139,695,0,68,17080
1/22/2019,5,9763,2670,3778,844,0,69,17124
1/22/2019,6,9997,2717,3871,1131,0,70,17786
1/22/2019,7,9979,2784,5168,1695,0,72,19698
1/22/2019,8,9984,2795,5417,2274,0,85,20555
1/22/2019,9,9981,2719,5471,2500,30,85,20786
1/22/2019,10,9979,2943,5523,2480,73,85,21083
1/22/2019,11,9980,3359,5149,2527,91,79,21185
1/22/2019,12,9979,3973,4677,2448,100,66,21243
1/22/2019,13,9975,3216,4419,2402,109,28,20149
1/22/2019,14,10007,3266,4192,2546,76,27,20114
1/22/2019,15,10041,2967,4070,2756,73,27,19934
1/22/2019,16,10051,2797,4367,2805,39,27,20086
1/22/2019,17,10053,2952,4771,2966,15,27,20784
1/22/2019,18,10051,3101,5370,2975,0,29,21526
1/22/2019,19,10174,2989,5347,3062,0,28,21600
1/22/2019,20,10333,3103,5316,3122,0,27,21901
1/22/2019,21,10338,3549,5160,3017,0,27,22091
1/22/2019,22,10341,3391,4835,2636,0,27,21230
1/22/2019,23,10356,2590,4199,2443,0,27,19615
1/22/2019,24,10354,1644,4028,2264,0,21,18311
1/23/2019,1,10379,1679,3914,1919,0,13,17904
1/23/2019,2,10379,1220,3429,1746,0,10,16784
1/23/2019,3,10374,1298,3811,1739,0,10,17232
1/23/2019,4,10373,933,3345,1865,0,10,16526
1/23/2019,5,10376,850,3331,1933,0,9,16499
1/23/2019,6,10368,952,3386,1974,0,11,16691
1/23/2019,7,10382,1272,4062,2343,0,16,18075
1/23/2019,8,10387,1442,4609,2623,0,26,19087
1/23/2019,9,10387,1456,4340,2746,3,28,18960
1/23/2019,10,10390,1458,4157,2973,10,27,19015
1/23/2019,11,10391,1352,4884,3119,13,27,19786
1/23/2019,12,10398,1532,4594,3256,22,26,19828
1/23/2019,13,10409,1484,4431,3497,20,27,19868
1/23/2019,14,10411,1626,4275,3706,13,26,20057
1/23/2019,15,10409,1017,4061,3804,8,26,19325
1/23/2019,16,10412,1026,4663,3884,6,26,20017
1/23/2019,17,10411,1210,4879,3892,1,22,20415
1/23/2019,18,10411,1339,5083,3839,0,27,20699
1/23/2019,19,10407,1326,4997,3788,0,27,20545
1/23/2019,20,10394,1320,4783,3684,0,27,20208
1/23/2019,21,10394,1282,4568,3368,0,27,19639
1/23/2019,22,10400,1046,4921,2835,0,27,19229
1/23/2019,23,10413,988,4465,2298,0,27,18191
1/23/2019,24,10408,423,4156,2019,0,16,17022
1/24/2019,1,10407,277,3514,2009,0,12,16219
1/24/2019,2,10419,277,3340,2015,0,12,16063
1/24/2019,3,10424,290,3155,2192,0,12,16073
1/24/2019,4,10423,325,3191,2038,0,11,15988
1/24/2019,5,10423,419,3209,1797,0,12,15860
1/24/2019,6,10420,765,3241,1651,0,14,16091
1/24/2019,7,10417,1344,3804,1496,0,30,17091
1/24/2019,8,10419,1460,4299,1831,0,43,18052
1/24/2019,9,10418,1775,4733,1899,2,43,18870
1/24/2019,10,10417,1593,4780,1825,7,40,18662
1/24/2019,11,10412,1851,4729,1884,16,43,18935
1/24/2019,12,10409,1561,4460,2177,25,45,18677
1/24/2019,13,10412,1489,3745,2334,23,44,18047
1/24/2019,14,10417,1662,3621,2178,17,47,17942
1/24/2019,15,10416,1683,3913,2210,17,47,18286
1/24/2019,16,10412,1391,4147,1875,13,40,17878
1/24/2019,17,10412,1451,4546,1869,2,26,18306
1/24/2019,18,10407,1683,4982,1998,0,27,19097
1/24/2019,19,10409,1705,4991,2372,0,28,19505
1/24/2019,20,10413,1691,4831,2629,0,27,19591
1/24/2019,21,10414,1387,4735,2609,0,27,19172
1/24/2019,22,10407,1148,4268,2913,0,27,18763
1/24/2019,23,10365,412,4042,3205,0,27,18051
1/24/2019,24,10410,274,3472,3484,0,17,17657
1/25/2019,1,10401,271,3317,3444,0,12,17445
1/25/2019,2,10405,278,3169,3360,0,10,17222
1/25/2019,3,10413,276,3134,3067,0,12,16902
1/25/2019,4,10410,273,3101,3078,0,14,16876
1/25/2019,5,10415,268,3103,3212,0,18,17016
1/25/2019,6,10412,269,3267,3437,0,35,17420
1/25/2019,7,10412,271,3722,3437,0,79,17921
1/25/2019,8,10417,284,4231,3877,0,158,18967
1/25/2019,9,10411,286,4236,3898,9,202,19042
1/25/2019,10,10412,374,4442,3843,50,206,19327
1/25/2019,11,10408,406,4092,3850,132,205,19093
1/25/2019,12,10407,574,3975,3658,211,205,19030
1/25/2019,13,10404,810,4143,3467,196,164,19184
1/25/2019,14,10409,1137,4444,3192,149,63,19394
1/25/2019,15,10409,1550,4401,3176,134,28,19698
1/25/2019,16,10408,1597,4281,2816,83,30,19215
1/25/2019,17,10407,1554,4469,2439,31,33,18933
1/25/2019,18,10401,1545,4577,3015,1,35,19574
1/25/2019,19,10407,1547,4702,3133,0,33,19822
1/25/2019,20,10405,1559,4436,2960,0,31,19391
1/25/2019,21,10405,1553,4211,3042,0,26,19237
1/25/2019,22,10411,1207,4026,3227,0,25,18896
1/25/2019,23,10404,572,4238,2917,0,26,18157
1/25/2019,24,10401,478,4259,2535,0,18,17691
1/26/2019,1,10401,379,4058,2132,0,6,16976
1/26/2019,2,10411,392,4355,1794,0,0,16952
1/26/2019,3,10413,410,4095,1469,0,0,16387
1/26/2019,4,10410,469,4387,1161,0,0,16427
1/26/2019,5,10406,674,4134,1043,0,0,16257
1/26/2019,6,10407,901,4261,982,0,0,16551
1/26/2019,7,10413,1177,4110,884,0,0,16584
1/26/2019,8,10418,1408,4682,856,0,0,17364
1/26/2019,9,10406,1668,4923,802,31,0,17830
1/26/2019,10,10405,1826,4987,680,124,0,18022
1/26/2019,11,10411,1653,4826,628,226,0,17744
1/26/2019,12,10411,1662,4495,682,272,0,17522
1/26/2019,13,10411,1707,4368,717,248,0,17451
1/26/2019,14,10410,1620,4207,551,224,0,17012
1/26/2019,15,10377,1777,4487,436,175,0,17252
1/26/2019,16,10419,1958,4415,443,87,0,17322
1/26/2019,17,10417,2005,4933,512,24,0,17891
1/26/2019,18,10405,2579,5383,512,1,0,18880
1/26/2019,19,10413,3059,5475,535,0,0,19482
1/26/2019,20,10417,2250,5462,715,0,5,18849
1/26/2019,21,10410,1967,5184,899,0,6,18466
1/26/2019,22,10418,1946,4393,1089,0,19,17865
1/26/2019,23,10416,1502,4074,1065,0,27,17084
1/26/2019,24,10414,1183,4299,1088,0,26,17010
1/27/2019,1,10417,414,3974,1142,0,24,15971
1/27/2019,2,10421,283,3989,1250,0,25,15968
1/27/2019,3,10424,279,4056,1585,0,21,16365
1/27/2019,4,10424,279,3748,2234,0,12,16697
1/27/2019,5,10418,281,3799,2280,0,22,16800
1/27/2019,6,10362,283,3829,2534,0,8,17016
1/27/2019,7,10330,291,3901,2955,0,1,17478
1/27/2019,8,10334,290,4191,2777,0,0,17592
1/27/2019,9,10339,368,4487,2868,10,0,18072
1/27/2019,10,10358,526,4536,2765,46,0,18231
1/27/2019,11,10389,705,4285,2338,144,0,17861
1/27/2019,12,10406,900,4356,1883,221,0,17766
1/27/2019,13,10415,1066,4231,2324,208,0,18244
1/27/2019,14,10416,1273,4295,2562,202,0,18748
1/27/2019,15,10415,1790,4512,2362,172,0,19251
1/27/2019,16,10415,1876,4699,2131,94,0,19215
1/27/2019,17,10410,2099,5185,1643,34,0,19371
1/27/2019,18,10414,2236,5662,1877,1,0,20190
1/27/2019,19,10412,2580,5882,1834,0,0,20708
1/27/2019,20,10415,2187,5732,1728,0,1,20063
1/27/2019,21,10411,1963,5531,1712,0,1,19618
1/27/2019,22,10409,1335,5238,1663,0,0,18645
1/27/2019,23,10414,960,5045,1243,0,0,17662
1/27/2019,24,10406,910,4931,785,0,0,17032
1/28/2019,1,10413,944,4909,474,0,0,16740
1/28/2019,2,10407,941,4473,332,0,4,16157
1/28/2019,3,10417,904,4256,377,0,19,15973
1/28/2019,4,10421,1299,4803,441,0,32,16996
1/28/2019,5,10414,1439,4372,582,0,31,16838
1/28/2019,6,10419,1641,4377,902,0,22,17361
1/28/2019,7,10416,1870,5009,1552,0,24,18871
1/28/2019,8,10411,1995,5373,2356,1,29,20165
1/28/2019,9,10416,1844,5355,2549,44,30,20238
1/28/2019,10,10414,1821,4898,3021,98,32,20284
1/28/2019,11,10407,1920,5064,3207,141,32,20771
1/28/2019,12,10410,1932,4970,3277,155,28,20772
1/28/2019,13,10416,1811,4782,3376,142,27,20554
1/28/2019,14,10415,1834,4540,3562,93,27,20471
1/28/2019,15,10417,2117,4296,3663,89,27,20609
1/28/2019,16,10415,2292,4363,3583,56,27,20736
1/28/2019,17,10406,2312,5280,3409,16,28,21451
1/28/2019,18,10399,2864,5951,3369,0,28,22611
1/28/2019,19,10413,2657,5932,3427,0,31,22460
1/28/2019,20,10413,2610,5941,3255,0,28,22247
1/28/2019,21,10416,2354,5696,2986,0,27,21479
1/28/2019,22,10413,2491,5108,2810,0,27,20849
1/28/2019,23,10413,1533,4553,2987,0,26,19512
1/28/2019,24,10414,444,4208,3180,0,19,18265
1/29/2019,1,10414,277,3873,3353,0,17,17934
1/29/2019,2,10412,277,3819,3484,0,15,18007
1/29/2019,3,10411,282,3656,3625,0,14,17988
1/29/2019,4,10405,296,3499,3642,0,14,17856
1/29/2019,5,10413,395,3751,3618,0,15,18192
1/29/2019,6,10428,728,3913,3673,0,16,18758
1/29/2019,7,10421,1269,4380,3422,0,18,19510
1/29/2019,8,10421,2127,5226,3224,0,26,21024
1/29/2019,9,10420,2426,5145,3082,2,27,21102
1/29/2019,10,10423,2467,5032,3182,19,27,21150
1/29/2019,11,10422,2036,4982,3264,51,27,20782
1/29/2019,12,10422,1867,4660,2766,71,27,19813
1/29/2019,13,10426,1552,4852,2784,79,27,19720
1/29/2019,14,10418,1605,4602,2915,66,27,19633
1/29/2019,15,10405,1813,4729,2862,54,10,19873
1/29/2019,16,10399,1913,5085,2578,46,26,20047
1/29/2019,17,10409,2002,5171,3183,14,27,20806
1/29/2019,18,10416,1976,5498,3664,1,27,21582
1/29/2019,19,10409,1996,5491,3796,0,27,21719
1/29/2019,20,10421,2003,5425,3782,0,27,21658
1/29/2019,21,10417,1944,5509,3750,0,27,21647
1/29/2019,22,10420,1737,4992,3766,0,27,20942
1/29/2019,23,10417,1134,4221,3337,0,27,19136
1/29/2019,24,10415,505,4191,3292,0,21,18424
1/30/2019,1,10418,395,4203,3014,0,33,18063
1/30/2019,2,10418,396,4156,3244,0,38,18252
1/30/2019,3,10411,418,4117,2928,0,38,17912
1/30/2019,4,10412,520,3997,3322,0,37,18288
1/30/2019,5,10416,812,4011,2817,0,33,18089
1/30/2019,6,10418,1049,4324,2415,0,36,18242
1/30/2019,7,10423,1390,4628,2730,0,33,19204
1/30/2019,8,10419,1764,5004,3319,0,51,20557
1/30/2019,9,10418,1970,4944,3423,9,67,20831
1/30/2019,10,10421,1984,4571,3489,44,74,20583
1/30/2019,11,10410,1888,4593,3579,83,91,20644
1/30/2019,12,10421,1847,4478,3704,105,92,20647
1/30/2019,13,10418,1790,4529,3780,123,108,20748
1/30/2019,14,10416,1846,4772,3783,119,120,21056
1/30/2019,15,10418,1887,4990,3886,88,189,21458
1/30/2019,16,10417,2003,4884,3351,70,201,20926
1/30/2019,17,10416,2075,5154,3622,28,165,21460
1/30/2019,18,10418,2257,5822,3813,2,170,22482
1/30/2019,19,10397,2386,6116,3844,0,224,22967
1/30/2019,20,10142,2362,6039,3759,0,230,22532
1/30/2019,21,10136,2560,5957,3740,0,182,22575
1/30/2019,22,10113,2152,5739,3787,0,122,21913
1/30/2019,23,10092,1677,4767,3779,0,144,20459
1/30/2019,24,10094,1169,4481,3711,0,58,19513
1/31/2019,1,10086,1009,4372,3666,0,29,19162
1/31/2019,2,10080,1000,4105,3588,0,19,18792
1/31/2019,3,10082,1262,4226,3483,0,15,19068
1/31/2019,4,10081,1264,4048,3448,0,13,18854
1/31/2019,5,10086,1456,4175,3402,0,17,19136
1/31/2019,6,10089,1562,4330,3171,0,20,19172
1/31/2019,7,10094,1760,5007,3064,0,17,19942
1/31/2019,8,10093,2033,5439,3198,0,25,20788
1/31/2019,9,10094,2804,5173,3228,37,26,21362
1/31/2019,10,10102,2669,5164,3205,111,26,21277
1/31/2019,11,10107,2638,4840,2825,167,23,20600
1/31/2019,12,10126,2680,4654,2979,186,44,20669
1/31/2019,13,10149,2738,4461,2274,193,79,19894
1/31/2019,14,10202,2800,4321,2344,182,82,19931
1/31/2019,15,10203,2519,4365,2236,163,82,19568
1/31/2019,16,10199,2181,4519,2844,109,83,19935
1/31/2019,17,10199,2652,4725,2408,40,85,20109
1/31/2019,18,10193,2899,5322,3156,2,85,21657
1/31/2019,19,10197,3099,6153,3000,0,86,22535
1/31/2019,20,10198,3239,6185,2813,0,87,22522
1/31/2019,21,10195,3425,6014,2476,0,82,22192
1/31/2019,22,10191,3145,5671,2090,0,81,21178
1/31/2019,23,10179,2568,5210,1768,0,79,19804
1/31/2019,24,10169,1917,4895,1595,0,72,18648
2/1/2019,1,10163,2145,4486,1383,0,26,18203
2/1/2019,2,10158,2284,4503,1182,0,12,18139
2/1/2019,3,10162,2266,4464,937,0,11,17840
2/1/2019,4,10162,2647,4392,765,0,11,17977
2/1/2019,5,10156,2978,4422,623,0,12,18191
2/1/2019,6,10153,2826,5034,512,0,16,18541
2/1/2019,7,10163,3359,5787,453,0,19,19781
2/1/2019,8,10169,4575,5770,430,1,26,20971
2/1/2019,9,10169,4485,5710,452,45,26,20887
2/1/2019,10,10166,4166,5576,383,149,26,20466
2/1/2019,11,10178,4317,5214,269,232,26,20236
2/1/2019,12,10184,4502,5067,228,288,26,20295
2/1/2019,13,10188,3704,4710,208,311,26,19147
2/1/2019,14,10191,4071,4668,206,311,30,19477
2/1/2019,15,10197,4063,4595,182,280,34,19351
2/1/2019,16,10193,4920,4903,183,197,26,20422
2/1/2019,17,10193,4141,5641,201,68,26,20270
2/1/2019,18,10146,4659,6006,305,4,26,21146
2/1/2019,19,10143,4537,6010,572,0,26,21288
2/1/2019,20,10145,4338,5969,862,0,27,21341
2/1/2019,21,10144,3663,5660,999,0,27,20493
2/1/2019,22,10144,3689,4965,1146,0,26,19970
2/1/2019,23,10141,3370,4480,1335,0,18,19344
2/1/2019,24,10140,1997,4445,1566,0,10,18158
2/2/2019,1,10144,1548,4162,1860,0,0,17714
2/2/2019,2,10137,1201,4018,1880,0,0,17236
2/2/2019,3,10144,964,4041,1894,0,0,17043
2/2/2019,4,10136,1019,4100,2279,0,0,17534
2/2/2019,5,10156,935,3778,2710,0,0,17579
2/2/2019,6,10157,936,3796,3023,0,0,17912
2/2/2019,7,10159,958,3996,3112,0,0,18225
2/2/2019,8,10160,1030,4288,3107,0,0,18585
2/2/2019,9,10148,1162,4533,3305,12,0,19160
2/2/2019,10,10143,1164,4619,3369,41,0,19336
2/2/2019,11,10148,1579,5070,3258,92,0,20147
2/2/2019,12,10148,1324,4867,3278,106,0,19723
2/2/2019,13,10144,1216,4820,3268,115,0,19563
2/2/2019,14,10142,1287,4519,3102,112,0,19162
2/2/2019,15,10150,1301,4966,2753,113,0,19283
2/2/2019,16,10154,1371,5128,2477,72,0,19202
2/2/2019,17,10157,1393,5123,2364,26,0,19063
2/2/2019,18,10164,1203,5761,2160,3,0,19291
2/2/2019,19,10255,1202,5856,2025,0,0,19338
2/2/2019,20,10268,1146,5463,2025,0,0,18902
2/2/2019,21,10264,1145,5627,1891,0,0,18927
2/2/2019,22,10235,1140,5519,1786,0,0,18680
2/2/2019,23,10259,800,4662,1912,0,0,17633
2/2/2019,24,10269,725,4103,2106,0,0,17203
2/3/2019,1,10268,392,3548,2078,0,0,16286
2/3/2019,2,10263,337,3563,2253,0,6,16422
2/3/2019,3,10265,316,3555,2461,0,3,16600
2/3/2019,4,10264,316,3574,2560,0,0,16714
2/3/2019,5,10269,316,3668,2591,0,0,16844
2/3/2019,6,10263,318,3801,2746,0,0,17128
2/3/2019,7,10263,321,3965,2943,0,0,17492
2/3/2019,8,10264,331,3893,3009,0,0,17497
2/3/2019,9,10261,408,3893,3130,10,0,17702
2/3/2019,10,10266,418,4029,3391,41,0,18145
2/3/2019,11,10267,630,4271,3405,53,0,18626
2/3/2019,12,10261,870,4091,3408,118,0,18748
2/3/2019,13,10264,998,3901,3075,126,0,18364
2/3/2019,14,10260,962,3892,3016,148,0,18278
2/3/2019,15,10257,989,3792,3273,127,1,18439
2/3/2019,16,10216,1004,4361,3134,57,1,18773
2/3/2019,17,10246,1207,5188,2899,38,0,19578
2/3/2019,18,10244,1239,5526,2973,2,0,19984
2/3/2019,19,10247,1338,5081,3011,0,0,19677
2/3/2019,20,10250,1346,4888,3079,0,0,19563
2/3/2019,21,10249,721,4731,2943,0,0,18644
2/3/2019,22,10244,533,4461,3065,0,0,18303
2/3/2019,23,10245,417,4124,2976,0,0,17762
2/3/2019,24,10244,332,4013,2847,0,0,17436
2/4/2019,1,10244,331,3883,2582,0,0,17040
2/4/2019,2,10243,333,3736,2368,0,0,16680
2/4/2019,3,10244,340,3617,2341,0,0,16542
2/4/2019,4,10243,352,3275,2220,0,0,16090
2/4/2019,5,10235,394,3582,2268,0,9,16488
2/4/2019,6,10240,459,3986,2095,0,13,16793
2/4/2019,7,10238,703,4227,2115,0,10,17293
2/4/2019,8,10241,925,4810,2435,0,22,18433
2/4/2019,9,10236,933,4425,2703,15,26,18338
2/4/2019,10,10237,931,4571,2741,69,24,18573
2/4/2019,11,10195,931,4773,2773,120,22,18814
2/4/2019,12,10216,835,4498,2874,139,27,18589
2/4/2019,13,10225,821,4504,3124,143,27,18844
2/4/2019,14,10007,574,4375,3224,132,28,18340
2/4/2019,15,9923,575,4446,3253,82,27,18306
2/4/2019,16,9919,752,4149,3439,65,28,18352
2/4/2019,17,9918,765,4324,3643,13,28,18691
2/4/2019,18,9914,756,5048,3778,0,27,19523
2/4/2019,19,9913,755,4792,3860,0,27,19347
2/4/2019,20,9913,755,4662,3974,0,26,19330
2/4/2019,21,9907,751,4705,3926,0,27,19316
2/4/2019,22,9896,744,4624,3837,0,26,19127
2/4/2019,23,9899,703,3888,3749,0,27,18266
2/4/2019,24,10012,531,3523,3089,0,18,17173
2/5/2019,1,10202,315,3303,2590,0,14,16424
2/5/2019,2,10213,283,3372,2278,0,11,16157
2/5/2019,3,10212,282,3396,1981,0,10,15881
2/5/2019,4,10213,356,3311,2040,0,11,15931
2/5/2019,5,10214,583,3229,2026,0,11,16063
2/5/2019,6,10221,836,3513,1950,0,14,16534
2/5/2019,7,10218,959,4061,1903,0,18,17159
2/5/2019,8,10216,939,4662,2006,0,27,17850
2/5/2019,9,10212,929,4598,1952,9,27,17727
2/5/2019,10,10212,1105,5182,1513,32,15,18059
2/5/2019,11,10208,1207,4913,1487,66,24,17905
2/5/2019,12,10209,1409,4381,1572,103,27,17701
2/5/2019,13,10209,1621,4255,1416,145,27,17673
2/5/2019,14,10206,1811,4465,1225,127,27,17861
2/5/2019,15,10208,1970,4376,1025,82,28,17689
2/5/2019,16,10207,2371,4071,794,53,27,17523
2/5/2019,17,10204,2510,4662,525,29,27,17957
2/5/2019,18,10202,2688,5464,420,3,27,18804
2/5/2019,19,10209,3229,5547,381,0,27,19393
2/5/2019,20,10209,2903,5644,401,0,28,19185
2/5/2019,21,10198,2779,5349,454,0,26,18806
2/5/2019,22,10194,2275,4782,540,0,26,17817
2/5/2019,23,10185,1595,4550,414,0,26,16770
2/5/2019,24,10179,993,4367,456,0,18,16013
2/6/2019,1,10182,791,4355,596,0,13,15937
2/6/2019,2,10183,749,4243,1002,0,12,16189
2/6/2019,3,10185,786,3501,1455,0,12,15939
2/6/2019,4,10190,843,3529,1533,0,17,16112
2/6/2019,5,10190,1021,4375,838,0,18,16442
2/6/2019,6,10184,923,4221,1152,0,24,16504
2/6/2019,7,10182,999,4858,926,0,32,16997
2/6/2019,8,10187,1618,5520,771,1,39,18136
2/6/2019,9,10166,2480,5396,614,8,57,18721
2/6/2019,10,10102,2253,5326,490,15,95,18281
2/6/2019,11,10094,2680,5310,456,27,155,18722
2/6/2019,12,10094,2745,5084,518,29,148,18618
2/6/2019,13,10099,3212,4904,404,32,141,18792
2/6/2019,14,9955,3295,4834,128,32,142,18386
2/6/2019,15,9736,3295,4905,71,29,145,18181
2/6/2019,16,9820,3064,5061,69,17,105,18136
2/6/2019,17,9826,3165,5250,53,5,82,18381
2/6/2019,18,9827,3434,5364,79,0,92,18796
2/6/2019,19,9832,3302,5378,139,0,120,18771
2/6/2019,20,9831,3254,5432,192,0,85,18794
2/6/2019,21,9834,3137,5435,223,0,84,18713
2/6/2019,22,9825,2361,5195,202,0,83,17666
2/6/2019,23,9826,2115,4426,206,0,49,16622
2/6/2019,24,9827,1460,4122,114,0,21,15544
2/7/2019,1,9817,988,4313,91,0,14,15223
2/7/2019,2,9817,798,4118,121,0,12,14866
2/7/2019,3,9813,757,3998,80,0,11,14659
2/7/2019,4,9812,816,3993,86,0,11,14718
2/7/2019,5,9809,1019,3850,115,0,10,14803
2/7/2019,6,9811,1355,3876,124,0,14,15180
2/7/2019,7,9818,1848,4667,117,0,18,16468
2/7/2019,8,9823,2280,5352,162,0,26,17643
2/7/2019,9,9822,2173,5340,281,12,28,17656
2/7/2019,10,9820,2018,5222,541,33,27,17661
2/7/2019,11,9600,2015,5206,736,59,28,17644
2/7/2019,12,9501,1917,5196,1176,54,30,17874
2/7/2019,13,9476,1830,5000,1173,50,35,17564
2/7/2019,14,9515,1941,4927,1310,36,29,17758
2/7/2019,15,9514,1927,4522,1838,24,31,17856
2/7/2019,16,9515,1550,4790,2313,14,33,18215
2/7/2019,17,9592,1430,4961,2604,5,29,18621
2/7/2019,18,9820,1420,4898,2799,0,28,18965
2/7/2019,19,9820,1423,4838,2797,0,27,18905
2/7/2019,20,9820,1421,4934,3245,0,27,19447
2/7/2019,21,9817,976,4801,3425,0,27,19046
2/7/2019,22,9812,817,4610,3578,0,27,18844
2/7/2019,23,9795,791,3663,3589,0,27,17865
2/7/2019,24,9789,494,3811,3164,0,18,17276
2/8/2019,1,9779,380,3937,2543,0,12,16651
2/8/2019,2,9779,379,3968,2193,0,11,16330
2/8/2019,3,9780,380,3955,1991,0,10,16116
2/8/2019,4,9775,388,3832,2181,0,10,16186
2/8/2019,5,9774,394,3901,2221,0,10,16300
2/8/2019,6,9776,394,3984,2686,0,13,16853
2/8/2019,7,9774,394,4157,3279,0,20,17624
2/8/2019,8,9775,397,4517,3888,0,13,18590
2/8/2019,9,9778,366,4925,3967,9,7,19052
2/8/2019,10,9717,448,5165,3972,30,19,19351
2/8/2019,11,9698,546,5119,3964,82,27,19436
2/8/2019,12,9774,792,4761,3875,135,27,19364
2/8/2019,13,9781,1092,4599,3797,113,27,19409
2/8/2019,14,9771,1367,4612,3543,117,27,19437
2/8/2019,15,9778,1458,4523,3484,123,27,19393
2/8/2019,16,9778,1615,4724,3410,83,27,19637
2/8/2019,17,9777,1761,4873,3537,30,27,20005
2/8/2019,18,9485,1813,5195,3994,2,27,20516
2/8/2019,19,9328,2004,5616,4038,0,27,21013
2/8/2019,20,9302,1770,5248,4027,0,27,20374
2/8/2019,21,9101,1731,5174,4001,0,27,20034
2/8/2019,22,9042,1683,4978,3844,0,27,19574
2/8/2019,23,8999,779,4775,3671,0,27,18251
2/8/2019,24,8995,601,4524,3756,0,16,17892
2/9/2019,1,8993,524,4210,3711,0,6,17444
2/9/2019,2,9001,340,4194,3663,0,0,17198
2/9/2019,3,8992,356,3925,3682,0,0,16955
2/9/2019,4,8994,451,3725,3505,0,0,16675
2/9/2019,5,8998,715,3772,3306,0,0,16791
2/9/2019,6,8999,1087,3819,3038,0,0,16943
2/9/2019,7,9004,1497,3901,2663,0,0,17065
2/9/2019,8,9004,1956,4599,2378,3,0,17940
2/9/2019,9,9005,2366,4592,2156,64,0,18183
2/9/2019,10,9012,2391,4539,1877,188,0,18007
2/9/2019,11,9011,2396,4899,1417,263,0,17986
2/9/2019,12,9013,2622,5044,924,271,0,17874
2/9/2019,13,9029,2660,4879,586,253,0,17407
2/9/2019,14,9033,2731,4762,442,227,0,17195
2/9/2019,15,9032,2921,4753,447,204,0,17357
2/9/2019,16,9032,2797,4717,531,146,0,17223
2/9/2019,17,9025,2888,5074,598,66,18,17669
2/9/2019,18,9024,3455,5473,510,7,64,18533
2/9/2019,19,9022,4061,5559,530,0,103,19275
2/9/2019,20,8992,3783,5545,607,0,56,18983
2/9/2019,21,9017,3457,5401,557,0,53,18485
2/9/2019,22,9020,3524,4916,560,0,53,18073
2/9/2019,23,9018,3045,4569,504,0,53,17189
2/9/2019,24,9017,2991,4289,325,0,52,16674
2/10/2019,1,9014,2967,4121,231,0,14,16347
2/10/2019,2,9041,2324,3799,246,0,0,15410
2/10/2019,3,9045,2017,3980,251,0,1,15294
2/10/2019,4,9041,1927,3852,222,0,1,15043
2/10/2019,5,9035,1970,4113,174,0,0,15292
2/10/2019,6,9033,2075,4278,184,0,0,15570
2/10/2019,7,9041,2132,4499,281,0,0,15953
2/10/2019,8,9043,2163,4589,303,4,0,16102
2/10/2019,9,9048,2286,4597,327,39,4,16301
2/10/2019,10,9044,2411,4624,251,92,24,16446
2/10/2019,11,9048,2281,5121,233,118,54,16855
2/10/2019,12,9048,2201,4843,145,151,57,16445
2/10/2019,13,9047,2183,4711,209,153,58,16361
2/10/2019,14,9052,2108,4626,198,140,58,16182
2/10/2019,15,9057,2262,4815,212,124,58,16528
2/10/2019,16,9055,2422,4820,270,96,58,16721
2/10/2019,17,9050,2598,5306,464,38,58,17514
2/10/2019,18,9047,2960,5557,562,2,58,18186
2/10/2019,19,9045,3244,5676,729,0,58,18752
2/10/2019,20,9046,3006,5594,882,0,58,18586
2/10/2019,21,9043,2972,5528,880,0,58,18481
2/10/2019,22,9040,3112,5076,849,0,58,18135
2/10/2019,23,9046,2678,4938,704,0,15,17381
2/10/2019,24,9048,2340,4375,631,0,0,16394
2/11/2019,1,9059,2021,4129,559,0,0,15768
2/11/2019,2,9063,1814,4068,559,0,11,15515
2/11/2019,3,9059,1285,4338,679,0,9,15370
2/11/2019,4,9067,1221,4178,753,0,10,15229
2/11/2019,5,9060,1527,3946,774,0,13,15320
2/11/2019,6,9063,1920,3888,878,0,35,15784
2/11/2019,7,9067,2412,5033,949,0,67,17528
2/11/2019,8,9063,3262,5290,1096,1,82,18794
2/11/2019,9,9067,2994,5175,1242,20,83,18581
2/11/2019,10,9068,2741,4723,1420,68,83,18103
2/11/2019,11,9066,2601,5162,1577,107,83,18596
2/11/2019,12,9057,2617,5065,1722,145,83,18689
2/11/2019,13,9053,2344,5005,1748,191,83,18424
2/11/2019,14,9069,2532,4548,1822,193,83,18247
2/11/2019,15,9079,2551,4156,1925,165,83,17959
2/11/2019,16,9079,2468,4294,1889,116,83,17929
2/11/2019,17,9078,2502,4621,2255,42,83,18581
2/11/2019,18,9080,2865,5374,2303,4,83,19709
2/11/2019,19,9084,3051,5328,2551,0,83,20097
2/11/2019,20,9086,2975,5313,2926,0,84,20384
2/11/2019,21,9082,2589,4747,3271,0,83,19772
2/11/2019,22,9083,2411,4046,3342,0,85,18967
2/11/2019,23,9076,1467,3965,3258,0,42,17808
2/11/2019,24,9079,965,3603,3508,0,18,17173
2/12/2019,1,9075,455,3886,3634,0,13,17063
2/12/2019,2,9074,301,3986,3749,0,12,17122
2/12/2019,3,9071,357,3504,3864,0,11,16807
2/12/2019,4,9068,580,3533,3915,0,12,17108
2/12/2019,5,9068,1044,4236,3393,0,12,17753
2/12/2019,6,9071,1814,4293,2997,0,17,18192
2/12/2019,7,9071,1968,4699,2911,1,19,18669
2/12/2019,8,9074,2314,5008,3038,1,26,19461
2/12/2019,9,9068,2604,5183,2927,14,27,19823
2/12/2019,10,9071,3409,5276,2760,36,27,20579
2/12/2019,11,9075,3904,5174,2606,53,33,20845
2/12/2019,12,9076,3793,4977,2557,62,44,20509
2/12/2019,13,9079,3572,4943,2574,60,39,20267
2/12/2019,14,9077,3619,4792,2549,53,28,20118
2/12/2019,15,9078,3993,4675,2354,36,31,20167
2/12/2019,16,9078,4065,4816,2073,20,31,20083
2/12/2019,17,9082,3713,4818,2165,8,32,19818
2/12/2019,18,9078,3672,4855,2544,0,34,20183
2/12/2019,19,9057,3439,5105,2772,0,32,20405
2/12/2019,20,9055,3728,5206,2761,0,27,20777
2/12/2019,21,9057,3401,5040,3042,0,27,20567
2/12/2019,22,9066,2783,4495,3211,0,28,19583
2/12/2019,23,9069,1891,3790,2893,0,27,17670
2/12/2019,24,9066,970,3759,3353,0,17,17165
2/13/2019,1,9070,409,4135,3358,0,13,16985
2/13/2019,2,9064,345,4202,3380,0,12,17003
2/13/2019,3,9064,347,4216,3384,0,12,17023
2/13/2019,4,9046,354,4063,3464,0,11,16938
2/13/2019,5,9054,501,3585,3664,0,12,16816
2/13/2019,6,9072,895,3669,3670,0,14,17320
2/13/2019,7,9078,1227,3926,3632,0,20,17883
2/13/2019,8,9078,1483,4333,3781,0,27,18702
2/13/2019,9,9075,1642,4876,3871,9,27,19500
2/13/2019,10,9073,1878,4970,3876,27,27,19851
2/13/2019,11,9079,1824,4945,3883,35,27,19793
2/13/2019,12,9080,1768,4628,3869,55,27,19427
2/13/2019,13,9065,1760,4317,3893,64,27,19126
2/13/2019,14,8926,1820,4259,3925,51,28,19009
2/13/2019,15,8913,1929,4273,4000,50,26,19191
2/13/2019,16,9068,1937,4498,3812,38,27,19380
2/13/2019,17,9066,1976,4937,3414,14,27,19434
2/13/2019,18,9062,1977,5193,3636,1,27,19896
2/13/2019,19,9085,1946,5391,3711,0,27,20160
2/13/2019,20,9087,1932,5162,3789,0,27,19997
2/13/2019,21,9087,1933,4951,3548,0,27,19546
2/13/2019,22,9082,1607,4880,3355,0,27,18951
2/13/2019,23,9081,1255,4617,3111,0,27,18091
2/13/2019,24,9078,812,4475,2828,0,16,17209
2/14/2019,1,9084,572,4356,2627,0,16,16655
2/14/2019,2,9081,522,4426,2524,0,13,16566
2/14/2019,3,9081,629,4063,2556,0,14,16343
2/14/2019,4,9087,865,3896,2144,0,13,16005
2/14/2019,5,9088,1292,4344,1518,0,14,16256
2/14/2019,6,9087,1673,4558,991,0,15,16324
2/14/2019,7,9087,2045,5112,846,0,20,17110
2/14/2019,8,9087,2405,5178,1240,5,27,17942
2/14/2019,9,9089,2096,4953,1550,37,27,17752
2/14/2019,10,9085,2169,5077,1777,48,27,18183
2/14/2019,11,9086,2049,4881,1943,97,27,18083
2/14/2019,12,9088,1993,4584,1934,128,28,17755
2/14/2019,13,9093,2223,4623,1885,130,27,17981
2/14/2019,14,9094,2413,4654,1974,130,27,18292
2/14/2019,15,9091,2463,4878,1896,101,27,18456
2/14/2019,16,9096,2592,4876,2077,77,27,18745
2/14/2019,17,9095,2375,4381,2270,26,27,18174
2/14/2019,18,9095,2350,4652,2584,3,27,18711
2/14/2019,19,9101,2201,5136,2841,0,27,19306
2/14/2019,20,9099,2044,4873,2949,0,27,18992
2/14/2019,21,9091,1644,4794,2920,0,27,18476
2/14/2019,22,9083,1404,4759,2874,0,27,18147
2/14/2019,23,9082,614,4949,2618,0,27,17290
2/14/2019,24,9086,453,4602,2465,0,17,16623
2/15/2019,1,9077,406,3831,2610,0,14,15938
2/15/2019,2,9082,373,3389,2695,0,13,15552
2/15/2019,3,9087,370,3313,3048,0,13,15831
2/15/2019,4,9093,370,3404,3049,0,13,15929
2/15/2019,5,9097,383,3479,3287,0,13,16259
2/15/2019,6,9092,419,3615,3311,0,15,16452
2/15/2019,7,9096,574,4256,3201,0,21,17148
2/15/2019,8,9095,740,4515,3701,0,27,18078
2/15/2019,9,9093,761,4777,3808,12,27,18478
2/15/2019,10,9095,856,5265,3850,37,27,19130
2/15/2019,11,9089,880,5229,3820,42,27,19087
2/15/2019,12,9085,956,4799,3767,73,27,18707
2/15/2019,13,9082,1081,4575,3708,114,28,18588
2/15/2019,14,9082,1415,4462,3166,129,27,18281
2/15/2019,15,9078,1570,4413,3136,174,27,18398
2/15/2019,16,9082,1696,4473,3242,121,27,18641
2/15/2019,17,9083,1633,4541,3188,41,27,18513
2/15/2019,18,9087,1692,5127,3213,5,27,19151
2/15/2019,19,9087,1806,5222,3301,0,27,19443
2/15/2019,20,9086,1804,5225,3367,0,27,19509
2/15/2019,21,9084,1791,4985,3128,0,27,19015
2/15/2019,22,9083,1231,4870,3058,0,27,18269
2/15/2019,23,9084,604,4486,2962,0,27,17163
2/15/2019,24,9088,508,4220,2790,0,17,16623
2/16/2019,1,9085,463,3847,2515,0,5,15915
2/16/2019,2,9088,308,4111,2439,0,0,15946
2/16/2019,3,9088,316,4503,2096,0,0,16003
2/16/2019,4,9086,314,4632,1686,0,0,15718
2/16/2019,5,9089,357,4497,1740,0,0,15683
2/16/2019,6,9090,459,4542,1559,0,0,15650
2/16/2019,7,9088,647,4813,1308,0,2,15858
2/16/2019,8,9088,1022,5096,1074,10,2,16292
2/16/2019,9,9089,1282,4959,899,90,3,16322
2/16/2019,10,9083,1267,4986,703,153,4,16196
2/16/2019,11,9080,1585,5091,554,199,6,16515
2/16/2019,12,9081,1732,4988,426,160,7,16394
2/16/2019,13,9083,1686,4868,416,180,4,16237
2/16/2019,14,9080,1489,4680,434,251,1,15935
2/16/2019,15,9076,1598,4605,415,251,2,15947
2/16/2019,16,9046,1809,4395,397,177,2,15826
2/16/2019,17,9060,1709,4642,433,68,1,15913
2/16/2019,18,9079,1845,5430,570,11,0,16935
2/16/2019,19,9078,1990,5739,580,0,0,17387
2/16/2019,20,9081,2103,5735,544,0,0,17463
2/16/2019,21,9059,2251,5427,454,0,0,17191
2/16/2019,22,9074,2038,5127,347,0,0,16586
2/16/2019,23,9075,1808,4868,238,0,0,15989
2/16/2019,24,9081,1353,4628,188,0,0,15250
2/17/2019,1,9088,1001,4662,191,0,0,14942
2/17/2019,2,9083,925,4465,297,0,0,14770
2/17/2019,3,9083,734,4156,454,0,0,14427
2/17/2019,4,9081,490,4473,537,0,0,14581
2/17/2019,5,9079,421,4726,550,0,0,14776
2/17/2019,6,9081,493,4886,587,0,0,15047
2/17/2019,7,9082,585,4959,874,1,0,15501
2/17/2019,8,9082,599,4860,1003,15,0,15559
2/17/2019,9,9078,724,4418,1110,111,0,15441
2/17/2019,10,9080,947,4351,1084,191,0,15653
2/17/2019,11,9078,1073,4405,1687,229,0,16472
2/17/2019,12,9078,1060,4362,1960,200,0,16660
2/17/2019,13,9074,1087,4533,1868,209,0,16771
2/17/2019,14,9073,1460,5088,1628,160,0,17409
2/17/2019,15,9068,1506,5004,1701,152,0,17431
2/17/2019,16,9066,1642,4373,1897,131,0,17109
2/17/2019,17,9062,1616,4450,1799,46,0,16973
2/17/2019,18,9064,1616,4668,2180,8,0,17536
2/17/2019,19,9050,1617,4899,2391,0,0,17957
2/17/2019,20,9061,1619,5015,2082,0,0,17777
2/17/2019,21,9054,1571,5052,2069,0,0,17746
2/17/2019,22,9058,1445,5207,1862,0,0,17572
2/17/2019,23,9054,874,5143,1872,0,0,16943
2/17/2019,24,9057,528,4511,2195,0,0,16291
2/18/2019,1,9051,424,4073,2238,0,0,15786
2/18/2019,2,9052,413,4218,2139,0,0,15822
2/18/2019,3,9056,413,4308,1978,0,0,15755
2/18/2019,4,9053,552,4124,1742,0,0,15471
2/18/2019,5,9052,924,4380,1462,0,0,15818
2/18/2019,6,9056,1275,4340,1268,0,0,15939
2/18/2019,7,9055,1518,4590,1079,0,0,16242
2/18/2019,8,9055,1874,4923,947,3,0,16802
2/18/2019,9,9051,1839,4959,846,25,0,16720
2/18/2019,10,9049,2131,4963,797,65,2,17007
2/18/2019,11,9050,1997,4765,827,112,23,16774
2/18/2019,12,9052,1991,4423,928,214,52,16660
2/18/2019,13,9052,2096,4031,996,271,53,16499
2/18/2019,14,9054,2132,3975,778,285,53,16277
2/18/2019,15,9050,2359,3937,711,266,53,16376
2/18/2019,16,9052,2442,4208,768,228,53,16751
2/18/2019,17,9049,2584,4383,1368,146,53,17583
2/18/2019,18,9054,3087,5248,1288,25,53,18755
2/18/2019,19,9055,3466,5862,1174,0,53,19610
2/18/2019,20,9058,3596,5743,1153,0,53,19603
2/18/2019,21,9057,3196,5675,1120,0,53,19101
2/18/2019,22,9055,3249,5150,951,0,53,18458
2/18/2019,23,9055,2695,4811,781,0,13,17355
2/18/2019,24,9058,2362,4426,622,0,0,16468
2/19/2019,1,9054,1890,4456,525,0,0,15925
2/19/2019,2,9056,1940,4556,427,0,7,15986
2/19/2019,3,9050,2073,4524,285,0,11,15943
2/19/2019,4,9064,2034,4320,281,0,10,15709
2/19/2019,5,9066,2157,4357,277,0,12,15869
2/19/2019,6,9053,2345,4783,301,0,38,16520
2/19/2019,7,9051,2878,5351,302,1,85,17668
2/19/2019,8,9050,4087,5601,407,19,146,19310
2/19/2019,9,9052,4052,5519,405,120,106,19254
2/19/2019,10,9047,3361,5454,314,239,78,18493
2/19/2019,11,9050,3228,5405,342,311,77,18413
2/19/2019,12,9052,3003,5419,345,314,77,18210
2/19/2019,13,9072,2876,5231,382,296,78,17935
2/19/2019,14,9082,2720,5238,345,328,53,17766
2/19/2019,15,9087,2556,5122,299,332,58,17454
2/19/2019,16,9084,2694,5167,228,269,66,17508
2/19/2019,17,9084,3414,5487,211,148,75,18419
2/19/2019,18,9086,4029,5647,192,24,80,19058
2/19/2019,19,9081,4342,5742,311,0,86,19562
2/19/2019,20,9080,4448,5722,396,0,86,19732
2/19/2019,21,9076,4490,5465,407,0,86,19524
2/19/2019,22,9085,4036,5326,423,0,78,18948
2/19/2019,23,9083,3224,4983,398,0,36,17724
2/19/2019,24,9086,2119,4552,445,0,20,16222
2/20/2019,1,9083,1990,4611,452,0,13,16149
2/20/2019,2,9086,1964,4620,480,0,11,16161
2/20/2019,3,9084,1956,4577,582,0,11,16210
2/20/2019,4,9086,2105,4529,894,0,12,16626
2/20/2019,5,9087,1998,4184,1395,0,12,16676
2/20/2019,6,9089,2005,4105,1648,0,36,16883
2/20/2019,7,9086,2121,5130,2131,1,72,18541
2/20/2019,8,9087,2313,5230,2792,7,79,19508
2/20/2019,9,9088,2327,5241,2834,48,78,19616
2/20/2019,10,9090,2176,5392,2344,94,78,19174
2/20/2019,11,9087,2656,5303,2270,110,88,19514
2/20/2019,12,9087,1995,5223,2410,160,82,18957
2/20/2019,13,9084,1780,4990,2691,141,84,18770
2/20/2019,14,9083,1717,5122,2654,151,90,18817
2/20/2019,15,9083,1961,5271,2528,108,84,19035
2/20/2019,16,9085,1739,5290,2516,83,81,18794
2/20/2019,17,9084,1649,5445,2563,36,78,18855
2/20/2019,18,9085,1988,5403,2554,3,97,19130
2/20/2019,19,9084,1862,5634,2582,0,98,19260
2/20/2019,20,9084,1693,5699,2568,0,82,19126
2/20/2019,21,9081,1972,5654,2169,0,95,18971
2/20/2019,22,9078,2402,5457,2030,0,69,19036
2/20/2019,23,9081,1838,4483,2426,0,27,17855
2/20/2019,24,9084,1080,3636,2623,0,18,16441
2/21/2019,1,9078,565,3598,3013,0,12,16266
2/21/2019,2,9080,410,3864,3044,0,11,16409
2/21/2019,3,9088,413,4155,3021,0,10,16687
2/21/2019,4,9090,422,3719,3292,0,10,16533
2/21/2019,5,9089,575,3539,3353,0,11,16567
2/21/2019,6,9086,998,3557,3078,0,13,16732
2/21/2019,7,9088,1146,3948,3158,0,20,17360
2/21/2019,8,9090,1220,4321,3499,3,26,18159
2/21/2019,9,9088,1364,4760,3396,29,27,18664
2/21/2019,10,9083,1412,4921,3488,62,27,18993
2/21/2019,11,9085,1470,5000,3403,90,27,19075
2/21/2019,12,9089,1344,4769,3498,110,27,18837
2/21/2019,13,9090,1218,4500,3542,129,27,18506
2/21/2019,14,9090,1351,4115,3570,195,28,18349
2/21/2019,15,9090,1512,4079,3317,176,50,18224
2/21/2019,16,9088,1470,4441,2884,133,80,18096
2/21/2019,17,9088,1842,4462,2506,74,82,18054
2/21/2019,18,9088,1932,4981,2173,12,83,18269
2/21/2019,19,9086,1946,5483,1966,0,83,18564
2/21/2019,20,9091,2435,5565,1669,0,103,18863
2/21/2019,21,9092,2048,5456,1548,0,83,18227
2/21/2019,22,9085,2223,4968,1289,0,92,17657
2/21/2019,23,9089,1836,4388,1076,0,81,16470
2/21/2019,24,9093,1586,4388,937,0,30,16034
2/22/2019,1,9099,1474,4163,746,0,11,15493
2/22/2019,2,9100,1407,4512,546,0,10,15575
2/22/2019,3,9099,1550,4364,436,0,10,15459
2/22/2019,4,9094,1580,4278,375,0,10,15337
2/22/2019,5,9096,1954,3845,412,0,11,15318
2/22/2019,6,9094,2301,3818,260,0,13,15486
2/22/2019,7,9092,2572,4677,347,1,21,16710
2/22/2019,8,9090,3057,5234,318,13,28,17740
2/22/2019,9,9091,3209,5013,177,91,28,17609
2/22/2019,10,9093,2751,5031,59,203,27,17164
2/22/2019,11,9093,2683,5057,42,221,27,17123
2/22/2019,12,9093,2457,4758,36,215,49,16608
2/22/2019,13,9092,2406,4637,55,177,80,16447
2/22/2019,14,9092,2430,4932,69,154,83,16760
2/22/2019,15,9093,2638,4918,48,146,83,16926
2/22/2019,16,9092,2343,5151,74,105,83,16848
2/22/2019,17,9095,2457,5479,54,66,83,17234
2/22/2019,18,9095,2687,5579,63,15,103,17542
2/22/2019,19,9095,3212,5636,91,0,171,18205
2/22/2019,20,9096,2989,5527,89,0,127,17828
2/22/2019,21,9095,2585,5495,135,0,89,17399
2/22/2019,22,9088,2584,5243,180,0,101,17196
2/22/2019,23,9083,1917,4719,260,0,43,16022
2/22/2019,24,9084,1578,4403,443,0,16,15524
2/23/2019,1,9084,1311,4325,609,0,0,15329
2/23/2019,2,9088,1074,4150,830,0,1,15143
2/23/2019,3,9092,962,3925,1051,0,1,15031
2/23/2019,4,9086,910,3974,1125,0,0,15095
2/23/2019,5,9086,936,4205,1245,0,0,15472
2/23/2019,6,9084,896,3918,1626,0,0,15524
2/23/2019,7,9088,890,3995,1931,1,0,15905
2/23/2019,8,9090,894,4540,2095,16,0,16635
2/23/2019,9,9089,784,4848,2102,61,18,16902
2/23/2019,10,9089,695,4897,2247,119,55,17102
2/23/2019,11,9088,710,4684,2278,169,55,16984
2/23/2019,12,9085,736,4289,2288,206,55,16659
2/23/2019,13,9085,748,4032,2375,211,55,16506
2/23/2019,14,9082,761,3782,2255,208,55,16143
2/23/2019,15,9035,762,3935,2352,255,55,16394
2/23/2019,16,9085,765,3867,2197,150,55,16119
2/23/2019,17,9080,765,4266,2754,58,55,16978
2/23/2019,18,9081,768,4528,2852,6,55,17290
2/23/2019,19,9078,768,4693,2991,0,55,17585
2/23/2019,20,9084,766,4360,3034,0,55,17299
2/23/2019,21,9084,766,4290,3142,0,55,17337
2/23/2019,22,9075,764,4181,3235,0,18,17273
2/23/2019,23,9071,473,3675,3232,0,0,16451
2/23/2019,24,9076,360,3618,3242,0,0,16296
2/24/2019,1,9085,361,3445,3240,0,0,16131
2/24/2019,2,9089,360,3349,3149,0,0,15947
2/24/2019,3,9093,359,3298,3122,0,0,15872
2/24/2019,4,9089,358,3251,3164,0,0,15862
2/24/2019,5,9089,365,3215,3113,0,0,15782
2/24/2019,6,9092,440,3343,3301,0,0,16176
2/24/2019,7,9091,548,3595,3029,0,0,16263
2/24/2019,8,9086,545,4052,3064,3,0,16750
2/24/2019,9,9087,546,4433,3252,29,1,17348
2/24/2019,10,9086,612,4134,3414,41,2,17289
2/24/2019,11,9093,910,4180,3341,70,0,17594
2/24/2019,12,9092,891,4516,3379,37,0,17915
2/24/2019,13,9088,866,4525,3317,70,0,17866
2/24/2019,14,9090,896,4602,3265,66,0,17919
2/24/2019,15,9086,990,4674,3247,30,0,18027
2/24/2019,16,9077,1306,5006,3208,15,0,18612
2/24/2019,17,9079,1420,5051,3325,12,0,18887
2/24/2019,18,9081,1361,5216,3337,2,0,18997
2/24/2019,19,9075,1348,5546,3193,0,0,19162
2/24/2019,20,9073,1232,5333,3177,0,0,18815
2/24/2019,21,9066,1452,5297,3023,0,0,18838
2/24/2019,22,9070,1525,4645,2882,0,0,18122
2/24/2019,23,9076,1329,4027,2892,0,0,17324
2/24/2019,24,9076,1090,3851,2803,0,0,16820
2/25/2019,1,9076,897,3734,2693,0,0,16400
2/25/2019,2,9075,899,3857,2725,0,8,16564
2/25/2019,3,9075,956,3838,2671,0,11,16551
2/25/2019,4,9080,1018,3774,2831,0,12,16715
2/25/2019,5,9079,1327,3829,2458,0,12,16705
2/25/2019,6,9080,1650,3931,2217,0,16,16894
2/25/2019,7,9076,1900,4205,2215,1,23,17420
2/25/2019,8,9076,2185,4252,2772,8,28,18321
2/25/2019,9,9077,2311,4347,2777,49,28,18589
2/25/2019,10,9081,2289,4286,3047,81,28,18812
2/25/2019,11,9080,2292,4385,3208,126,27,19118
2/25/2019,12,9079,2290,4097,3063,199,27,18755
2/25/2019,13,9076,2052,4265,2697,232,27,18349
2/25/2019,14,9079,1902,4209,3023,207,27,18447
2/25/2019,15,9080,2059,4281,2781,185,27,18413
2/25/2019,16,9083,2201,4136,2735,135,27,18317
2/25/2019,17,9081,1970,4741,3269,74,27,19162
2/25/2019,18,9079,2191,5458,3155,13,27,19923
2/25/2019,19,9078,2116,5655,2806,0,27,19682
2/25/2019,20,9080,2391,5699,2522,0,27,19719
2/25/2019,21,9078,2866,5470,2238,0,27,19679
2/25/2019,22,9074,2706,5128,2020,0,27,18955
2/25/2019,23,9074,2288,4516,1789,0,27,17694
2/25/2019,24,9077,2091,4222,1606,0,21,17017
2/26/2019,1,9080,2178,3924,1670,0,13,16865
2/26/2019,2,9081,2203,4069,1542,0,9,16904
2/26/2019,3,9076,2322,3920,1324,0,9,16651
2/26/2019,4,9080,2411,3810,1249,0,9,16559
2/26/2019,5,9079,2442,3863,1005,0,9,16398
2/26/2019,6,9078,2752,4213,897,0,14,16954
2/26/2019,7,9082,3340,4581,781,1,19,17804
2/26/2019,8,9081,4623,4441,769,10,26,18950
2/26/2019,9,9081,4357,4425,916,58,27,18864
2/26/2019,10,9084,3902,4504,1028,135,27,18680
2/26/2019,11,9085,3601,4334,1008,151,27,18206
2/26/2019,12,9084,3692,4159,904,218,27,18084
2/26/2019,13,9085,3552,4028,914,228,27,17834
2/26/2019,14,9085,3319,4041,838,216,27,17526
2/26/2019,15,9087,3360,4390,808,205,27,17877
2/26/2019,16,9087,2955,4597,770,186,23,17618
2/26/2019,17,9086,4012,5096,559,91,27,18871
2/26/2019,18,9090,4832,5455,335,18,27,19757
2/26/2019,19,9088,4952,5594,258,0,27,19919
2/26/2019,20,9088,4947,5598,280,0,27,19940
2/26/2019,21,9088,4858,5485,297,0,27,19755
2/26/2019,22,9080,4937,5164,334,0,27,19542
2/26/2019,23,9071,3442,4908,390,0,27,17838
2/26/2019,24,9079,3029,4350,399,0,23,16880
2/27/2019,1,9084,3400,3940,419,0,15,16858
2/27/2019,2,9081,3043,3841,587,0,10,16562
2/27/2019,3,9084,2758,3540,742,0,10,16134
2/27/2019,4,9086,2796,3395,924,0,10,16211
2/27/2019,5,9086,2854,3591,1176,0,11,16718
2/27/2019,6,9084,3106,4125,1231,0,15,17561
2/27/2019,7,9087,3625,4634,1323,1,20,18690
2/27/2019,8,9088,4437,4808,1536,5,27,19901
2/27/2019,9,9087,4354,4788,1869,30,27,20155
2/27/2019,10,9090,3851,4756,1707,50,27,19481
2/27/2019,11,9086,4308,4618,1479,57,27,19575
2/27/2019,12,9089,4381,4608,1074,71,27,19250
2/27/2019,13,9085,4832,4649,753,64,27,19410
2/27/2019,14,9081,4790,4723,580,45,16,19235
2/27/2019,15,9081,4834,4862,524,37,24,19362
2/27/2019,16,9078,4480,4988,421,26,27,19020
2/27/2019,17,9080,4753,5343,350,11,27,19564
2/27/2019,18,9081,4759,5582,356,3,26,19807
2/27/2019,19,9082,4615,5933,376,0,27,20033
2/27/2019,20,9079,4693,5795,498,0,27,20092
2/27/2019,21,9079,4364,5719,793,0,27,19982
2/27/2019,22,9074,4114,5166,973,0,27,19354
2/27/2019,23,9074,3657,4441,890,0,27,18089
2/27/2019,24,9076,2926,4145,804,0,16,16967
2/28/2019,1,9076,2580,4168,643,0,15,16482
2/28/2019,2,9090,2493,4239,511,0,12,16345
2/28/2019,3,9088,2674,4144,381,0,11,16298
2/28/2019,4,9086,2735,4181,292,0,10,16304
2/28/2019,5,9085,2973,4198,207,0,10,16473
2/28/2019,6,9085,3841,4437,132,0,13,17508
2/28/2019,7,9088,4538,5141,105,0,16,18888
2/28/2019,8,9085,4739,5269,173,3,26,19295
2/28/2019,9,9085,4630,5250,192,20,27,19204
2/28/2019,10,9084,4815,5162,157,58,27,19303
2/28/2019,11,9089,4410,5203,105,106,27,18940
2/28/2019,12,9090,3954,5015,98,148,27,18332
2/28/2019,13,9093,3612,4595,93,180,27,17600
2/28/2019,14,9092,3291,4543,91,200,27,17244
2/28/2019,15,9048,2929,4745,108,191,27,17048
2/28/2019,16,9093,3151,4952,142,142,27,17507
2/28/2019,17,9090,3586,5329,177,76,31,18289
2/28/2019,18,9090,4268,5827,209,18,28,19440
2/28/2019,19,9086,4663,5871,266,0,27,19913
2/28/2019,20,9091,4573,5898,381,0,28,19971
2/28/2019,21,9092,4277,5835,534,0,30,19768
2/28/2019,22,9092,4009,5543,599,0,32,19275
2/28/2019,23,9085,4096,4714,657,0,29,18581
2/28/2019,24,9086,3301,4300,565,0,12,17264
3/1/2019,1,9088,2744,4125,545,0,11,16513
3/1/2019,2,9084,2444,4086,540,0,11,16165
3/1/2019,3,9088,2436,3962,552,0,11,16049
3/1/2019,4,9095,2522,4061,480,0,10,16168
3/1/2019,5,9089,2504,4254,453,0,14,16314
3/1/2019,6,9092,2943,4691,411,0,29,17166
3/1/2019,7,9097,3582,5203,386,1,85,18354
3/1/2019,8,9098,4281,5268,348,31,189,19215
3/1/2019,9,9098,3717,5175,314,116,158,18578
3/1/2019,10,9097,3294,4933,173,198,136,17831
3/1/2019,11,9098,2965,4618,72,271,95,17119
3/1/2019,12,9096,3327,4444,35,314,124,17340
3/1/2019,13,9097,2763,4558,43,284,91,16836
3/1/2019,14,9096,2524,4184,59,344,78,16285
3/1/2019,15,9098,2297,4328,86,321,80,16210
3/1/2019,16,9093,2378,4313,83,249,81,16197
3/1/2019,17,9096,2866,4751,68,115,81,16977
3/1/2019,18,9095,3649,5073,106,28,81,18032
3/1/2019,19,9097,4038,5482,144,0,91,18852
3/1/2019,20,9096,3891,5520,211,0,85,18803
3/1/2019,21,9096,4144,4956,393,0,84,18673
3/1/2019,22,9095,3374,4634,480,0,84,17667
3/1/2019,23,9094,2776,4098,537,0,81,16586
3/1/2019,24,9094,1901,4176,520,0,29,15720
3/2/2019,1,9094,712,4242,399,0,7,14454
3/2/2019,2,9096,462,4352,340,0,0,14250
3/2/2019,3,9098,293,4471,234,0,0,14096
3/2/2019,4,9095,293,4470,212,0,0,14070
3/2/2019,5,9094,370,4696,233,0,0,14393
3/2/2019,6,9093,665,5067,186,0,21,15032
3/2/2019,7,9091,928,4665,160,1,73,14918
3/2/2019,8,9098,1205,4665,230,18,147,15363
3/2/2019,9,9097,1486,4954,228,65,99,15929
3/2/2019,10,9092,1836,5041,141,99,63,16272
3/2/2019,11,9088,1999,4886,90,118,59,16240
3/2/2019,12,9087,2320,4800,62,182,59,16510
3/2/2019,13,9088,2150,4690,182,162,59,16331
3/2/2019,14,9087,1954,4184,302,173,52,15752
3/2/2019,15,9089,1914,4024,675,116,51,15869
3/2/2019,16,9091,1618,4231,937,67,51,15995
3/2/2019,17,9089,1449,3974,1446,31,51,16040
3/2/2019,18,9087,1308,4358,1757,8,51,16569
3/2/2019,19,9092,1313,4850,1492,0,51,16798
3/2/2019,20,9092,1322,5046,1319,0,52,16831
3/2/2019,21,9090,1016,5008,1148,0,53,16315
3/2/2019,22,9089,925,4758,981,0,52,15805
3/2/2019,23,9077,954,4485,819,0,13,15348
3/2/2019,24,9066,656,4377,655,0,0,14754
3/3/2019,1,9081,538,4233,497,0,0,14349
3/3/2019,2,9082,530,4096,564,0,0,14272
3/3/2019,3,9065,487,3906,627,0,0,14085
3/3/2019,4,9042,726,4162,555,0,0,14485
3/3/2019,5,9033,996,4218,447,0,0,14694
3/3/2019,6,9033,1226,4419,318,0,0,14996
3/3/2019,7,9030,1448,4510,264,1,0,15253
3/3/2019,8,9030,1408,4256,210,14,0,14918
3/3/2019,9,9026,1315,4481,121,91,0,15034
3/3/2019,10,9027,1319,4458,110,160,0,15074
3/3/2019,11,9073,1330,4189,152,183,0,14927
3/3/2019,12,9080,1399,4435,242,176,0,15332
3/3/2019,13,9077,1446,4402,290,96,0,15311
3/3/2019,14,9080,1564,4487,246,85,0,15462
3/3/2019,15,9085,1599,4671,259,74,0,15688
3/3/2019,16,9046,1579,4624,322,44,20,15635
3/3/2019,17,9045,1507,5089,360,19,51,16071
3/3/2019,18,9041,1615,5610,361,5,59,16691
3/3/2019,19,9054,2105,5815,582,0,129,17685
3/3/2019,20,9055,1715,5552,733,0,111,17166
3/3/2019,21,9042,1450,5680,742,0,59,16973
3/3/2019,22,9025,1177,5193,765,0,55,16215
3/3/2019,23,9014,1131,4599,763,0,15,15522
3/3/2019,24,8755,1438,4479,735,0,0,15407
3/4/2019,1,8490,1250,4098,929,0,0,14767
3/4/2019,2,8492,1125,3697,1293,0,0,14607
3/4/2019,3,8502,1312,3519,1480,0,0,14813
3/4/2019,4,8531,1437,3711,1329,0,5,15013
3/4/2019,5,8566,1779,3756,1152,0,7,15260
3/4/2019,6,8565,2221,4347,900,0,31,16064
3/4/2019,7,8561,2781,5053,746,1,65,17207
3/4/2019,8,8558,3815,5315,701,9,98,18496
3/4/2019,9,8558,3681,5331,537,44,68,18219
3/4/2019,10,8562,3634,5297,376,113,85,18067
3/4/2019,11,8557,3227,4973,542,222,88,17609
3/4/2019,12,8561,2598,4737,1179,256,79,17410
3/4/2019,13,8561,2409,4273,1758,233,77,17311
3/4/2019,14,8562,2169,4150,1913,273,82,17149
3/4/2019,15,8564,2000,4117,2404,250,83,17418
3/4/2019,16,8555,1947,4193,2555,212,83,17545
3/4/2019,17,8560,2074,4545,2527,116,83,17905
3/4/2019,18,8564,2273,5006,2442,22,83,18390
3/4/2019,19,8565,2376,5698,2461,0,83,19183
3/4/2019,20,8565,2300,5357,2815,0,83,19120
3/4/2019,21,8564,2104,5186,2875,0,81,18810
3/4/2019,22,8564,1928,4871,2815,0,77,18255
3/4/2019,23,8566,1818,4419,2670,0,40,17513
3/4/2019,24,8566,1567,3930,2363,0,18,16444
3/5/2019,1,8562,1124,3916,2141,0,14,15757
3/5/2019,2,8567,1170,3964,2266,0,14,15981
3/5/2019,3,8561,1280,3474,2446,0,14,15775
3/5/2019,4,8557,1376,3433,2639,0,14,16019
3/5/2019,5,8552,1512,3566,2191,0,13,15834
3/5/2019,6,8561,1658,3593,2644,0,16,16472
3/5/2019,7,8569,1818,4062,2983,1,41,17474
3/5/2019,8,8563,2047,4717,3140,27,71,18565
3/5/2019,9,8563,2053,4735,3298,106,78,18833
3/5/2019,10,8566,2051,4784,3313,185,78,18977
3/5/2019,11,8567,1890,4513,3152,217,80,18419
3/5/2019,12,8559,1541,4459,3251,236,64,18110
3/5/2019,13,8561,1530,4209,3289,223,80,17892
3/5/2019,14,8562,1690,4207,3422,205,82,18168
3/5/2019,15,8561,1896,4540,3281,189,85,18552
3/5/2019,16,8561,1934,4791,2978,149,90,18503
3/5/2019,17,8564,2094,5395,2530,88,90,18761
3/5/2019,18,8567,2369,5802,2268,25,91,19122
3/5/2019,19,8565,3058,5905,2095,0,107,19730
3/5/2019,20,8564,3307,5773,2211,0,168,20023
3/5/2019,21,8558,3238,5760,2260,0,140,19956
3/5/2019,22,8558,2782,5248,2333,0,88,19009
3/5/2019,23,8562,2246,4385,2566,0,50,17809
3/5/2019,24,8558,1963,3597,2695,0,27,16840
3/6/2019,1,8561,1637,3612,2795,0,22,16627
3/6/2019,2,8561,1510,4032,2562,0,21,16686
3/6/2019,3,8560,1649,4081,2639,0,19,16948
3/6/2019,4,8561,1748,3611,2799,0,19,16738
3/6/2019,5,8566,2026,3786,2490,0,21,16889
3/6/2019,6,8566,2318,4743,2227,1,26,17881
3/6/2019,7,8564,3272,5252,2047,1,52,19188
3/6/2019,8,8563,4182,5457,1735,30,98,20065
3/6/2019,9,8565,4336,5407,1437,95,152,19992
3/6/2019,10,8560,3268,5301,1480,191,99,18899
3/6/2019,11,8569,2722,4893,1793,260,89,18326
3/6/2019,12,8568,2250,4458,2098,301,90,17765
3/6/2019,13,8567,2049,4498,2069,298,90,17571
3/6/2019,14,8566,2211,4771,1895,294,90,17827
3/6/2019,15,8562,2397,4651,1793,269,90,17762
3/6/2019,16,8567,2508,4476,1621,195,90,17457
3/6/2019,17,8563,2685,5158,1558,144,90,18198
3/6/2019,18,8565,3029,5831,1436,39,90,18990
3/6/2019,19,8565,4014,6008,1218,0,104,19909
3/6/2019,20,8565,4270,5930,1291,0,122,20178
3/6/2019,21,8564,4212,5677,1312,0,87,19852
3/6/2019,22,8550,3721,5415,1277,0,86,19049
3/6/2019,23,8544,3562,4811,1226,0,49,18192
3/6/2019,24,8547,2939,4384,1482,0,27,17379
3/7/2019,1,8558,2309,4442,1423,0,22,16754
3/7/2019,2,8560,2148,4479,1292,0,20,16499
3/7/2019,3,8552,2487,4351,1267,0,19,16676
3/7/2019,4,8555,2391,4232,1413,0,18,16609
3/7/2019,5,8546,2539,4631,1431,0,18,17165
3/7/2019,6,8553,2776,5046,1433,0,23,17831
3/7/2019,7,8562,3514,5392,1297,1,30,18796
3/7/2019,8,8566,4196,5428,1032,24,35,19281
3/7/2019,9,8566,4163,5311,690,111,33,18874
3/7/2019,10,8563,3766,5171,658,253,32,18443
3/7/2019,11,8561,3257,4807,913,263,36,17837
3/7/2019,12,8551,3087,4617,1235,254,37,17781
3/7/2019,13,8545,2940,4552,1338,278,36,17689
3/7/2019,14,8540,3064,4389,1322,306,37,17658
3/7/2019,15,8539,2951,4479,1303,270,53,17595
3/7/2019,16,8543,2832,4808,1064,219,82,17548
3/7/2019,17,8555,3369,5349,870,140,90,18373
3/7/2019,18,8547,3742,5943,681,37,98,19048
3/7/2019,19,8539,4579,5927,541,0,118,19704
3/7/2019,20,8539,4339,5883,624,0,106,19491
3/7/2019,21,8539,4112,5742,765,0,96,19254
3/7/2019,22,8536,4041,5345,894,0,94,18910
3/7/2019,23,8535,3806,4644,1017,0,55,18057
3/7/2019,24,8544,2946,4251,1200,0,33,16974
3/8/2019,1,8546,2049,4221,1270,0,22,16108
3/8/2019,2,8536,1542,4330,1199,0,21,15628
3/8/2019,3,8543,1678,4277,1235,0,20,15753
3/8/2019,4,8543,1820,4177,1201,0,20,15761
3/8/2019,5,8547,2505,4331,1047,0,20,16450
3/8/2019,6,8548,2776,4525,953,0,26,16828
3/8/2019,7,8557,3295,5119,1011,2,34,18018
3/8/2019,8,8558,3495,5227,973,50,37,18340
3/8/2019,9,8553,3307,5244,761,168,37,18070
3/8/2019,10,8548,3565,5149,440,276,37,18015
3/8/2019,11,8550,3632,4931,349,324,37,17823
3/8/2019,12,8554,3452,4601,435,323,37,17402
3/8/2019,13,8556,3283,4398,421,338,24,17020
3/8/2019,14,8551,3100,4283,344,342,27,16647
3/8/2019,15,8552,2848,4319,311,350,27,16407
3/8/2019,16,8558,2663,4320,268,317,51,16177
3/8/2019,17,8568,2823,4435,253,196,82,16357
3/8/2019,18,8559,2939,5202,196,60,81,17037
3/8/2019,19,8563,3957,5289,230,1,85,18125
3/8/2019,20,8565,4417,5245,260,0,104,18591
3/8/2019,21,8563,4037,5043,261,0,87,17991
3/8/2019,22,8565,3573,4669,317,0,83,17207
3/8/2019,23,8560,3241,4196,348,0,84,16429
3/8/2019,24,8564,2363,4070,320,0,35,15352
3/9/2019,1,8564,2182,4034,298,0,6,15084
3/9/2019,2,8567,2006,3910,268,0,0,14751
3/9/2019,3,8564,1991,3853,227,0,0,14635
3/9/2019,4,8570,2063,3798,235,0,0,14666
3/9/2019,5,8567,2112,3902,239,0,1,14821
3/9/2019,6,8563,2387,4315,273,1,0,15539
3/9/2019,7,8564,2471,4716,467,2,20,16240
3/9/2019,8,8562,2324,4786,602,71,48,16393
3/9/2019,9,8564,2220,4424,640,208,54,16110
3/9/2019,10,8568,2125,4120,1013,322,51,16199
3/9/2019,11,8562,1962,3937,1437,366,51,16315
3/9/2019,12,8555,1948,3929,1921,373,51,16777
3/9/2019,13,8558,1946,3676,2012,369,51,16612
3/9/2019,14,8559,1938,3604,2080,360,10,16551
3/9/2019,15,8556,1627,3834,2252,337,0,16606
3/9/2019,16,8557,1527,3534,2800,248,0,16666
3/9/2019,17,8557,1527,3705,3379,114,0,17282
3/9/2019,18,8548,1526,3932,3761,28,0,17795
3/9/2019,19,8547,1527,4538,4066,0,0,18678
3/9/2019,20,8542,1528,4472,4087,0,0,18629
3/9/2019,21,8541,1417,4173,4091,0,1,18223
3/9/2019,22,8538,1330,3779,4033,0,1,17681
3/9/2019,23,8530,528,4062,3889,0,0,17009
3/9/2019,24,8535,337,3923,3909,0,0,16704
3/10/2019,1,8541,329,3658,3823,0,0,16351
3/10/2019,2,8542,329,4059,3442,0,0,16372
3/10/2019,3,8536,329,3828,3458,0,0,16151
3/10/2019,4,8536,329,2992,3568,0,6,15431
3/10/2019,5,8545,329,3180,3665,0,3,15722
3/10/2019,6,8548,328,3394,3699,0,8,15977
3/10/2019,7,8547,327,3833,3720,1,3,16431
3/10/2019,8,8546,358,4388,3680,3,0,16975
3/10/2019,9,8544,596,4629,3799,16,0,17584
3/10/2019,10,8541,522,4594,3845,47,0,17549
3/10/2019,11,8538,639,4843,3679,63,0,17762
3/10/2019,12,8545,841,4626,3596,76,0,17684
3/10/2019,13,8546,755,4156,3813,83,0,17353
3/10/2019,14,8543,606,4412,3680,54,0,17295
3/10/2019,15,8541,623,4458,3769,37,0,17428
3/10/2019,16,8541,666,4430,3793,29,0,17459
3/10/2019,17,8538,649,4341,3988,11,0,17527
3/10/2019,18,8540,595,4377,4050,3,0,17565
3/10/2019,19,8539,566,4577,3875,0,0,17557
3/10/2019,20,8534,537,4256,4029,0,0,17356
3/10/2019,21,8537,520,4290,4075,0,0,17422
3/10/2019,22,8537,509,4069,3933,0,0,17048
3/10/2019,23,8538,602,3686,3898,0,0,16724
3/10/2019,24,8533,509,3313,3855,0,4,16214
3/11/2019,1,8528,513,3164,3820,0,13,16038
3/11/2019,2,8530,570,3067,3398,0,13,15578
3/11/2019,3,8532,720,2978,3625,0,13,15868
3/11/2019,4,8532,766,3082,3659,0,13,16052
3/11/2019,5,8527,915,3224,3312,0,14,15992
3/11/2019,6,8524,1265,3538,3375,0,20,16722
3/11/2019,7,8522,1566,3888,3479,1,24,17480
3/11/2019,8,8519,1731,4478,3212,36,25,18001
3/11/2019,9,8522,2041,4330,3304,108,25,18330
3/11/2019,10,8513,1809,4350,3391,129,25,18217
3/11/2019,11,8515,1853,4204,3280,146,26,18024
3/11/2019,12,8513,1770,4255,3028,180,26,17772
3/11/2019,13,8400,1701,4212,3130,166,25,17634
3/11/2019,14,8350,1758,4105,3229,174,26,17642
3/11/2019,15,8352,1589,3887,3496,156,27,17507
3/11/2019,16,8452,1513,3942,3508,121,27,17563
3/11/2019,17,8495,1519,4412,3308,65,27,17826
3/11/2019,18,8500,1604,4879,2882,22,27,17914
3/11/2019,19,8505,1783,5179,2366,1,27,17861
3/11/2019,20,8502,2079,5061,2206,0,27,17875
3/11/2019,21,8514,1756,4530,2166,0,27,16993
3/11/2019,22,8555,1654,4086,2100,0,27,16422
3/11/2019,23,8597,1437,3612,1956,0,18,15620
3/11/2019,24,8624,1384,3466,1897,0,12,15383
3/12/2019,1,8689,1409,3340,1793,0,11,15242
3/12/2019,2,8744,1442,3468,1473,0,10,15137
3/12/2019,3,8765,1745,3596,1391,0,10,15507
3/12/2019,4,8764,2217,3207,1328,0,10,15526
3/12/2019,5,8763,2694,3378,856,0,15,15706
3/12/2019,6,8763,2754,3941,982,0,22,16462
3/12/2019,7,8760,3796,4826,697,2,26,18107
3/12/2019,8,8761,4306,4821,500,32,27,18447
3/12/2019,9,8760,4096,4698,420,112,27,18113
3/12/2019,10,8761,3776,4331,444,223,27,17562
3/12/2019,11,8758,3376,4223,400,326,27,17110
3/12/2019,12,8855,2782,4000,576,350,27,16590
3/12/2019,13,8922,2167,3732,827,356,26,16030
3/12/2019,14,8931,2129,3564,960,353,27,15964
3/12/2019,15,8935,2218,3397,1152,363,27,16092
3/12/2019,16,8933,2351,3330,947,315,26,15902
3/12/2019,17,8929,2531,3565,1109,199,27,16360
3/12/2019,18,8929,2583,4036,1128,67,27,16770
3/12/2019,19,8929,2518,4689,1454,1,28,17619
3/12/2019,20,8933,2505,4789,1670,0,27,17924
3/12/2019,21,8933,2360,4485,1762,0,27,17567
3/12/2019,22,8962,1990,3922,1747,0,27,16648
3/12/2019,23,8974,1243,3818,1646,0,19,15700
3/12/2019,24,8993,825,3763,1725,0,14,15320
3/13/2019,1,8993,732,3239,1813,0,11,14788
3/13/2019,2,8995,745,3170,1872,0,11,14793
3/13/2019,3,8985,805,3068,1915,0,11,14784
3/13/2019,4,8986,1056,3157,1675,0,11,14885
3/13/2019,5,8982,1384,3566,1434,0,13,15379
3/13/2019,6,8973,1804,3737,1371,0,22,15907
3/13/2019,7,8974,1975,4514,1715,2,27,17207
3/13/2019,8,8972,2047,4689,2110,12,27,17857
3/13/2019,9,8987,1950,4414,2212,30,28,17621
3/13/2019,10,8995,1830,4474,2170,60,27,17556
3/13/2019,11,8994,2275,3998,2148,78,27,17520
3/13/2019,12,8990,2127,3854,2160,90,27,17248
3/13/2019,13,8846,2189,3819,2107,106,27,17094
3/13/2019,14,8816,2079,3795,2026,125,27,16868
3/13/2019,15,8900,2459,4058,1512,77,27,17033
3/13/2019,16,8994,2872,4447,1021,80,27,17441
3/13/2019,17,9003,2864,4567,907,57,27,17425
3/13/2019,18,9005,2440,4786,982,23,27,17263
3/13/2019,19,9004,2295,4971,1280,0,27,17577
3/13/2019,20,9000,2218,4918,1503,0,27,17666
3/13/2019,21,8989,2084,4412,1904,0,27,17416
3/13/2019,22,8983,1663,4026,2265,0,27,16964
3/13/2019,23,8989,941,3564,2580,0,17,16091
3/13/2019,24,8992,340,3453,2721,0,13,15519
3/14/2019,1,8993,261,3330,2821,0,13,15418
3/14/2019,2,8993,261,3286,2818,0,12,15370
3/14/2019,3,8991,272,3043,2923,0,12,15241
3/14/2019,4,8991,435,3048,2807,0,13,15294
3/14/2019,5,8987,673,3116,2895,0,16,15687
3/14/2019,6,8984,968,3192,3142,0,21,16307
3/14/2019,7,8989,1125,3906,3223,1,27,17271
3/14/2019,8,8983,1190,4535,3315,29,27,18079
3/14/2019,9,8981,1308,4186,3330,72,27,17904
3/14/2019,10,8977,1316,4192,3413,126,27,18051
3/14/2019,11,8922,1312,4138,3574,132,27,18105
3/14/2019,12,8919,1314,3791,3704,105,27,17860
3/14/2019,13,8920,1176,4023,3768,92,27,18006
3/14/2019,14,8922,1119,4494,3404,117,27,18083
3/14/2019,15,8940,939,4889,2779,87,27,17661
3/14/2019,16,8958,847,4282,3250,75,27,17439
3/14/2019,17,8960,766,3885,3147,35,27,16820
3/14/2019,18,8983,708,4346,3293,15,27,17372
3/14/2019,19,8979,898,4918,3343,1,27,18166
3/14/2019,20,8975,948,4590,3461,0,26,18000
3/14/2019,21,8978,904,4128,3890,0,26,17926
3/14/2019,22,8974,805,3673,3798,0,26,17276
3/14/2019,23,8970,703,3272,3618,0,16,16579
3/14/2019,24,8967,651,3088,3325,0,14,16045
3/15/2019,1,8975,301,2851,3431,0,14,15572
3/15/2019,2,8974,252,2798,3353,0,13,15390
3/15/2019,3,8980,254,2727,3461,0,13,15435
3/15/2019,4,8988,254,2809,3551,0,14,15616
3/15/2019,5,8996,254,2788,3766,0,14,15818
3/15/2019,6,8992,252,3006,3931,0,19,16200
3/15/2019,7,8995,256,3846,3950,3,27,17077
3/15/2019,8,8997,265,4235,3956,18,27,17498
3/15/2019,9,8995,350,4620,3969,31,27,17992
3/15/2019,10,8996,409,4836,3932,56,27,18256
3/15/2019,11,8995,517,4509,3943,73,27,18064
3/15/2019,12,8993,697,3906,3983,116,27,17722
3/15/2019,13,9001,952,4073,3922,93,27,18068
3/15/2019,14,9009,908,3851,3917,78,27,17790
3/15/2019,15,9019,859,4029,3906,82,27,17922
3/15/2019,16,9009,742,4116,3901,48,27,17843
3/15/2019,17,9007,681,4618,3670,25,27,18028
3/15/2019,18,9007,938,5048,3403,5,27,18428
3/15/2019,19,9007,859,5041,3384,0,27,18318
3/15/2019,20,9005,721,4504,3422,0,27,17679
3/15/2019,21,9005,513,4620,3674,0,27,17839
3/15/2019,22,9000,292,4008,3665,0,27,16992
3/15/2019,23,9001,255,3640,3682,0,27,16605
3/15/2019,24,9008,255,3560,3602,0,21,16446
3/16/2019,1,9016,259,3635,3255,0,9,16174
3/16/2019,2,9015,257,3663,2987,0,0,15922
3/16/2019,3,9016,244,3376,3049,0,0,15685
3/16/2019,4,9020,226,3304,3063,0,0,15613
3/16/2019,5,9018,227,3364,2915,0,0,15524
3/16/2019,6,9020,227,3528,2740,1,0,15516
3/16/2019,7,9017,233,3657,2625,1,0,15533
3/16/2019,8,9015,263,4241,2475,14,0,16008
3/16/2019,9,9019,403,4211,2660,81,0,16374
3/16/2019,10,9014,476,3920,2734,184,0,16328
3/16/2019,11,9001,423,3566,2681,231,0,15902
3/16/2019,12,9018,434,3562,3038,259,0,16311
3/16/2019,13,9017,544,3704,3022,207,0,16494
3/16/2019,14,9017,474,3909,2932,172,0,16504
3/16/2019,15,8982,852,4043,3030,169,0,17076
3/16/2019,16,9020,1024,4252,2863,125,0,17284
3/16/2019,17,9036,1162,4713,2620,57,0,17588
3/16/2019,18,9039,1304,5121,2235,21,0,17720
3/16/2019,19,9039,1301,5216,1987,1,1,17545
3/16/2019,20,9033,1310,5157,2028,0,0,17528
3/16/2019,21,9030,1316,5145,2101,0,0,17592
3/16/2019,22,9032,1327,4663,2142,0,0,17164
3/16/2019,23,9040,1462,4434,1976,0,0,16912
3/16/2019,24,9056,1453,3700,1983,0,0,16192
3/17/2019,1,9054,964,3594,1774,0,0,15386
3/17/2019,2,9054,840,3575,1611,0,0,15080
3/17/2019,3,9053,724,3799,1347,0,3,14926
3/17/2019,4,9048,723,3747,949,0,11,14478
3/17/2019,5,9053,1037,4182,578,0,14,14864
3/17/2019,6,9051,1268,4160,311,1,16,14807
3/17/2019,7,9054,1385,4103,170,3,31,14746
3/17/2019,8,9054,1511,4183,215,40,22,15025
3/17/2019,9,9051,1343,4112,226,151,28,14911
3/17/2019,10,9049,1438,4121,279,281,25,15193
3/17/2019,11,9049,1462,3649,507,319,26,15012
3/17/2019,12,9052,1474,3309,791,331,24,14981
3/17/2019,13,9055,1448,3291,995,317,23,15129
3/17/2019,14,9052,1277,3441,1079,322,20,15191
3/17/2019,15,9038,1286,3927,1056,279,12,15598
3/17/2019,16,9041,1426,3894,971,216,7,15555
3/17/2019,17,9040,1513,4504,847,133,7,16044
3/17/2019,18,9042,1445,4597,670,52,2,15808
3/17/2019,19,9043,1658,5278,535,5,1,16520
3/17/2019,20,9038,1987,5397,528,0,1,16951
3/17/2019,21,9035,1744,5115,571,0,0,16465
3/17/2019,22,9034,1815,4696,536,0,1,16082
3/17/2019,23,9039,1992,4307,457,0,1,15796
3/17/2019,24,9037,1794,3878,458,0,0,15167
3/18/2019,1,9040,1559,3712,411,0,0,14722
3/18/2019,2,9038,1886,3649,378,0,8,14959
3/18/2019,3,9027,2215,3583,367,0,12,15204
3/18/2019,4,9015,2114,3600,351,0,13,15093
3/18/2019,5,9010,2273,3507,360,0,20,15170
3/18/2019,6,9017,3397,4319,352,1,43,17129
3/18/2019,7,9017,4150,4677,390,7,86,18327
3/18/2019,8,9013,3812,4552,360,54,102,17893
3/18/2019,9,9011,3780,4466,211,141,101,17710
3/18/2019,10,9009,3632,4208,301,224,101,17475
3/18/2019,11,9009,3433,4087,369,298,101,17297
3/18/2019,12,9004,3247,3932,492,265,102,17042
3/18/2019,13,9011,2918,3869,614,248,98,16758
3/18/2019,14,9004,2644,3813,662,212,80,16415
3/18/2019,15,9000,2570,3525,860,176,80,16211
3/18/2019,16,9013,2586,3602,730,170,80,16181
3/18/2019,17,9027,2609,4061,692,142,80,16611
3/18/2019,18,9024,2765,4573,618,51,80,17111
3/18/2019,19,9008,3934,4810,456,4,106,18318
3/18/2019,20,9004,4072,4693,552,0,129,18450
3/18/2019,21,9001,3609,4667,807,0,96,18180
3/18/2019,22,9005,2648,4592,1043,0,50,17338
3/18/2019,23,9003,1934,4138,1127,0,18,16220
3/18/2019,24,9004,1476,3763,1110,0,13,15366
3/19/2019,1,9004,1585,3911,1052,0,13,15565
3/19/2019,2,9002,1615,3997,965,0,13,15592
3/19/2019,3,9004,1831,3889,790,0,13,15527
3/19/2019,4,9007,2295,3885,459,0,12,15658
3/19/2019,5,9008,2542,3524,299,0,13,15386
3/19/2019,6,9004,3602,4337,306,1,19,17269
3/19/2019,7,9001,4560,4580,289,6,26,18462
3/19/2019,8,9006,4470,4533,276,73,25,18383
3/19/2019,9,9010,3891,4496,131,205,26,17759
3/19/2019,10,9007,3262,4365,78,315,27,17054
3/19/2019,11,9012,2791,4076,132,337,27,16375
3/19/2019,12,9013,2514,3693,299,330,27,15876
3/19/2019,13,9010,2317,3489,584,287,28,15715
3/19/2019,14,9010,2446,3454,349,152,29,15440
3/19/2019,15,9008,2209,3535,997,262,30,16041
3/19/2019,16,9010,2169,3848,1064,242,35,16368
3/19/2019,17,9008,1994,4374,883,154,27,16440
3/19/2019,18,9008,1993,4591,822,54,26,16494
3/19/2019,19,9019,2559,4718,915,4,26,17241
3/19/2019,20,9024,2463,4663,1242,0,27,17419
3/19/2019,21,9018,2409,4500,1616,0,27,17570
3/19/2019,22,9024,1396,4048,1871,0,27,16366
3/19/2019,23,9038,529,3932,2068,0,18,15585
3/19/2019,24,9041,321,3746,2070,0,13,15191
3/20/2019,1,9044,324,3853,1964,0,13,15198
3/20/2019,2,9041,355,4032,1720,0,13,15161
3/20/2019,3,9042,565,4032,1714,0,13,15366
3/20/2019,4,9058,672,3376,1850,0,17,14973
3/20/2019,5,9067,911,3489,1897,0,31,15395
3/20/2019,6,9068,1448,3834,1978,1,36,16365
3/20/2019,7,9068,1751,4400,2217,7,41,17484
3/20/2019,8,9066,1732,4414,2154,75,42,17483
3/20/2019,9,9065,1678,4158,1845,162,39,16947
3/20/2019,10,9067,1560,4314,1698,274,40,16953
3/20/2019,11,9065,1387,3884,1895,319,42,16592
3/20/2019,12,9065,1347,3619,1884,313,39,16267
3/20/2019,13,9061,1433,3940,1915,308,43,16700
3/20/2019,14,9063,1514,3664,1833,274,38,16386
3/20/2019,15,9064,1625,3488,1792,259,39,16267
3/20/2019,16,9064,1813,3582,1590,178,42,16269
3/20/2019,17,9072,1975,3996,1354,79,38,16514
3/20/2019,18,9073,2193,4459,992,22,31,16770
3/20/2019,19,9074,2613,4494,1069,0,27,17277
3/20/2019,20,9071,2463,4411,1090,0,28,17063
3/20/2019,21,9068,2285,4290,1314,0,28,16985
3/20/2019,22,9067,1918,3735,1381,0,27,16128
3/20/2019,23,9061,990,3479,1372,0,18,14920
3/20/2019,24,9067,703,3666,1391,0,12,14839
3/21/2019,1,9065,744,3996,1217,0,9,15031
3/21/2019,2,9064,905,3918,1184,0,8,15079
3/21/2019,3,9060,955,3680,1035,0,9,14739
3/21/2019,4,9062,1257,3659,873,0,16,14867
3/21/2019,5,9062,1672,3252,786,0,36,14808
3/21/2019,6,9067,2044,3759,753,0,67,15690
3/21/2019,7,9069,2698,4372,814,4,89,17046
3/21/2019,8,9070,2961,4387,624,19,92,17153
3/21/2019,9,9070,3232,4301,470,41,92,17206
3/21/2019,10,9071,3477,4115,415,60,93,17231
3/21/2019,11,9069,3253,4036,405,67,91,16921
3/21/2019,12,9071,3317,3914,338,80,91,16811
3/21/2019,13,9069,2915,3954,299,114,119,16470
3/21/2019,14,9073,2667,3823,453,99,122,16237
3/21/2019,15,9066,2697,3835,517,76,97,16288
3/21/2019,16,9064,2695,3902,708,73,97,16539
3/21/2019,17,9060,2726,4319,678,43,116,16942
3/21/2019,18,9069,2629,4327,757,15,100,16897
3/21/2019,19,9070,2371,4508,898,0,102,16949
3/21/2019,20,9069,2487,4471,1038,0,127,17192
3/21/2019,21,9066,2233,4414,1084,0,88,16885
3/21/2019,22,9067,1654,4084,1044,0,84,15933
3/21/2019,23,9062,1193,3849,1057,0,73,15234
3/21/2019,24,9064,956,3730,1259,0,23,15032
3/22/2019,1,9060,702,3695,1455,0,6,14918
3/22/2019,2,9064,627,3490,1540,0,7,14728
3/22/2019,3,9062,652,3705,1523,0,9,14951
3/22/2019,4,9063,830,3805,1526,0,13,15237
3/22/2019,5,9070,1012,3470,1662,0,19,15233
3/22/2019,6,9074,1355,3698,1524,0,46,15697
3/22/2019,7,9071,1449,4048,2225,1,85,16879
3/22/2019,8,9068,1455,4128,2646,16,88,17401
3/22/2019,9,9069,1460,3934,2708,23,99,17293
3/22/2019,10,9068,1326,3969,2647,62,100,17172
3/22/2019,11,9068,1265,3815,3057,101,99,17405
3/22/2019,12,9062,1263,3650,2739,152,81,16947
3/22/2019,13,9066,1263,3591,3397,186,79,17582
3/22/2019,14,9063,1264,3589,3399,166,80,17561
3/22/2019,15,9066,777,3571,3277,185,80,16956
3/22/2019,16,9062,629,3745,3628,128,80,17272
3/22/2019,17,9064,628,4050,3727,93,60,17622
3/22/2019,18,9061,628,4215,3757,25,57,17743
3/22/2019,19,9065,633,4228,3644,2,61,17633
3/22/2019,20,9058,633,4212,3629,0,75,17607
3/22/2019,21,9051,631,4500,3334,0,78,17594
3/22/2019,22,9060,645,4159,3075,0,44,16983
3/22/2019,23,9057,506,3975,2934,0,15,16487
3/22/2019,24,9054,487,3962,2825,0,13,16341
3/23/2019,1,9051,394,3589,2896,0,0,15930
3/23/2019,2,9054,414,3633,2753,0,0,15854
3/23/2019,3,9054,521,3807,2718,0,0,16100
3/23/2019,4,9056,422,3653,2691,0,0,15822
3/23/2019,5,9062,455,3673,2548,0,0,15738
3/23/2019,6,9066,593,3756,2249,2,0,15666
3/23/2019,7,9061,605,4091,2188,10,0,15955
3/23/2019,8,9066,607,4140,2036,101,0,15950
3/23/2019,9,9067,610,3803,1718,242,0,15440
3/23/2019,10,9070,616,4090,1423,346,0,15545
3/23/2019,11,9071,881,4487,1091,375,0,15905
3/23/2019,12,9077,996,4143,1024,376,0,15616
3/23/2019,13,9072,943,3901,1034,376,0,15326
3/23/2019,14,9034,961,3658,1037,376,0,15066
3/23/2019,15,9066,1032,3617,1282,373,0,15370
3/23/2019,16,9072,1007,3516,1138,330,0,15063
3/23/2019,17,9077,1008,3926,1267,217,0,15495
3/23/2019,18,9072,1011,4393,1300,80,0,15856
3/23/2019,19,9075,1087,4797,1447,5,0,16411
3/23/2019,20,9069,1062,4653,2065,0,0,16849
3/23/2019,21,9067,860,4216,2244,0,0,16387
3/23/2019,22,9069,661,3890,2188,0,0,15808
3/23/2019,23,9062,312,3611,2315,0,0,15300
3/23/2019,24,9065,226,3561,2501,0,0,15353
3/24/2019,1,9059,226,3698,2607,0,0,15590
3/24/2019,2,9060,226,3718,2645,0,0,15649
3/24/2019,3,9066,226,3794,2558,0,0,15644
3/24/2019,4,9068,227,4005,2385,0,0,15685
3/24/2019,5,9068,233,4065,2272,0,0,15638
3/24/2019,6,9074,300,4265,2058,1,0,15698
3/24/2019,7,9073,263,4429,1968,10,0,15743
3/24/2019,8,9073,239,4410,1840,80,2,15644
3/24/2019,9,9074,234,4217,1828,161,0,15514
3/24/2019,10,9064,399,4794,1571,203,0,16031
3/24/2019,11,9064,444,4556,1441,202,0,15707
3/24/2019,12,9066,527,4287,1363,218,0,15461
3/24/2019,13,9069,741,3691,1323,250,1,15075
3/24/2019,14,9070,906,3729,1262,231,2,15200
3/24/2019,15,9072,914,4156,1122,250,17,15531
3/24/2019,16,9072,899,4319,1144,222,51,15707
3/24/2019,17,9070,945,4461,1165,138,58,15837
3/24/2019,18,9090,980,4746,1184,45,56,16101
3/24/2019,19,9119,989,4905,1206,4,63,16286
3/24/2019,20,9080,1340,4997,1087,0,69,16573
3/24/2019,21,8468,1540,4797,1094,0,100,15999
3/24/2019,22,8330,1429,4297,1393,0,88,15537
3/24/2019,23,8326,1106,3940,1550,0,64,14986
3/24/2019,24,8328,717,3719,1722,0,11,14497
3/25/2019,1,8324,703,3976,1883,0,0,14886
3/25/2019,2,8324,732,3976,1666,0,4,14702
3/25/2019,3,8319,934,4223,1508,0,12,14996
3/25/2019,4,8326,993,3896,1777,0,16,15008
3/25/2019,5,8336,1329,3612,1897,0,39,15213
3/25/2019,6,8342,2028,3768,1879,1,72,16090
3/25/2019,7,8336,2870,4649,1861,9,93,17818
3/25/2019,8,8340,2914,4633,1629,74,83,17673
3/25/2019,9,8340,2622,4297,1425,188,78,16950
3/25/2019,10,8340,2579,3970,1122,259,78,16348
3/25/2019,11,8341,2561,4178,888,276,78,16322
3/25/2019,12,8342,2803,4091,879,277,77,16469
3/25/2019,13,8341,2911,3961,1106,276,93,16688
3/25/2019,14,8342,2646,3964,1431,277,80,16740
3/25/2019,15,8359,2435,3721,1830,271,81,16697
3/25/2019,16,8359,2350,3514,2023,244,79,16569
3/25/2019,17,8350,2426,3764,2575,164,80,17359
3/25/2019,18,8351,2556,4499,2458,64,80,18008
3/25/2019,19,8352,3112,5035,1992,4,101,18596
3/25/2019,20,8358,3428,4830,1729,0,132,18477
3/25/2019,21,8360,2712,4787,1620,0,100,17579
3/25/2019,22,8355,2299,4125,1605,0,80,16464
3/25/2019,23,8353,1925,3490,1430,0,29,15227
3/25/2019,24,8356,1532,3621,1352,0,14,14875
3/26/2019,1,8357,1633,4044,1198,0,12,15244
3/26/2019,2,8352,1898,3951,997,0,12,15210
3/26/2019,3,8350,1985,3894,871,0,11,15111
3/26/2019,4,8339,2291,3747,929,0,12,15318
3/26/2019,5,8345,2796,3902,941,0,36,16020
3/26/2019,6,8346,3476,4151,820,1,73,16867
3/26/2019,7,8346,4482,4508,732,15,89,18172
3/26/2019,8,8344,3864,4451,528,116,85,17388
3/26/2019,9,8347,3235,4247,401,255,81,16566
3/26/2019,10,8353,2932,4397,302,352,79,16415
3/26/2019,11,8357,2761,4133,167,374,79,15871
3/26/2019,12,8356,2630,3965,127,376,79,15533
3/26/2019,13,8355,2524,3916,231,376,84,15486
3/26/2019,14,8357,2457,3783,376,376,82,15431
3/26/2019,15,8357,2547,3666,451,372,79,15472
3/26/2019,16,8354,2660,3752,445,331,78,15620
3/26/2019,17,8355,3188,4206,397,215,82,16443
3/26/2019,18,8355,3315,4517,296,80,82,16645
3/26/2019,19,8349,3949,4782,306,6,29,17421
3/26/2019,20,8347,4264,4755,329,0,25,17720
3/26/2019,21,8348,3790,4630,317,0,29,17114
3/26/2019,22,8351,3264,4333,347,0,32,16327
3/26/2019,23,8353,2328,3844,388,0,53,14966
3/26/2019,24,8355,1702,3864,399,0,53,14373
3/27/2019,1,8356,1594,3974,410,0,52,14386
3/27/2019,2,8357,1763,3998,541,0,52,14711
3/27/2019,3,8349,1762,3952,636,0,53,14752
3/27/2019,4,8352,2146,3961,687,0,54,15200
3/27/2019,5,8356,2595,4025,744,0,46,15766
3/27/2019,6,8352,3541,4539,816,1,57,17306
3/27/2019,7,8346,4314,4611,898,13,80,18262
3/27/2019,8,8346,3982,4576,898,91,117,18010
3/27/2019,9,8354,2868,4527,725,231,147,16852
3/27/2019,10,8355,2700,4057,787,319,154,16372
3/27/2019,11,8360,2496,3864,864,346,156,16086
3/27/2019,12,8371,2126,3735,972,352,149,15705
3/27/2019,13,8370,2050,3930,1039,345,146,15880
3/27/2019,14,8372,1621,3669,1077,318,146,15203
3/27/2019,15,8367,1502,3773,1158,299,125,15224
3/27/2019,16,8355,1642,3819,1268,246,108,15438
3/27/2019,17,8349,1914,3999,1329,146,137,15874
3/27/2019,18,8351,2155,4181,1367,48,148,16250
3/27/2019,19,8350,2402,4366,1516,5,153,16792
3/27/2019,20,8350,2306,4261,1959,0,135,17011
3/27/2019,21,8346,1939,4078,2272,0,106,16741
3/27/2019,22,8340,1313,3805,2631,0,67,16156
3/27/2019,23,8340,800,3628,2933,0,50,15751
3/27/2019,24,8332,725,3390,3149,0,45,15641
3/28/2019,1,8336,719,3337,3453,0,29,15874
3/28/2019,2,8337,408,3436,3662,0,21,15864
3/28/2019,3,8341,326,3505,3712,0,21,15905
3/28/2019,4,8343,451,3411,3726,0,37,15968
3/28/2019,5,8346,815,3373,3575,0,41,16150
3/28/2019,6,8343,1069,3650,3561,1,50,16674
3/28/2019,7,8346,1158,3947,3754,5,54,17264
3/28/2019,8,8344,1162,4122,3795,27,52,17502
3/28/2019,9,8348,1230,4313,3788,51,45,17775
3/28/2019,10,8345,1351,4261,3671,59,44,17731
3/28/2019,11,8343,1190,4071,3582,72,39,17297
3/28/2019,12,8339,1157,3652,3401,130,41,16720
3/28/2019,13,8337,1264,3500,2948,147,37,16233
3/28/2019,14,8335,1395,3554,2721,148,28,16181
3/28/2019,15,8331,1661,3774,2956,97,30,16849
3/28/2019,16,8329,2427,4016,2563,83,44,17462
3/28/2019,17,8332,2415,4217,2168,59,74,17265
3/28/2019,18,8345,2272,3995,2094,32,78,16816
3/28/2019,19,8342,2242,4289,1993,4,77,16947
3/28/2019,20,8344,2446,4573,2183,0,77,17623
3/28/2019,21,8349,2050,4146,2227,0,76,16848
3/28/2019,22,8349,1504,3874,1871,0,76,15674
3/28/2019,23,8349,1275,3615,1861,0,70,15170
3/28/2019,24,8345,923,3849,1642,0,34,14793
3/29/2019,1,8352,1132,3971,1148,0,11,14614
3/29/2019,2,8351,962,3780,887,0,11,13991
3/29/2019,3,8353,1086,3755,707,0,11,13912
3/29/2019,4,8354,1619,3908,504,0,11,14396
3/29/2019,5,8354,2072,3577,452,0,15,14470
3/29/2019,6,8351,2619,4023,540,0,49,15582
3/29/2019,7,8351,3393,4400,433,4,83,16664
3/29/2019,8,8348,3650,4411,328,40,100,16877
3/29/2019,9,8367,3628,3975,149,101,106,16326
3/29/2019,10,8377,2579,4210,236,202,85,15689
3/29/2019,11,8357,2272,4001,288,284,80,15282
3/29/2019,12,8349,2187,3882,405,331,79,15233
3/29/2019,13,8342,2103,3620,485,349,80,14979
3/29/2019,14,8341,2187,3341,428,358,82,14737
3/29/2019,15,8336,2269,3307,291,332,83,14618
3/29/2019,16,8334,1935,3468,451,261,81,14530
3/29/2019,17,8339,1861,3947,605,204,81,15037
3/29/2019,18,8338,2165,4256,548,70,82,15459
3/29/2019,19,8335,2563,4604,445,6,85,16038
3/29/2019,20,8325,2692,4792,372,0,92,16273
3/29/2019,21,8321,2677,4558,412,0,90,16058
3/29/2019,22,8331,1805,4428,507,0,39,15110
3/29/2019,23,8337,1498,3944,721,0,18,14518
3/29/2019,24,8336,681,3679,1005,0,8,13709
3/30/2019,1,8343,446,3511,1226,0,0,13526
3/30/2019,2,8343,445,3464,1329,0,0,13581
3/30/2019,3,8340,443,3368,1771,0,2,13924
3/30/2019,4,8338,447,3477,2072,0,2,14336
3/30/2019,5,8340,447,3571,1908,0,0,14266
3/30/2019,6,8339,521,3618,2163,0,0,14641
3/30/2019,7,8339,535,3707,2010,3,0,14594
3/30/2019,8,8340,652,4194,2136,16,0,15338
3/30/2019,9,8339,1008,4787,1854,39,0,16027
3/30/2019,10,8341,1409,4719,1651,51,0,16171
3/30/2019,11,8337,1607,4325,1339,57,2,15667
3/30/2019,12,8336,1615,4090,1378,55,2,15476
3/30/2019,13,8336,1004,3676,1955,99,2,15072
3/30/2019,14,8338,913,3591,2494,69,5,15410
3/30/2019,15,8337,1056,3489,2754,57,20,15713
3/30/2019,16,8341,1407,3874,2600,55,53,16330
3/30/2019,17,8339,1454,4356,2446,34,55,16684
3/30/2019,18,8342,1358,4445,2262,16,58,16481
3/30/2019,19,8340,1062,4186,2324,1,55,15968
3/30/2019,20,8340,1009,3995,2196,0,51,15591
3/30/2019,21,8341,1013,3894,2467,0,51,15766
3/30/2019,22,8338,728,3864,2831,0,51,15812
3/30/2019,23,8324,478,3666,3241,0,60,15769
3/30/2019,24,8340,448,3407,3253,0,16,15464
3/31/2019,1,8347,283,3390,3224,0,0,15244
3/31/2019,2,8347,254,3308,3227,0,0,15136
3/31/2019,3,8350,256,3291,3134,0,0,15031
3/31/2019,4,8349,258,3425,3053,0,0,15085
3/31/2019,5,8348,257,3608,3081,0,0,15294
3/31/2019,6,8352,258,3935,2842,0,0,15387
3/31/2019,7,8349,270,4207,2701,3,0,15530
3/31/2019,8,8344,363,4640,2577,18,0,15942
3/31/2019,9,8345,507,4234,2643,38,0,15767
3/31/2019,10,8331,415,3995,2594,51,0,15386
3/31/2019,11,8333,380,4017,2692,73,0,15495
3/31/2019,12,8334,333,3707,2685,93,0,15152
3/31/2019,13,8337,404,3445,2714,127,0,15027
3/31/2019,14,8339,588,3360,2733,145,0,15165
3/31/2019,15,8309,871,3480,2513,163,0,15336
3/31/2019,16,8338,871,3926,2638,154,0,15927
3/31/2019,17,8324,990,4577,2500,93,0,16484
3/31/2019,18,8337,1035,4771,2269,38,0,16450
3/31/2019,19,8338,1014,5149,2179,3,0,16683
3/31/2019,20,8332,1027,5054,2227,0,0,16640
3/31/2019,21,8326,1027,4991,2256,0,0,16600
3/31/2019,22,8332,952,4626,2366,0,0,16276
3/31/2019,23,8328,724,3916,2352,0,0,15320
3/31/2019,24,8324,345,3932,2468,0,0,15069
4/1/2019,1,8313,466,3696,2452,0,0,14927
4/1/2019,2,8322,646,3773,2194,0,2,14937
4/1/2019,3,8325,1128,3880,1953,0,12,15298
4/1/2019,4,8332,1653,3650,1681,0,13,15329
4/1/2019,5,8343,2008,3713,1410,0,12,15486
4/1/2019,6,8342,2356,4488,1149,2,13,16350
4/1/2019,7,8343,2680,5237,874,16,25,17175
4/1/2019,8,8343,2670,5239,626,103,27,17008
4/1/2019,9,8342,2516,5212,369,225,27,16691
4/1/2019,10,8339,2330,4955,357,332,27,16340
4/1/2019,11,8339,2329,4488,421,358,27,15962
4/1/2019,12,8342,2356,4249,537,321,27,15832
4/1/2019,13,8341,1872,4167,811,327,27,15545
4/1/2019,14,8345,1553,3925,1279,319,27,15448
4/1/2019,15,8346,1661,3772,1512,311,27,15629
4/1/2019,16,8341,1698,3847,1599,269,27,15781
4/1/2019,17,8339,1497,3866,2078,195,27,16002
4/1/2019,18,8346,1455,4253,2014,78,27,16173
4/1/2019,19,8343,1682,5241,1689,8,27,16990
4/1/2019,20,8342,2239,5202,1572,0,27,17382
4/1/2019,21,8336,1907,4932,1756,0,26,16957
4/1/2019,22,8333,1043,4577,2136,0,26,16115
4/1/2019,23,8330,844,3826,1981,0,17,14998
4/1/2019,24,8340,568,3781,2124,0,13,14826
4/2/2019,1,8340,465,4207,2002,0,13,15027
4/2/2019,2,8343,593,4150,1927,0,12,15025
4/2/2019,3,8345,505,4170,1956,0,12,14988
4/2/2019,4,8344,549,3720,2025,0,12,14650
4/2/2019,5,8346,747,3480,2154,0,16,14743
4/2/2019,6,8345,1033,3624,2449,1,23,15475
4/2/2019,7,8344,1247,4352,2746,10,27,16726
4/2/2019,8,8335,1259,4067,2848,64,27,16600
4/2/2019,9,8184,1253,4337,2816,134,27,16751
4/2/2019,10,8178,1250,4130,2779,236,27,16600
4/2/2019,11,8178,1117,3756,2840,321,27,16239
4/2/2019,12,8181,1057,3454,2759,339,27,15817
4/2/2019,13,8180,1058,3367,2695,337,27,15664
4/2/2019,14,8183,1060,3685,2988,266,27,16209
4/2/2019,15,8322,1165,4146,2846,199,27,16705
4/2/2019,16,8342,1221,4416,2761,158,27,16925
4/2/2019,17,8343,1385,4269,2696,110,27,16830
4/2/2019,18,8343,986,4559,2677,49,26,16640
4/2/2019,19,8340,883,4605,2955,9,26,16818
4/2/2019,20,8343,848,4093,3182,0,26,16492
4/2/2019,21,8341,844,3921,3407,0,26,16539
4/2/2019,22,8342,357,3854,3463,0,26,16042
4/2/2019,23,8342,252,3457,3469,0,19,15539
4/2/2019,24,8343,253,3378,3193,0,13,15180
4/3/2019,1,8351,252,3286,3178,0,12,15079
4/3/2019,2,8351,251,3087,3404,0,11,15104
4/3/2019,3,8348,252,2821,3692,0,11,15124
4/3/2019,4,8349,250,2896,3725,0,11,15231
4/3/2019,5,8349,249,2972,3779,0,14,15363
4/3/2019,6,8346,251,3386,3893,0,19,15895
4/3/2019,7,8348,255,3899,3863,16,26,16407
4/3/2019,8,8345,288,4206,3660,99,27,16625
4/3/2019,9,8344,268,4047,3689,204,27,16579
4/3/2019,10,8341,335,4168,3655,232,27,16758
4/3/2019,11,8343,343,3887,3669,253,30,16525
4/3/2019,12,8338,425,3437,3422,324,28,15974
4/3/2019,13,8201,486,3310,3265,310,27,15599
4/3/2019,14,8170,624,3315,3075,324,27,15535
4/3/2019,15,8207,842,3318,2832,313,28,15540
4/3/2019,16,8329,872,3468,2964,273,27,15933
4/3/2019,17,8337,971,3991,2849,182,27,16357
4/3/2019,18,8337,1082,4631,2403,61,27,16541
4/3/2019,19,8338,1201,5054,1929,8,27,16557
4/3/2019,20,8340,1641,5280,1462,0,27,16750
4/3/2019,21,8334,1546,5255,1051,0,27,16213
4/3/2019,22,8335,1546,4836,652,0,27,15396
4/3/2019,23,8335,1432,4532,518,0,19,14836
4/3/2019,24,8328,1227,3975,542,0,14,14086
4/4/2019,1,8337,838,3996,677,0,13,13861
4/4/2019,2,8345,849,3978,716,0,12,13900
4/4/2019,3,8338,744,3428,813,0,11,13334
4/4/2019,4,8346,738,3203,1008,0,12,13307
4/4/2019,5,8347,934,3559,1074,0,16,13930
4/4/2019,6,8348,1512,4348,954,1,35,15198
4/4/2019,7,8346,1835,4902,709,27,85,15904
4/4/2019,8,8348,1809,4686,553,106,124,15626
4/4/2019,9,8348,1825,4583,410,209,86,15461
4/4/2019,10,8349,2526,4642,387,280,139,16323
4/4/2019,11,8350,1977,4396,412,318,100,15553
4/4/2019,12,8347,1985,4253,373,332,107,15397
4/4/2019,13,8346,1478,3950,358,334,79,14545
4/4/2019,14,8348,1209,3781,433,307,78,14156
4/4/2019,15,8348,1191,3789,454,272,77,14131
4/4/2019,16,8348,1112,4028,473,236,77,14274
4/4/2019,17,8345,1271,4548,532,151,91,14938
4/4/2019,18,8349,1522,4637,602,58,136,15304
4/4/2019,19,8328,1652,5188,660,6,148,15982
4/4/2019,20,8326,1673,5326,855,0,153,16333
4/4/2019,21,8345,1425,4821,1156,0,177,15924
4/4/2019,22,8346,1056,4154,1549,0,106,15211
4/4/2019,23,8345,601,3444,1954,0,73,14417
4/4/2019,24,8346,389,3568,1953,0,27,14283
4/5/2019,1,8352,285,3595,2232,0,13,14477
4/5/2019,2,8349,342,3365,2415,0,13,14484
4/5/2019,3,8352,347,3508,2389,0,13,14609
4/5/2019,4,8350,633,3799,2228,0,15,15025
4/5/2019,5,8351,972,3403,2089,0,18,14833
4/5/2019,6,8348,1267,3998,2158,1,39,15811
4/5/2019,7,8350,2071,4539,2034,12,90,17096
4/5/2019,8,8345,2245,4709,1880,45,141,17365
4/5/2019,9,8341,2290,4620,1736,93,134,17214
4/5/2019,10,8343,2682,4569,1301,139,111,17145
4/5/2019,11,8341,2728,3966,1115,113,144,16407
4/5/2019,12,8343,2655,3913,848,84,148,15991
4/5/2019,13,8340,2995,3845,509,106,147,15942
4/5/2019,14,8342,3372,3802,306,112,152,16086
4/5/2019,15,8344,3133,3938,191,75,185,15866
4/5/2019,16,8340,3266,4376,108,49,152,16291
4/5/2019,17,8345,3374,4713,84,32,188,16736
4/5/2019,18,8354,3178,4715,173,16,200,16636
4/5/2019,19,8355,2914,4669,292,2,155,16387
4/5/2019,20,8356,2596,4919,344,1,141,16357
4/5/2019,21,8354,2813,4867,397,1,116,16548
4/5/2019,22,8343,2180,4462,433,0,123,15541
4/5/2019,23,8333,1031,4100,430,0,76,13970
4/5/2019,24,8349,720,3638,459,0,84,13250
4/6/2019,1,8401,437,3656,425,0,64,12983
4/6/2019,2,8409,501,3684,380,0,23,12997
4/6/2019,3,8409,584,3744,279,0,0,13016
4/6/2019,4,8403,593,3802,223,0,0,13021
4/6/2019,5,8403,596,3734,157,0,0,12890
4/6/2019,6,8405,650,3823,110,1,0,12989
4/6/2019,7,8401,756,4095,69,10,0,13331
4/6/2019,8,8402,926,4884,47,34,0,14293
4/6/2019,9,8419,1184,4993,37,75,0,14708
4/6/2019,10,8609,981,4025,27,172,0,13814
4/6/2019,11,8673,637,4269,42,298,0,13919
4/6/2019,12,8772,401,4109,90,316,0,13688
4/6/2019,13,8793,481,3914,134,307,0,13629
4/6/2019,14,8821,363,3490,149,279,0,13102
4/6/2019,15,8962,384,3393,247,282,1,13269
4/6/2019,16,8914,404,3970,321,240,35,13884
4/6/2019,17,8910,438,4066,329,170,52,13965
4/6/2019,18,8913,569,4201,378,70,53,14184
4/6/2019,19,8916,471,4463,291,8,53,14202
4/6/2019,20,8919,495,4753,319,0,66,14552
4/6/2019,21,8915,446,4434,383,0,61,14239
4/6/2019,22,8921,285,3853,514,0,102,13675
4/6/2019,23,8927,194,3590,656,0,68,13435
4/6/2019,24,8934,198,3586,766,0,4,13488
4/7/2019,1,8932,258,3321,1132,0,0,13643
4/7/2019,2,8933,193,3454,1111,0,0,13691
4/7/2019,3,8964,192,3346,1089,0,0,13591
4/7/2019,4,9077,192,3120,1157,0,0,13546
4/7/2019,5,9087,193,3242,1291,0,0,13813
4/7/2019,6,9085,204,3507,1383,1,0,14180
4/7/2019,7,9085,212,3767,1393,16,0,14473
4/7/2019,8,9086,194,3700,1528,74,0,14582
4/7/2019,9,9084,194,3904,1255,129,0,14566
4/7/2019,10,9086,201,4144,957,193,0,14581
4/7/2019,11,8984,287,4142,811,238,0,14462
4/7/2019,12,8977,223,3729,864,252,0,14045
4/7/2019,13,8980,194,3640,981,250,0,14045
4/7/2019,14,8980,196,3504,1238,207,0,14125
4/7/2019,15,9097,196,3350,1657,183,0,14483
4/7/2019,16,9114,201,3625,1794,119,0,14853
4/7/2019,17,9111,202,4139,2154,60,0,15666
4/7/2019,18,9114,211,4144,2493,21,0,15983
4/7/2019,19,9113,254,4614,2548,4,1,16534
4/7/2019,20,9111,385,4473,2565,1,1,16536
4/7/2019,21,9114,390,4599,2386,1,0,16490
4/7/2019,22,9121,390,4030,2337,1,0,15879
4/7/2019,23,9126,383,3581,2139,1,0,15230
4/7/2019,24,9129,228,3237,2253,0,0,14847
4/8/2019,1,9125,194,2962,2389,0,0,14670
4/8/2019,2,8864,194,3171,2240,0,10,14479
4/8/2019,3,8317,195,3055,2792,0,12,14371
4/8/2019,4,8311,193,2978,2913,0,11,14406
4/8/2019,5,8309,194,3056,2936,0,14,14509
4/8/2019,6,8308,207,3519,3043,1,21,15099
4/8/2019,7,8304,260,4101,3290,3,27,15985
4/8/2019,8,8307,378,4800,3166,31,27,16709
4/8/2019,9,8309,435,4983,2830,68,27,16652
4/8/2019,10,8308,524,4849,2667,81,28,16457
4/8/2019,11,8303,508,4687,2249,121,27,15895
4/8/2019,12,8299,892,4839,1847,120,28,16025
4/8/2019,13,8300,1259,4446,1524,147,27,15703
4/8/2019,14,8305,1444,4168,1363,181,27,15488
4/8/2019,15,8310,1292,4373,1416,184,45,15620
4/8/2019,16,8308,1484,4610,1249,198,75,15924
4/8/2019,17,8312,2516,4803,856,132,95,16714
4/8/2019,18,8310,2631,4826,484,58,102,16411
4/8/2019,19,8315,2706,4809,347,8,144,16329
4/8/2019,20,8314,2686,4776,304,1,134,16215
4/8/2019,21,8313,2651,4720,598,1,144,16427
4/8/2019,22,8305,1882,4046,1116,1,84,15434
4/8/2019,23,8311,1067,3699,1357,1,30,14465
4/8/2019,24,8307,411,3617,1699,1,14,14049
4/9/2019,1,8309,282,3750,1817,0,13,14171
4/9/2019,2,8314,279,3741,1661,0,15,14010
4/9/2019,3,8195,370,3621,1897,0,15,14098
4/9/2019,4,8064,440,3690,1884,0,14,14092
4/9/2019,5,8065,311,3633,2134,0,18,14161
4/9/2019,6,8063,257,3566,3150,1,24,15061
4/9/2019,7,8062,262,4043,3391,4,30,15792
4/9/2019,8,8062,265,4240,3512,61,30,16170
4/9/2019,9,8060,302,4264,3485,113,31,16255
4/9/2019,10,8060,484,4658,3187,149,29,16567
4/9/2019,11,8063,680,4831,2919,208,28,16729
4/9/2019,12,8064,743,4182,2904,211,31,16135
4/9/2019,13,8048,962,4172,2896,176,31,16285
4/9/2019,14,8048,1356,4384,2801,147,31,16767
4/9/2019,15,8059,1624,4564,2537,113,44,16941
4/9/2019,16,8060,2131,4616,2215,92,86,17200
4/9/2019,17,8063,2347,4947,1648,82,128,17215
4/9/2019,18,8062,2641,5210,1101,41,150,17205
4/9/2019,19,8061,2639,4952,1189,5,149,16995
4/9/2019,20,8058,2155,4976,1302,0,112,16603
4/9/2019,21,8072,2316,5137,770,1,104,16400
4/9/2019,22,8110,2333,4401,856,1,102,15803
4/9/2019,23,8115,1850,4162,734,0,31,14892
4/9/2019,24,8116,1548,4130,667,0,15,14476
4/10/2019,1,8116,1037,3962,854,0,16,13985
4/10/2019,2,8096,1068,3906,914,0,16,14000
4/10/2019,3,8095,1007,3935,1175,0,16,14228
4/10/2019,4,8094,1106,3845,1067,0,16,14128
4/10/2019,5,8095,1329,3974,1121,0,16,14535
4/10/2019,6,8094,1783,4348,1224,1,24,15474
4/10/2019,7,8094,2658,4846,1315,16,30,16959
4/10/2019,8,8094,2312,4829,1507,73,29,16844
4/10/2019,9,8090,1866,4753,1590,128,28,16455
4/10/2019,10,8108,1548,4695,1422,175,28,15976
4/10/2019,11,8122,1675,4563,1187,225,28,15800
4/10/2019,12,8114,1972,4336,1004,244,27,15697
4/10/2019,13,8006,2139,3970,1098,251,28,15492
4/10/2019,14,7949,1588,3920,1108,275,28,14868
4/10/2019,15,7945,1672,3732,1094,250,29,14722
4/10/2019,16,8082,1687,3877,1180,228,35,15089
4/10/2019,17,8113,1843,4342,1085,156,75,15614
4/10/2019,18,8112,1916,4754,1008,82,112,15984
4/10/2019,19,8112,2209,4899,828,29,124,16201
4/10/2019,20,8113,2963,4833,724,3,154,16790
4/10/2019,21,8112,2930,4630,742,0,162,16576
4/10/2019,22,8110,2157,4387,728,0,137,15519
4/10/2019,23,8116,1517,4069,678,0,71,14451
4/10/2019,24,8105,1155,3926,859,0,46,14091
4/11/2019,1,8111,888,3684,969,0,45,13697
4/11/2019,2,8109,779,3603,1209,0,46,13746
4/11/2019,3,8107,791,3563,1703,0,47,14211
4/11/2019,4,8112,937,3209,1973,0,46,14277
4/11/2019,5,8111,1193,3328,2254,0,50,14936
4/11/2019,6,8110,1425,4152,2713,2,56,16458
4/11/2019,7,8155,1615,4839,2706,15,65,17395
4/11/2019,8,8355,1501,4909,2741,75,65,17646
4/11/2019,9,8353,1597,4844,2752,145,71,17762
4/11/2019,10,8352,1296,4742,2693,181,61,17325
4/11/2019,11,8355,1178,4462,2829,226,70,17120
4/11/2019,12,8367,922,3949,2990,247,72,16547
4/11/2019,13,8558,625,3551,3134,293,69,16230
4/11/2019,14,8734,446,3821,3269,259,69,16598
4/11/2019,15,8818,583,4178,3419,181,70,17249
4/11/2019,16,8825,394,4198,3501,172,69,17159
4/11/2019,17,8822,316,4574,3585,88,67,17452
4/11/2019,18,8824,276,4562,3575,38,69,17344
4/11/2019,19,8820,261,4701,3659,8,72,17521
4/11/2019,20,8820,263,4710,3684,0,58,17535
4/11/2019,21,8826,258,4450,3703,0,55,17292
4/11/2019,22,8830,258,4003,3620,0,63,16774
4/11/2019,23,8830,258,3639,3412,0,53,16192
4/11/2019,24,8903,256,3337,3514,0,43,16053
4/12/2019,1,8931,257,3177,3319,0,38,15722
4/12/2019,2,9113,257,3061,3258,0,47,15736
4/12/2019,3,9111,258,2979,3244,0,48,15640
4/12/2019,4,9114,256,3084,3173,0,49,15676
4/12/2019,5,9375,258,3300,3044,0,54,16031
4/12/2019,6,9394,257,3869,3163,3,56,16742
4/12/2019,7,9393,263,4481,3277,22,63,17499
4/12/2019,8,9456,285,4655,3372,70,64,17902
4/12/2019,9,9586,255,4112,3032,156,65,17206
4/12/2019,10,9614,255,4171,2771,147,68,17026
4/12/2019,11,9781,277,4664,2158,178,64,17122
4/12/2019,12,9793,380,4447,2652,150,64,17486
4/12/2019,13,9797,272,4053,2620,137,64,16943
4/12/2019,14,9796,254,3990,2935,112,63,17150
4/12/2019,15,9794,254,3934,2793,119,64,16958
4/12/2019,16,9777,251,3914,2928,98,64,17032
4/12/2019,17,9783,250,3957,2743,77,64,16874
4/12/2019,18,9917,249,3913,2822,43,65,17009
4/12/2019,19,9941,250,3898,3055,13,64,17221
4/12/2019,20,9940,252,3996,3178,2,65,17433
4/12/2019,21,9942,253,3884,2936,2,50,17067
4/12/2019,22,9933,251,3689,2674,2,48,16597
4/12/2019,23,9924,146,3492,2246,2,38,15848
4/12/2019,24,9777,139,3651,901,2,32,14502
4/13/2019,1,9357,139,3611,860,2,36,14005
4/13/2019,2,9043,138,3548,952,2,38,13721
4/13/2019,3,8603,139,3646,1261,2,38,13689
4/13/2019,4,8829,138,3600,1178,2,38,13785
4/13/2019,5,8941,136,3847,883,2,37,13846
4/13/2019,6,9207,138,3893,1047,3,37,14325
4/13/2019,7,9230,138,3977,1315,31,37,14728
4/13/2019,8,9225,139,4054,1431,117,37,15003
4/13/2019,9,9224,139,3972,1488,267,37,15127
4/13/2019,10,9237,140,3907,1209,349,30,14872
4/13/2019,11,9234,139,3895,1106,356,35,14765
4/13/2019,12,9250,140,3842,945,344,37,14558
4/13/2019,13,9275,140,3846,731,304,38,14334
4/13/2019,14,9296,139,3820,664,226,37,14182
4/13/2019,15,9300,141,3893,615,226,37,14212
4/13/2019,16,9301,139,3964,855,265,37,14561
4/13/2019,17,9432,139,4020,1293,189,38,15111
4/13/2019,18,9556,140,4339,1325,97,38,15495
4/13/2019,19,9561,149,4891,1033,22,37,15693
4/13/2019,20,9552,158,5322,940,2,37,16011
4/13/2019,21,9500,144,4731,976,0,27,15378
4/13/2019,22,9552,142,4254,1224,0,26,15198
4/13/2019,23,9564,141,3895,961,0,35,14596
4/13/2019,24,9566,141,3524,821,0,33,14085
4/14/2019,1,9570,142,3359,1283,0,34,14388
4/14/2019,2,9570,141,3291,1319,0,33,14354
4/14/2019,3,9595,142,3260,1189,0,34,14220
4/14/2019,4,9593,142,3333,1215,0,35,14318
4/14/2019,5,9594,142,3865,998,2,37,14638
4/14/2019,6,9595,142,3771,1311,5,36,14860
4/14/2019,7,9594,141,3616,1623,19,38,15031
4/14/2019,8,9584,142,3810,1990,57,36,15619
4/14/2019,9,9580,141,4057,2200,74,36,16088
4/14/2019,10,9578,142,4315,2508,86,36,16665
4/14/2019,11,9564,143,4131,2737,96,37,16708
4/14/2019,12,9564,142,4152,2974,103,37,16972
4/14/2019,13,9564,141,4297,2893,83,36,17014
4/14/2019,14,9568,140,4036,3150,73,36,17003
4/14/2019,15,9576,141,4317,3007,69,36,17146
4/14/2019,16,9576,144,4752,2628,72,37,17209
4/14/2019,17,9581,234,5368,2370,47,38,17638
4/14/2019,18,9583,168,4757,2624,18,37,17187
4/14/2019,19,9580,137,4353,2660,3,38,16771
4/14/2019,20,9579,137,4410,2499,0,38,16663
4/14/2019,21,9579,138,4793,1943,0,30,16483
4/14/2019,22,9583,139,4647,1710,0,36,16115
4/14/2019,23,9588,139,4420,1448,0,38,15633
4/14/2019,24,9585,140,3995,1364,0,38,15122
4/15/2019,1,9587,140,3672,1564,0,44,15007
4/15/2019,2,9586,139,3436,1617,0,48,14826
4/15/2019,3,9587,139,3209,1881,0,46,14862
4/15/2019,4,9541,139,3139,2036,0,49,14904
4/15/2019,5,9540,139,3391,2259,0,52,15381
4/15/2019,6,9542,172,4203,2554,1,58,16530
4/15/2019,7,9543,274,5140,2205,10,63,17235
4/15/2019,8,9550,281,4821,2180,27,63,16922
4/15/2019,9,9550,264,4518,2250,61,61,16704
4/15/2019,10,9551,255,4613,2303,105,59,16886
4/15/2019,11,9548,254,4573,2263,128,54,16820
4/15/2019,12,9553,256,4143,2270,160,34,16416
4/15/2019,13,9555,256,4183,1971,248,29,16242
4/15/2019,14,9552,263,3800,1736,292,27,15670
4/15/2019,15,9553,274,3706,1846,280,28,15687
4/15/2019,16,9555,274,3899,1820,261,55,15864
4/15/2019,17,9551,278,4232,1831,193,101,16186
4/15/2019,18,9554,301,4487,1700,87,105,16234
4/15/2019,19,9553,549,5073,1350,16,80,16621
4/15/2019,20,9555,539,5347,1118,2,80,16641
4/15/2019,21,9551,481,5379,946,1,80,16438
4/15/2019,22,9549,454,4829,851,1,80,15764
4/15/2019,23,9553,460,4525,802,1,71,15412
4/15/2019,24,9551,478,4442,623,1,20,15115
4/16/2019,1,9554,543,4017,596,1,11,14722
4/16/2019,2,9558,449,3780,966,1,11,14765
4/16/2019,3,9557,268,4007,848,1,10,14691
4/16/2019,4,9557,314,4328,578,1,11,14789
4/16/2019,5,9549,375,4500,395,1,14,14834
4/16/2019,6,9550,478,4858,353,4,18,15261
4/16/2019,7,9548,819,5151,282,29,25,15854
4/16/2019,8,9549,839,4959,205,95,33,15680
4/16/2019,9,9557,863,4881,278,184,36,15799
4/16/2019,10,9545,878,4909,343,196,26,15897
4/16/2019,11,9586,963,4893,512,206,29,16189
4/16/2019,12,9634,943,4314,603,200,42,15736
4/16/2019,13,9623,895,4287,516,201,55,15577
4/16/2019,14,9631,892,4292,502,198,61,15576
4/16/2019,15,9631,892,4292,502,198,61,15576
4/16/2019,16,9631,892,4292,502,198,61,15576
4/16/2019,17,9717,831,3936,686,192,95,15457
4/16/2019,18,9717,831,3936,686,192,95,15457
4/16/2019,19,9774,918,4707,598,28,114,16139
4/16/2019,20,9775,918,4710,597,28,113,16141
4/16/2019,21,9775,918,4710,597,28,113,16141
4/16/2019,22,9775,918,4710,597,28,113,16141
4/16/2019,23,9818,253,4028,499,14,18,14630
4/16/2019,24,9854,254,3905,563,14,14,14604
4/17/2019,1,9815,423,4106,486,14,11,14855
4/17/2019,2,9807,430,4246,470,14,11,14978
4/17/2019,3,9816,446,4225,535,14,11,15047
4/17/2019,4,9813,423,4113,700,14,11,15074
4/17/2019,5,9882,418,3906,811,16,13,15046
4/17/2019,6,9997,418,4125,969,18,22,15549
4/17/2019,7,9999,422,4388,1290,50,28,16177
4/17/2019,8,9995,424,4281,1015,146,29,15890
4/17/2019,9,10001,418,4287,901,266,29,15902
4/17/2019,10,9999,416,4199,1145,360,27,16146
4/17/2019,11,9994,417,4059,1085,371,27,15953
4/17/2019,12,9991,416,3980,1071,374,28,15860
4/17/2019,13,9997,416,4011,1200,367,27,16018
4/17/2019,14,9995,414,3730,1265,343,28,15775
4/17/2019,15,9995,413,3764,1396,346,28,15942
4/17/2019,16,9981,414,3782,1633,286,28,16124
4/17/2019,17,9970,410,3868,1986,170,27,16431
4/17/2019,18,10017,415,4032,2084,60,27,16635
4/17/2019,19,10018,419,3997,2615,9,27,17085
4/17/2019,20,10017,541,4457,2744,0,28,17787
4/17/2019,21,10013,456,3948,2967,0,28,17412
4/17/2019,22,10014,415,3631,2308,0,27,16395
4/17/2019,23,10020,415,3528,1869,0,23,15855
4/17/2019,24,10014,415,3498,1769,0,15,15711
4/18/2019,1,10013,414,3473,1509,0,13,15422
4/18/2019,2,10014,415,3428,1352,0,13,15222
4/18/2019,3,10014,416,3444,1302,0,13,15189
4/18/2019,4,10016,417,3485,1315,0,13,15246
4/18/2019,5,10016,416,3524,1836,0,14,15806
4/18/2019,6,10020,257,3593,3123,1,23,17017
4/18/2019,7,10019,252,3815,2684,20,49,16839
4/18/2019,8,10022,254,3734,2355,73,53,16491
4/18/2019,9,10023,256,3790,2540,95,52,16756
4/18/2019,10,10021,255,3727,2468,145,50,16666
4/18/2019,11,10032,255,3812,2393,218,31,16741
4/18/2019,12,10024,254,3916,2479,143,27,16843
4/18/2019,13,10022,254,3845,2529,175,27,16852
4/18/2019,14,10027,261,3973,2447,200,27,16935
4/18/2019,15,10030,264,3990,2695,130,27,17136
4/18/2019,16,10031,287,3911,2769,97,27,17122
4/18/2019,17,10030,309,3967,2817,59,27,17209
4/18/2019,18,10032,438,4326,2228,26,26,17076
4/18/2019,19,10034,447,4203,2315,7,27,17033
4/18/2019,20,10032,449,4510,1909,0,27,16927
4/18/2019,21,10035,448,4640,1317,0,27,16467
4/18/2019,22,10030,319,4632,987,0,27,15995
4/18/2019,23,10037,147,4153,1102,0,17,15456
4/18/2019,24,10034,143,3680,1164,0,12,15033
4/19/2019,1,10036,143,3657,694,0,5,14535
4/19/2019,2,10038,142,3599,498,0,0,14277
4/19/2019,3,10037,141,3665,582,0,0,14425
4/19/2019,4,10037,141,3627,647,0,0,14452
4/19/2019,5,10039,142,3622,952,0,0,14755
4/19/2019,6,10037,140,3613,1151,1,0,14942
4/19/2019,7,10039,143,3682,633,5,0,14502
4/19/2019,8,10041,141,3696,1088,23,0,14989
4/19/2019,9,10033,139,3722,1804,60,0,15758
4/19/2019,10,10031,139,3842,1575,83,4,15674
4/19/2019,11,10033,138,3869,1896,102,6,16044
4/19/2019,12,10033,137,3689,2306,89,0,16254
4/19/2019,13,10036,137,3726,2004,97,0,16000
4/19/2019,14,10031,137,3823,1352,98,0,15441
4/19/2019,15,10027,138,3865,1783,84,0,15897
4/19/2019,16,10029,137,3799,2218,69,0,16252
4/19/2019,17,10029,138,3900,2420,46,0,16533
4/19/2019,18,10033,135,3887,2354,21,0,16430
4/19/2019,19,10027,138,3844,2280,2,0,16291
4/19/2019,20,10030,138,3730,2541,0,0,16439
4/19/2019,21,10026,139,3695,2150,0,0,16010
4/19/2019,22,10032,140,4023,1140,0,0,15335
4/19/2019,23,10022,138,3946,908,0,0,15014
4/19/2019,24,9985,140,3831,601,0,0,14557
4/20/2019,1,9724,137,3873,373,0,0,14107
4/20/2019,2,9523,139,3872,304,0,0,13838
4/20/2019,3,9210,139,3867,382,0,0,13598
4/20/2019,4,9133,139,3873,512,0,0,13657
4/20/2019,5,9130,138,3873,642,0,0,13783
4/20/2019,6,9138,138,3895,987,1,0,14159
4/20/2019,7,9298,137,4108,1017,11,0,14571
4/20/2019,8,9857,138,4225,834,39,0,15093
4/20/2019,9,10027,138,4175,1444,70,0,15854
4/20/2019,10,10026,138,4092,1993,91,0,16340
4/20/2019,11,10029,137,4140,2078,116,0,16500
4/20/2019,12,10029,138,4150,2237,126,0,16680
4/20/2019,13,10029,111,4169,2084,90,0,16483
4/20/2019,14,9984,108,4181,1654,107,0,16034
4/20/2019,15,10010,111,4455,1451,123,0,16150
4/20/2019,16,9996,129,4765,1000,128,0,16018
4/20/2019,17,10011,118,4788,806,76,0,15799
4/20/2019,18,10006,107,4600,607,37,0,15357
4/20/2019,19,10017,111,5083,523,8,0,15742
4/20/2019,20,10018,158,5511,219,0,0,15906
4/20/2019,21,10014,240,5383,90,0,0,15727
4/20/2019,22,10016,233,4697,122,0,0,15068
4/20/2019,23,10018,139,4356,66,0,0,14579
4/20/2019,24,10016,138,4126,66,0,0,14346
4/21/2019,1,10018,137,4184,75,0,0,14414
4/21/2019,2,10023,137,3842,136,0,0,14138
4/21/2019,3,10021,138,3655,258,0,0,14072
4/21/2019,4,10018,137,3669,243,0,0,14067
4/21/2019,5,10019,136,3672,135,0,0,13962
4/21/2019,6,10023,137,4120,123,2,0,14405
4/21/2019,7,10026,136,4292,105,21,0,14580
4/21/2019,8,10026,138,4403,85,71,3,14726
4/21/2019,9,10024,136,4675,80,122,2,15039
4/21/2019,10,10021,137,4857,60,147,13,15235
4/21/2019,11,10022,136,4841,88,165,33,15285
4/21/2019,12,10023,201,5098,100,202,25,15649
4/21/2019,13,10027,240,4818,160,248,19,15512
4/21/2019,14,10025,247,4495,89,167,25,15048
4/21/2019,15,10025,246,4496,207,187,33,15194
4/21/2019,16,10026,245,4519,229,124,37,15180
4/21/2019,17,10027,284,4796,266,72,40,15485
4/21/2019,18,10022,365,4907,226,36,37,15593
4/21/2019,19,10026,363,5057,236,5,37,15724
4/21/2019,20,10026,359,5262,281,0,35,15963
4/21/2019,21,10026,358,5045,334,0,22,15785
4/21/2019,22,10027,359,4486,392,0,21,15285
4/21/2019,23,10035,353,4183,513,0,33,15117
4/21/2019,24,10029,226,3941,426,0,36,14658
4/22/2019,1,10051,139,4097,448,0,44,14779
4/22/2019,2,10024,138,3959,502,0,47,14670
4/22/2019,3,9402,138,3890,495,0,46,13971
4/22/2019,4,9250,139,3813,642,0,48,13892
4/22/2019,5,9245,138,4073,621,0,51,14128
4/22/2019,6,9246,147,4422,549,2,56,14422
4/22/2019,7,9253,197,5057,510,25,62,15104
4/22/2019,8,9249,252,5164,497,56,61,15279
4/22/2019,9,9241,253,5020,366,148,62,15090
4/22/2019,10,9248,253,4636,373,236,59,14805
4/22/2019,11,9251,255,4286,375,288,62,14517
4/22/2019,12,9248,282,4263,405,320,60,14578
4/22/2019,13,9247,376,3985,381,374,58,14421
4/22/2019,14,9248,420,4024,639,390,61,14782
4/22/2019,15,9248,509,4064,496,379,61,14757
4/22/2019,16,9245,503,4072,758,315,61,14954
4/22/2019,17,9239,507,4096,867,210,59,14978
4/22/2019,18,9241,504,4438,854,85,62,15184
4/22/2019,19,9240,505,4776,1130,16,63,15730
4/22/2019,20,9241,517,5268,1354,0,63,16443
4/22/2019,21,9240,374,4654,1822,0,60,16150
4/22/2019,22,9244,287,4089,1647,0,54,15321
4/22/2019,23,9246,240,3752,1602,0,42,14882
4/22/2019,24,9245,230,3700,1636,0,32,14843
4/23/2019,1,9247,250,3693,1623,0,14,14827
4/23/2019,2,9245,252,3588,1563,0,11,14659
4/23/2019,3,9247,251,3726,1426,0,11,14661
4/23/2019,4,9247,249,3591,1724,0,12,14823
4/23/2019,5,9249,250,3612,1878,1,14,15004
4/23/2019,6,9248,251,3855,2246,3,20,15623
4/23/2019,7,9250,252,4074,2450,20,27,16073
4/23/2019,8,9250,251,4096,2593,64,27,16281
4/23/2019,9,9248,252,4011,2711,121,27,16370
4/23/2019,10,9249,357,3883,2717,187,27,16420
4/23/2019,11,9247,473,3835,2664,261,27,16507
4/23/2019,12,9245,611,3938,2060,195,27,16076
4/23/2019,13,9246,590,3925,2501,170,27,16459
4/23/2019,14,9248,593,3941,2421,153,26,16382
4/23/2019,15,9235,590,4059,2654,117,27,16682
4/23/2019,16,9238,592,4171,3113,63,30,17207
4/23/2019,17,9240,594,4016,3239,44,27,17160
4/23/2019,18,9245,594,4090,2677,23,27,16656
4/23/2019,19,9238,595,4293,2494,6,27,16653
4/23/2019,20,9235,597,4858,2788,0,28,17506
4/23/2019,21,9228,596,4887,2679,0,27,17417
4/23/2019,22,9234,592,4095,2372,0,26,16319
4/23/2019,23,9236,395,3880,2273,0,17,15801
4/23/2019,24,9235,250,3583,2019,0,14,15101
4/24/2019,1,9237,251,3608,1565,0,12,14673
4/24/2019,2,9237,250,3587,1386,0,11,14471
4/24/2019,3,9235,250,3599,1245,0,11,14340
4/24/2019,4,9233,250,3622,1073,0,13,14191
4/24/2019,5,9232,250,3798,1378,2,15,14675
4/24/2019,6,9236,347,4300,1375,3,18,15279
4/24/2019,7,9240,538,5334,1081,33,26,16252
4/24/2019,8,9238,793,5432,945,109,27,16544
4/24/2019,9,9234,740,5418,833,208,26,16459
4/24/2019,10,9234,688,5358,749,247,26,16302
4/24/2019,11,9237,685,4970,697,272,27,15888
4/24/2019,12,9235,688,5044,598,294,27,15886
4/24/2019,13,9233,734,5386,542,305,27,16227
4/24/2019,14,9192,742,5016,713,300,27,15990
4/24/2019,15,9192,741,4553,661,285,29,15461
4/24/2019,16,9193,866,4493,497,252,33,15334
4/24/2019,17,9197,821,4845,546,175,32,15616
4/24/2019,18,9199,793,5199,466,73,26,15756
4/24/2019,19,9199,793,5517,479,18,26,16032
4/24/2019,20,9195,797,5743,378,0,26,16139
4/24/2019,21,9184,862,5874,327,0,26,16273
4/24/2019,22,9185,626,5344,347,0,26,15528
4/24/2019,23,9182,594,4924,333,0,18,15051
4/24/2019,24,9184,591,4290,403,0,15,14483
4/25/2019,1,9186,402,4083,462,0,14,14147
4/25/2019,2,9168,251,4077,477,0,13,13986
4/25/2019,3,9173,262,4119,501,0,12,14067
4/25/2019,4,9168,386,4344,560,0,13,14471
4/25/2019,5,9172,463,4409,717,1,16,14778
4/25/2019,6,9174,588,4730,796,7,24,15319
4/25/2019,7,9177,589,5136,695,51,26,15674
4/25/2019,8,9178,591,5108,513,135,27,15552
4/25/2019,9,9177,593,5507,294,253,27,15851
4/25/2019,10,9170,590,5226,269,332,27,15614
4/25/2019,11,9166,595,5084,259,348,27,15479
4/25/2019,12,9166,624,4834,233,371,27,15255
4/25/2019,13,9164,631,4792,312,367,27,15293
4/25/2019,14,9172,631,4648,322,361,27,15161
4/25/2019,15,9175,628,4786,293,291,27,15200
4/25/2019,16,9166,628,5080,414,228,29,15545
4/25/2019,17,9162,629,5188,571,146,28,15724
4/25/2019,18,9169,635,5339,716,62,27,15948
4/25/2019,19,9174,635,5373,672,12,26,15892
4/25/2019,20,9172,630,5593,872,0,26,16293
4/25/2019,21,9163,631,5326,1183,0,26,16329
4/25/2019,22,9162,630,4863,954,0,26,15635
4/25/2019,23,9169,592,4443,881,0,17,15102
4/25/2019,24,9172,382,3957,960,0,14,14485
4/26/2019,1,9170,241,3664,1410,0,14,14499
4/26/2019,2,9167,242,3637,1234,0,14,14294
4/26/2019,3,9166,242,3716,1039,0,10,14173
4/26/2019,4,9167,240,3661,1087,0,14,14169
4/26/2019,5,9164,242,3642,1668,0,15,14731
4/26/2019,6,9170,241,3709,2232,1,24,15377
4/26/2019,7,9165,241,3779,2825,4,27,16041
4/26/2019,8,9165,241,3882,3220,24,27,16559
4/26/2019,9,9208,240,3850,3402,40,27,16767
4/26/2019,10,9228,251,3842,3342,72,27,16762
4/26/2019,11,9232,287,3805,3407,88,27,16846
4/26/2019,12,9225,294,3964,2952,108,27,16570
4/26/2019,13,9224,379,4006,2589,100,27,16325
4/26/2019,14,9227,453,4024,2475,97,27,16303
4/26/2019,15,9230,509,4053,2419,80,27,16318
4/26/2019,16,9224,513,4097,2576,57,27,16494
4/26/2019,17,9218,513,4039,2805,39,27,16641
4/26/2019,18,9222,523,3932,2838,28,27,16570
4/26/2019,19,9223,523,4032,2880,10,31,16699
4/26/2019,20,9223,513,3982,3196,0,32,16946
4/26/2019,21,9223,377,3958,2922,0,27,16507
4/26/2019,22,9228,286,3961,2256,0,27,15758
4/26/2019,23,9221,129,3937,1966,0,15,15268
4/26/2019,24,9216,112,3913,1851,0,5,15097
4/27/2019,1,9216,113,3933,1743,0,0,15005
4/27/2019,2,9219,112,3977,1938,0,0,15246
4/27/2019,3,9226,112,3966,1858,0,0,15162
4/27/2019,4,9231,112,3933,1852,0,0,15128
4/27/2019,5,9227,168,3925,1920,0,1,15241
4/27/2019,6,9225,265,3804,2265,6,9,15574
4/27/2019,7,9222,337,3908,2437,19,0,15923
4/27/2019,8,9228,334,3963,2814,57,0,16396
4/27/2019,9,9229,334,4226,2943,100,0,16832
4/27/2019,10,9228,337,4287,2847,170,0,16869
4/27/2019,11,9229,347,4271,2684,197,0,16728
4/27/2019,12,9232,356,4378,2394,255,0,16615
4/27/2019,13,9231,386,4565,2086,222,0,16490
4/27/2019,14,9234,398,4619,1802,205,0,16258
4/27/2019,15,9200,473,4996,1498,206,0,16373
4/27/2019,16,9187,705,4702,1334,213,0,16141
4/27/2019,17,9190,716,5008,866,175,0,15955
4/27/2019,18,9186,716,5056,894,71,0,15923
4/27/2019,19,9190,718,4980,752,16,2,15658
4/27/2019,20,9187,576,5345,801,0,1,15910
4/27/2019,21,9191,524,5588,776,0,0,16079
4/27/2019,22,9192,361,5705,641,0,0,15899
4/27/2019,23,9170,258,5516,378,0,0,15322
4/27/2019,24,9178,111,5089,346,0,0,14724
4/28/2019,1,9180,111,4385,357,0,0,14033
4/28/2019,2,9181,110,4130,523,0,0,13944
4/28/2019,3,9187,125,4032,392,0,0,13736
4/28/2019,4,9187,135,4127,576,0,0,14025
4/28/2019,5,9190,150,4221,824,1,0,14386
4/28/2019,6,9179,146,4419,1040,4,0,14788
4/28/2019,7,9172,102,4247,1164,36,0,14721
4/28/2019,8,9172,101,4675,1059,98,0,15105
4/28/2019,9,9167,101,4714,724,233,0,14939
4/28/2019,10,9165,157,4686,419,371,0,14798
4/28/2019,11,9161,253,4798,605,423,0,15240
4/28/2019,12,9160,325,4563,893,421,0,15362
4/28/2019,13,9162,325,4109,954,418,0,14968
4/28/2019,14,9162,328,4081,1013,408,0,14992
4/28/2019,15,9114,329,4174,862,404,0,14883
4/28/2019,16,9142,331,4549,689,333,0,15044
4/28/2019,17,9149,334,4918,888,248,0,15537
4/28/2019,18,9147,363,4971,984,110,0,15575
4/28/2019,19,9149,516,5082,611,19,0,15377
4/28/2019,20,8882,677,5502,536,0,0,15597
4/28/2019,21,8730,577,5878,471,0,0,15656
4/28/2019,22,8725,529,5245,437,0,0,14936
4/28/2019,23,8729,398,5147,483,0,0,14757
4/28/2019,24,8735,194,4520,544,0,0,13993
4/29/2019,1,8729,104,4516,625,0,0,13974
4/29/2019,2,8735,105,4508,762,0,10,14120
4/29/2019,3,8729,169,4550,988,0,11,14447
4/29/2019,4,8725,260,4653,1138,0,11,14787
4/29/2019,5,8721,328,4602,1340,1,13,15005
4/29/2019,6,8719,334,4837,1574,8,18,15490
4/29/2019,7,8722,334,4916,1783,63,26,15844
4/29/2019,8,8723,335,4780,1891,177,26,15932
4/29/2019,9,8724,335,4857,2008,265,25,16214
4/29/2019,10,8733,342,5001,1434,259,25,15794
4/29/2019,11,8739,335,5012,1773,236,28,16123
4/29/2019,12,8764,342,4890,1902,222,42,16162
4/29/2019,13,8767,379,4919,1877,216,80,16238
4/29/2019,14,8793,424,4493,2083,165,93,16051
4/29/2019,15,8862,451,4611,2241,153,86,16404
4/29/2019,16,9016,465,5164,2135,102,81,16963
4/29/2019,17,9095,755,5048,2622,57,82,17659
4/29/2019,18,9116,853,4887,2405,24,83,17368
4/29/2019,19,9115,649,5214,2425,7,83,17493
4/29/2019,20,9116,571,5266,2245,1,52,17251
4/29/2019,21,9121,571,5618,1812,0,27,17149
4/29/2019,22,9120,574,5441,1240,0,27,16402
4/29/2019,23,9186,464,5522,794,0,21,15987
4/29/2019,24,9229,233,5754,429,0,13,15658
4/30/2019,1,9236,216,5064,285,0,11,14812
4/30/2019,2,9234,172,4691,233,0,12,14342
4/30/2019,3,9231,251,4798,269,0,11,14560
4/30/2019,4,9228,469,4937,327,0,13,14974
4/30/2019,5,9225,545,5466,280,1,14,15531
4/30/2019,6,9232,684,5668,393,3,18,15998
4/30/2019,7,9232,877,5845,434,30,24,16442
4/30/2019,8,9224,624,5538,406,102,25,15919
4/30/2019,9,9207,395,5643,355,167,26,15793
4/30/2019,10,9207,362,5191,267,232,29,15288
4/30/2019,11,9204,360,5356,136,286,53,15395
4/30/2019,12,9204,360,5710,92,264,78,15708
4/30/2019,13,9204,360,5576,139,262,81,15622
4/30/2019,14,9205,358,5038,196,282,82,15161
4/30/2019,15,9206,359,5081,101,248,81,15076
4/30/2019,16,9204,362,5104,497,243,81,15491
4/30/2019,17,9203,402,5183,831,154,82,15855
4/30/2019,18,9234,499,5229,830,73,83,15948
4/30/2019,19,9232,719,5223,1049,15,83,16321
4/30/2019,20,9232,735,5157,1205,0,83,16412
4/30/2019,21,9199,734,5081,1203,0,83,16300
4/30/2019,22,8428,741,5371,1365,0,82,15987
4/30/2019,23,8414,658,4683,1530,0,40,15325
4/30/2019,24,8420,560,4359,1587,0,13,14939
5/1/2019,1,8420,281,4349,2008,0,12,15070
5/1/2019,2,8421,186,4290,2471,0,12,15380
5/1/2019,3,8423,186,4342,2454,0,14,15419
5/1/2019,4,8422,186,4314,2715,0,16,15653
5/1/2019,5,8417,186,4349,2737,1,31,15721
5/1/2019,6,8415,247,4705,3054,2,39,16462
5/1/2019,7,8413,336,4814,3293,21,45,16922
5/1/2019,8,8412,406,5253,3309,60,45,17485
5/1/2019,9,8406,410,5574,3118,106,46,17660
5/1/2019,10,8404,410,5451,3040,154,39,17498
5/1/2019,11,8402,411,5580,2995,156,40,17584
5/1/2019,12,8263,483,5475,2959,173,40,17393
5/1/2019,13,8235,524,5375,2941,158,45,17278
5/1/2019,14,8350,751,5517,2824,114,59,17615
5/1/2019,15,8400,780,5268,2731,102,92,17373
5/1/2019,16,8389,989,5671,2694,103,100,17946
5/1/2019,17,8389,1146,5923,2470,47,99,18074
5/1/2019,18,8395,1194,5927,1807,19,96,17438
5/1/2019,19,8403,1683,5827,1443,5,90,17451
5/1/2019,20,8410,1222,5777,1732,0,82,17223
5/1/2019,21,8411,1069,5220,1642,0,82,16424
5/1/2019,22,8407,1006,5173,1479,0,80,16145
5/1/2019,23,8407,667,5294,1106,0,28,15502
5/1/2019,24,8408,394,5634,677,0,14,15127
5/2/2019,1,8413,363,5482,595,0,11,14864
5/2/2019,2,8418,212,5071,570,0,11,14282
5/2/2019,3,8414,286,4884,592,0,11,14187
5/2/2019,4,8420,478,4792,446,0,11,14147
5/2/2019,5,8420,723,4569,437,2,14,14165
5/2/2019,6,8421,1031,5266,343,5,40,15106
5/2/2019,7,8425,1369,5700,312,35,90,15931
5/2/2019,8,8424,1491,5754,259,86,115,16129
5/2/2019,9,8522,1409,5644,169,135,82,15961
5/2/2019,10,8648,1418,5917,101,170,81,16335
5/2/2019,11,8653,1434,5763,69,218,81,16218
5/2/2019,12,8628,1293,5678,58,250,82,15989
5/2/2019,13,8598,1217,5143,118,252,81,15409
5/2/2019,14,8594,1203,5460,76,247,80,15660
5/2/2019,15,8593,1066,5394,94,213,81,15441
5/2/2019,16,8592,974,5354,37,159,81,15197
5/2/2019,17,8594,972,5928,27,101,81,15703
5/2/2019,18,8592,1237,5976,38,42,127,16012
5/2/2019,19,8595,1125,5930,153,13,106,15922
5/2/2019,20,8596,941,6065,240,0,131,15973
5/2/2019,21,8594,921,5805,316,0,96,15732
5/2/2019,22,8594,811,5559,364,0,75,15403
5/2/2019,23,8594,400,5581,327,0,27,14929
5/2/2019,24,8593,222,5457,404,0,13,14689
5/3/2019,1,8597,184,5278,532,0,11,14602
5/3/2019,2,8596,191,5370,422,0,10,14589
5/3/2019,3,8594,204,5345,346,0,10,14499
5/3/2019,4,8598,363,5185,309,0,11,14466
5/3/2019,5,8599,568,5302,312,0,14,14795
5/3/2019,6,8599,877,5475,304,2,36,15293
5/3/2019,7,8597,890,5939,439,16,78,15959
5/3/2019,8,8598,872,5665,648,53,89,15925
5/3/2019,9,8599,852,5476,766,96,83,15872
5/3/2019,10,8603,839,5474,778,142,83,15919
5/3/2019,11,8627,831,5661,731,153,98,16101
5/3/2019,12,8777,373,5402,722,171,88,15533
5/3/2019,13,8811,193,5342,872,175,87,15480
5/3/2019,14,8819,306,5104,989,156,85,15459
5/3/2019,15,8964,514,4982,1103,150,86,15799
5/3/2019,16,8985,591,5009,1118,123,86,15912
5/3/2019,17,8969,592,5272,936,96,86,15951
5/3/2019,18,8974,591,5574,808,41,93,16081
5/3/2019,19,8977,455,5211,823,14,86,15566
5/3/2019,20,8975,414,5756,681,0,95,15921
5/3/2019,21,8972,406,5513,601,0,79,15571
5/3/2019,22,8972,407,5385,580,0,53,15397
5/3/2019,23,8976,402,5174,531,0,32,15115
5/3/2019,24,8980,345,4977,570,0,10,14882
5/4/2019,1,8984,173,5233,336,0,0,14726
5/4/2019,2,8988,97,5411,336,0,0,14832
5/4/2019,3,8996,113,5432,266,0,0,14807
5/4/2019,4,9117,196,4997,229,0,0,14539
5/4/2019,5,9136,274,4869,284,1,0,14564
5/4/2019,6,9138,343,5186,416,2,0,15085
5/4/2019,7,9140,386,5535,327,28,0,15416
5/4/2019,8,9139,849,5978,192,71,0,16229
5/4/2019,9,9141,671,5804,205,146,0,15967
5/4/2019,10,9140,612,5696,197,171,0,15816
5/4/2019,11,9143,830,5828,191,190,0,16182
5/4/2019,12,9152,984,5674,214,190,1,16215
5/4/2019,13,9038,1134,5521,224,211,0,16128
5/4/2019,14,9066,991,5324,216,227,0,15824
5/4/2019,15,9167,941,5382,166,241,0,15897
5/4/2019,16,9155,941,5484,178,220,4,15982
5/4/2019,17,9159,938,5554,177,163,1,15992
5/4/2019,18,9159,924,5808,114,88,0,16093
5/4/2019,19,9164,592,5799,84,23,0,15662
5/4/2019,20,9161,509,5854,116,0,1,15641
5/4/2019,21,9172,508,5743,174,0,1,15598
5/4/2019,22,9175,508,5702,236,0,0,15621
5/4/2019,23,9177,510,5444,209,0,0,15340
5/4/2019,24,9182,350,5475,226,0,0,15233
5/5/2019,1,9181,189,5055,243,0,0,14668
5/5/2019,2,9183,99,5014,252,0,0,14548
5/5/2019,3,9186,99,4839,269,0,0,14393
5/5/2019,4,9190,99,4976,273,0,0,14538
5/5/2019,5,9196,190,4969,334,1,0,14690
5/5/2019,6,9192,303,4975,373,10,0,14853
5/5/2019,7,9188,463,4878,335,59,0,14923
5/5/2019,8,9192,453,4827,179,169,1,14821
5/5/2019,9,9203,454,5178,174,262,1,15272
5/5/2019,10,9202,457,5074,195,366,0,15294
5/5/2019,11,9199,452,5058,190,413,0,15312
5/5/2019,12,9202,480,5018,169,411,0,15280
5/5/2019,13,9198,455,4954,203,397,0,15207
5/5/2019,14,9195,419,4999,223,389,0,15225
5/5/2019,15,9190,494,4997,231,381,0,15293
5/5/2019,16,9189,659,5207,244,323,0,15622
5/5/2019,17,9183,851,5627,266,228,0,16155
5/5/2019,18,9180,907,5830,238,109,0,16264
5/5/2019,19,9179,917,5942,289,28,0,16355
5/5/2019,20,9186,863,5844,289,0,0,16182
5/5/2019,21,9190,873,5896,411,0,0,16370
5/5/2019,22,9193,681,5686,630,0,0,16190
5/5/2019,23,9191,619,5009,837,0,0,15656
5/5/2019,24,9199,252,4538,1064,0,0,15053
5/6/2019,1,9203,101,4014,759,0,0,14077
5/6/2019,2,9178,103,4128,510,0,3,13922
5/6/2019,3,8917,227,4103,630,0,12,13889
5/6/2019,4,8900,322,4178,701,0,11,14112
5/6/2019,5,9058,465,4541,874,1,13,14952
5/6/2019,6,9206,558,5171,684,9,21,15649
5/6/2019,7,9205,664,5478,616,60,27,16050
5/6/2019,8,9209,656,5108,420,188,27,15608
5/6/2019,9,9205,655,5064,363,268,27,15582
5/6/2019,10,9207,655,4970,459,349,27,15667
5/6/2019,11,9196,663,4907,246,334,27,15373
5/6/2019,12,9204,663,4834,449,367,27,15544
5/6/2019,13,9205,504,5022,763,368,27,15889
5/6/2019,14,9205,482,5167,891,350,27,16122
5/6/2019,15,9187,484,4847,1059,301,27,15905
5/6/2019,16,9187,503,4880,948,148,28,15694
5/6/2019,17,9199,579,5055,1271,131,46,16281
5/6/2019,18,9201,866,5349,730,66,74,16286
5/6/2019,19,9204,1026,5689,426,12,80,16437
5/6/2019,20,9206,1041,5575,461,0,86,16369
5/6/2019,21,9207,797,5149,531,0,86,15770
5/6/2019,22,9204,498,4888,731,0,86,15407
5/6/2019,23,9209,334,4586,649,0,71,14849
5/6/2019,24,9204,297,4336,276,0,22,14135
5/7/2019,1,9140,106,4259,239,0,10,13754
5/7/2019,2,8918,102,4253,327,0,11,13611
5/7/2019,3,8923,101,4287,293,0,10,13614
5/7/2019,4,8925,183,4269,334,0,11,13722
5/7/2019,5,8924,326,4536,311,0,15,14112
5/7/2019,6,9076,454,4944,791,2,21,15288
5/7/2019,7,9225,515,5210,814,13,27,15804
5/7/2019,8,9229,1137,4703,641,44,23,15777
5/7/2019,9,9219,1242,4658,351,119,10,15599
5/7/2019,10,9221,880,4399,300,156,9,14965
5/7/2019,11,9220,642,4251,228,177,11,14529
5/7/2019,12,9222,665,4336,396,201,10,14830
5/7/2019,13,9226,692,4441,483,221,9,15072
5/7/2019,14,9219,742,4372,589,233,9,15164
5/7/2019,15,9210,872,4281,564,261,9,15197
5/7/2019,16,9205,967,4227,532,247,9,15187
5/7/2019,17,9206,997,4285,761,205,9,15463
5/7/2019,18,9203,1149,4359,716,112,9,15548
5/7/2019,19,9163,1175,4490,853,25,10,15716
5/7/2019,20,9189,1408,4502,816,0,12,15927
5/7/2019,21,9182,1235,4467,836,0,25,15745
5/7/2019,22,8909,1184,4413,645,0,25,15176
5/7/2019,23,8430,965,4250,1050,0,16,14711
5/7/2019,24,8437,475,4212,944,0,11,14079
5/8/2019,1,8440,302,4253,856,0,11,13862
5/8/2019,2,8439,207,4249,871,0,10,13776
5/8/2019,3,8440,317,4176,773,0,10,13716
5/8/2019,4,8429,480,4260,597,0,11,13777
5/8/2019,5,8417,654,4344,992,1,13,14421
5/8/2019,6,8437,712,4397,1428,10,19,15003
5/8/2019,7,8436,835,4468,1631,63,27,15460
5/8/2019,8,8441,835,4375,1522,190,28,15391
5/8/2019,9,8392,821,4310,1589,324,28,15464
5/8/2019,10,8386,776,4360,1722,397,27,15668
5/8/2019,11,8383,602,4422,1589,401,27,15424
5/8/2019,12,8385,557,4518,1285,410,27,15182
5/8/2019,13,8383,397,4400,1920,410,27,15537
5/8/2019,14,8380,376,4361,1877,401,27,15422
5/8/2019,15,8372,376,4298,1746,388,27,15207
5/8/2019,16,8375,399,4348,1696,349,27,15194
5/8/2019,17,8376,403,4315,2501,228,27,15850
5/8/2019,18,8377,402,4218,2691,101,27,15816
5/8/2019,19,8391,376,4490,2881,20,26,16184
5/8/2019,20,8437,372,4408,3127,0,26,16370
5/8/2019,21,8435,373,4316,3013,0,26,16163
5/8/2019,22,8442,373,4291,2548,0,26,15680
5/8/2019,23,8442,222,4459,2058,0,27,15208
5/8/2019,24,8444,146,4350,1497,0,27,14464
5/9/2019,1,8443,117,4261,1189,0,26,14036
5/9/2019,2,8439,116,4227,1022,0,26,13830
5/9/2019,3,8440,115,4193,859,0,26,13633
5/9/2019,4,8442,110,4192,1110,0,26,13880
5/9/2019,5,8441,112,4239,1641,2,26,14461
5/9/2019,6,8442,199,4213,2554,5,27,15440
5/9/2019,7,8437,331,4380,2589,41,27,15805
5/9/2019,8,8432,450,4393,3099,114,27,16515
5/9/2019,9,8430,453,4471,2806,123,28,16311
5/9/2019,10,8428,455,4494,3101,175,27,16680
5/9/2019,11,8422,462,4289,3123,231,27,16554
5/9/2019,12,8417,474,4347,2141,249,27,15655
5/9/2019,13,8418,496,4539,2244,166,27,15890
5/9/2019,14,8422,548,4411,2735,153,27,16296
5/9/2019,15,8422,602,4562,2618,159,27,16390
5/9/2019,16,8427,623,4688,2821,101,27,16687
5/9/2019,17,8428,1083,5118,2603,62,27,17321
5/9/2019,18,8432,920,4833,2309,35,26,16555
5/9/2019,19,8433,783,4781,2230,10,26,16263
5/9/2019,20,8431,648,4552,2448,0,26,16105
5/9/2019,21,8434,599,4515,2246,0,26,15820
5/9/2019,22,8435,595,4512,1848,0,26,15416
5/9/2019,23,8435,565,4550,1278,0,26,14854
5/9/2019,24,8434,564,4372,1389,0,26,14785
5/10/2019,1,8437,516,4368,1136,0,26,14483
5/10/2019,2,8437,496,4370,804,0,26,14133
5/10/2019,3,8442,496,4376,687,0,26,14027
5/10/2019,4,8436,495,4360,1012,0,25,14328
5/10/2019,5,7958,732,4421,1257,0,26,14394
5/10/2019,6,7931,528,4616,2017,2,26,15120
5/10/2019,7,8131,498,4880,1903,10,26,15448
5/10/2019,8,8246,607,5233,1861,29,25,16001
5/10/2019,9,8366,602,4972,2103,64,25,16132
5/10/2019,10,8318,660,4637,2338,86,25,16064
5/10/2019,11,8408,700,4455,2242,134,25,15964
5/10/2019,12,8495,792,4574,2120,130,27,16138
5/10/2019,13,8491,946,4547,2215,147,26,16372
5/10/2019,14,8489,1029,4607,1654,148,26,15953
5/10/2019,15,8490,1180,4551,1296,158,26,15701
5/10/2019,16,8490,1243,4782,1084,144,26,15769
5/10/2019,17,8498,1258,4888,1010,122,26,15802
5/10/2019,18,8496,1242,5156,805,75,26,15800
5/10/2019,19,8495,1310,5217,704,20,26,15772
5/10/2019,20,8494,1255,5159,627,1,26,15562
5/10/2019,21,8497,1156,5068,446,0,26,15193
5/10/2019,22,8498,1122,4989,398,0,26,15033
5/10/2019,23,8048,983,5094,369,0,26,14520
5/10/2019,24,7922,914,5029,463,0,26,14354
5/11/2019,1,7921,533,4714,560,0,27,13755
5/11/2019,2,7920,371,4729,571,0,28,13619
5/11/2019,3,7919,252,4931,521,0,26,13649
5/11/2019,4,7919,334,4874,495,0,28,13650
5/11/2019,5,7918,393,4772,519,1,29,13632
5/11/2019,6,7914,471,4487,518,7,47,13444
5/11/2019,7,7918,619,4748,469,55,77,13886
5/11/2019,8,7915,819,5116,366,191,95,14502
5/11/2019,9,7920,861,5192,331,297,100,14701
5/11/2019,10,7919,1012,5207,226,329,85,14778
5/11/2019,11,7918,1160,5189,180,307,82,14836
5/11/2019,12,7915,969,5103,238,307,84,14616
5/11/2019,13,7913,873,4826,280,327,83,14302
5/11/2019,14,7910,775,4707,391,287,83,14153
5/11/2019,15,7912,805,4770,482,234,83,14286
5/11/2019,16,7910,870,5015,610,181,83,14669
5/11/2019,17,7915,948,5133,694,106,83,14879
5/11/2019,18,7919,1124,5032,716,64,82,14937
5/11/2019,19,7923,1242,5231,721,17,83,15217
5/11/2019,20,7921,1129,5013,989,1,83,15136
5/11/2019,21,7918,924,4575,1286,0,81,14784
5/11/2019,22,7915,777,4570,1404,0,53,14719
5/11/2019,23,7899,780,4415,1229,0,26,14349
5/11/2019,24,7921,640,4413,995,0,25,13994
5/12/2019,1,7919,251,4414,1250,0,25,13859
5/12/2019,2,7922,173,4215,1112,0,18,13440
5/12/2019,3,7923,173,4271,747,0,18,13132
5/12/2019,4,7923,173,4226,674,0,26,13022
5/12/2019,5,7924,170,4431,444,1,26,12996
5/12/2019,6,7925,169,4339,1016,7,27,13483
5/12/2019,7,7926,182,4362,1643,31,27,14171
5/12/2019,8,7923,322,4497,2197,74,27,15040
5/12/2019,9,7920,417,4747,2059,112,27,15282
5/12/2019,10,7916,421,4542,2168,159,27,15233
5/12/2019,11,7917,541,4464,2287,189,27,15425
5/12/2019,12,7915,667,4359,2366,199,27,15533
5/12/2019,13,7907,784,4446,2301,164,27,15629
5/12/2019,14,7914,649,4588,2333,167,27,15678
5/12/2019,15,7908,574,4815,2355,159,27,15838
5/12/2019,16,7895,652,5051,2310,108,27,16043
5/12/2019,17,7897,645,5114,2366,81,27,16130
5/12/2019,18,7895,601,4877,2327,43,26,15769
5/12/2019,19,7894,621,5092,2212,17,26,15862
5/12/2019,20,7890,750,4814,2240,0,26,15720
5/12/2019,21,7874,765,4610,2100,0,26,15375
5/12/2019,22,7886,768,4659,1963,0,26,15302
5/12/2019,23,7905,566,4826,1661,0,26,14984
5/12/2019,24,7909,278,4764,1536,0,26,14513
5/13/2019,1,7911,233,4568,1317,0,26,14055
5/13/2019,2,7912,246,4683,1085,0,23,13949
5/13/2019,3,7912,328,4821,932,0,15,14008
5/13/2019,4,7908,485,4905,876,0,26,14200
5/13/2019,5,7914,747,4576,868,0,31,14136
5/13/2019,6,7916,998,4976,895,6,42,14833
5/13/2019,7,7915,1339,5193,922,23,72,15464
5/13/2019,8,7914,1314,5299,843,57,78,15505
5/13/2019,9,7912,1469,5201,881,92,86,15641
5/13/2019,10,7906,1701,5303,814,131,134,15989
5/13/2019,11,7910,2025,5180,893,158,142,16308
5/13/2019,12,8106,1797,5097,990,140,91,16221
5/13/2019,13,8215,1583,4953,1218,125,79,16173
5/13/2019,14,8437,1570,4897,1181,115,79,16279
5/13/2019,15,8433,1715,5081,1036,125,79,16469
5/13/2019,16,8478,1794,5059,1361,99,80,16871
5/13/2019,17,8725,1442,5051,1590,66,28,16902
5/13/2019,18,8727,1407,5062,1566,32,34,16828
5/13/2019,19,8729,1413,5019,1502,11,34,16708
5/13/2019,20,8728,1408,4909,1457,0,27,16529
5/13/2019,21,8736,1072,4693,1313,0,27,15841
5/13/2019,22,8735,986,4563,1103,0,27,15414
5/13/2019,23,8701,568,4566,1008,0,26,14869
5/13/2019,24,8684,417,4426,1122,0,26,14675
5/14/2019,1,8681,298,4320,1360,0,28,14687
5/14/2019,2,8684,195,4268,1122,0,27,14296
5/14/2019,3,8680,202,4129,1163,0,26,14200
5/14/2019,4,8806,318,4147,1201,0,26,14498
5/14/2019,5,8941,404,4219,1291,1,26,14882
5/14/2019,6,9027,596,4667,1194,6,28,15518
5/14/2019,7,9032,779,5088,1092,33,27,16051
5/14/2019,8,9159,1071,5076,850,84,28,16268
5/14/2019,9,9221,971,4935,764,135,29,16055
5/14/2019,10,9227,750,4933,793,190,48,15941
5/14/2019,11,9226,680,4828,774,197,77,15782
5/14/2019,12,9255,808,4921,564,181,87,15816
5/14/2019,13,9253,1079,5060,474,203,92,16161
5/14/2019,14,9249,1172,4893,426,192,86,16018
5/14/2019,15,9256,1200,4717,461,187,87,15908
5/14/2019,16,9261,1054,4782,437,170,86,15790
5/14/2019,17,9260,886,5102,478,188,86,16000
5/14/2019,18,9263,826,5329,476,118,86,16098
5/14/2019,19,9264,813,5648,443,27,87,16282
5/14/2019,20,9260,649,5864,524,2,93,16392
5/14/2019,21,9260,342,5801,636,0,81,16120
5/14/2019,22,9267,270,5346,610,0,80,15573
5/14/2019,23,9193,235,4877,653,0,36,14994
5/14/2019,24,9109,273,4483,1007,0,15,14887
5/15/2019,1,9096,284,4052,901,0,12,14345
5/15/2019,2,9131,282,4060,836,0,12,14321
5/15/2019,3,9274,281,3999,743,0,12,14309
5/15/2019,4,9285,279,3972,885,0,13,14434
5/15/2019,5,9285,279,4111,746,1,16,14438
5/15/2019,6,9250,279,4532,1596,13,25,15695
5/15/2019,7,9244,277,5124,1283,60,27,16015
5/15/2019,8,9241,412,5608,648,163,30,16102
5/15/2019,9,9236,523,5351,598,243,35,15986
5/15/2019,10,9229,526,5009,468,321,36,15589
5/15/2019,11,9230,526,4907,416,350,35,15464
5/15/2019,12,9234,528,4929,651,351,33,15726
5/15/2019,13,9244,612,5179,976,314,30,16355
5/15/2019,14,9269,714,5097,1241,315,34,16670
5/15/2019,15,9290,855,5024,1163,257,28,16617
5/15/2019,16,9263,819,5128,1441,182,28,16861
5/15/2019,17,9282,1057,5569,757,152,56,16873
5/15/2019,18,9281,1238,5776,484,87,84,16950
5/15/2019,19,9278,892,5583,500,26,86,16365
5/15/2019,20,9275,707,5704,388,4,86,16164
5/15/2019,21,9273,594,5692,415,0,86,16060
5/15/2019,22,9272,494,5261,578,0,88,15693
5/15/2019,23,9280,445,4569,654,0,72,15020
5/15/2019,24,9288,324,4376,820,0,27,14835
5/16/2019,1,9284,219,4388,374,0,12,14277
5/16/2019,2,9280,231,4067,609,0,11,14198
5/16/2019,3,9283,347,4014,405,0,11,14060
5/16/2019,4,9301,457,4095,315,0,12,14180
5/16/2019,5,9302,556,4365,260,1,15,14499
5/16/2019,6,9305,558,4800,444,12,23,15142
5/16/2019,7,9303,568,5486,394,70,27,15848
5/16/2019,8,9262,604,5446,259,195,28,15794
5/16/2019,9,9257,600,5388,195,312,27,15779
5/16/2019,10,9255,602,5122,327,332,27,15665
5/16/2019,11,9260,690,4775,403,308,27,15463
5/16/2019,12,9263,697,4975,329,309,27,15600
5/16/2019,13,9267,575,4718,714,262,27,15563
5/16/2019,14,9308,563,4939,745,274,27,15856
5/16/2019,15,9304,573,4890,931,225,27,15950
5/16/2019,16,9301,564,4561,1103,165,27,15721
5/16/2019,17,9303,564,4585,1921,117,27,16517
5/16/2019,18,9302,555,4676,2130,40,27,16730
5/16/2019,19,9309,559,4696,2498,10,27,17099
5/16/2019,20,9309,560,4676,2821,1,27,17394
5/16/2019,21,9375,558,4620,1989,0,27,16569
5/16/2019,22,9456,462,4289,1862,0,27,16096
5/16/2019,23,9464,302,4043,1647,0,17,15473
5/16/2019,24,9461,210,4053,964,0,13,14701
5/17/2019,1,9454,207,3992,860,0,10,14523
5/17/2019,2,9448,207,3876,806,0,9,14346
5/17/2019,3,9450,215,3907,604,0,10,14186
5/17/2019,4,9468,293,3909,541,0,12,14223
5/17/2019,5,9458,502,4037,532,1,21,14551
5/17/2019,6,9460,577,4422,900,10,45,15414
5/17/2019,7,9457,581,4679,949,53,79,15798
5/17/2019,8,9402,486,4886,1077,122,89,16062
5/17/2019,9,9399,425,4807,1024,219,92,15966
5/17/2019,10,9397,423,4775,681,249,86,15611
5/17/2019,11,9428,450,5091,747,302,61,16079
5/17/2019,12,9460,454,5154,611,310,27,16016
5/17/2019,13,9417,454,4799,1121,328,27,16146
5/17/2019,14,9413,333,4739,862,338,27,15712
5/17/2019,15,9458,355,4759,800,372,27,15771
5/17/2019,16,9465,206,4628,611,334,27,15271
5/17/2019,17,9463,325,4747,872,215,27,15649
5/17/2019,18,9464,436,5170,681,111,27,15889
5/17/2019,19,9464,541,5071,639,22,27,15764
5/17/2019,20,9466,550,5426,666,3,28,16139
5/17/2019,21,9428,729,5680,409,0,28,16274
5/17/2019,22,9506,612,5157,306,0,28,15609
5/17/2019,23,9686,534,4815,274,0,18,15327
5/17/2019,24,9695,457,4247,297,0,7,14703
5/18/2019,1,9694,249,4068,241,0,0,14252
5/18/2019,2,9695,110,4008,282,0,0,14095
5/18/2019,3,9688,109,3916,352,0,1,14066
5/18/2019,4,9694,108,3855,317,0,0,13974
5/18/2019,5,9696,108,3848,343,1,4,14000
5/18/2019,6,9684,106,4004,421,10,18,14243
5/18/2019,7,9678,111,4196,498,59,44,14586
5/18/2019,8,9668,113,4822,211,160,51,15025
5/18/2019,9,9669,140,4875,590,238,51,15563
5/18/2019,10,9711,138,4901,676,283,51,15760
5/18/2019,11,9782,140,4790,668,277,43,15700
5/18/2019,12,9780,141,4688,432,315,0,15356
5/18/2019,13,9775,215,4396,457,343,0,15186
5/18/2019,14,9733,294,4393,337,321,0,15078
5/18/2019,15,9781,422,4436,274,209,0,15122
5/18/2019,16,9782,485,4409,869,211,0,15756
5/18/2019,17,9778,487,4756,781,109,0,15911
5/18/2019,18,9780,487,4878,787,61,0,15993
5/18/2019,19,9781,488,4922,923,26,0,16140
5/18/2019,20,9779,483,4889,1477,1,0,16629
5/18/2019,21,9790,380,4796,1591,0,0,16557
5/18/2019,22,9788,220,4413,1327,0,0,15748
5/18/2019,23,9719,105,4440,623,0,0,14887
5/18/2019,24,9415,104,4366,486,0,0,14371
5/19/2019,1,9222,102,3974,712,0,0,14010
5/19/2019,2,9227,107,3970,500,0,0,13804
5/19/2019,3,9162,107,3878,435,0,0,13582
5/19/2019,4,8929,106,3911,412,0,0,13358
5/19/2019,5,8934,107,4020,701,1,0,13763
5/19/2019,6,9008,107,3927,876,10,0,13928
5/19/2019,7,9292,108,4068,604,59,0,14131
5/19/2019,8,9530,123,4367,326,115,0,14461
5/19/2019,9,9527,138,4353,450,286,0,14754
5/19/2019,10,9528,137,4447,464,319,0,14895
5/19/2019,11,9532,136,4485,409,229,0,14791
5/19/2019,12,9533,139,4478,577,268,0,14995
5/19/2019,13,9530,137,4340,845,335,0,15187
5/19/2019,14,9532,136,4425,588,199,0,14880
5/19/2019,15,9534,137,4483,853,283,0,15290
5/19/2019,16,9740,137,4388,1515,209,0,15989
5/19/2019,17,9829,135,4540,1952,105,0,16561
5/19/2019,18,9830,136,4557,2066,43,0,16632
5/19/2019,19,9825,133,4485,2267,11,0,16721
5/19/2019,20,9823,133,4582,2362,0,0,16900
5/19/2019,21,9827,133,4458,2021,0,0,16439
5/19/2019,22,9828,131,4377,1322,0,0,15658
5/19/2019,23,9762,105,4008,746,0,0,14621
5/19/2019,24,9509,100,3940,662,0,0,14211
5/20/2019,1,9098,98,3993,387,0,0,13576
5/20/2019,2,8688,99,3906,496,0,0,13189
5/20/2019,3,8409,99,3983,657,0,0,13148
5/20/2019,4,8381,100,3863,751,0,0,13095
5/20/2019,5,8381,101,3936,857,0,0,13275
5/20/2019,6,8440,100,4069,803,8,0,13420
5/20/2019,7,8734,102,4064,814,52,0,13766
5/20/2019,8,9039,104,4356,767,95,0,14361
5/20/2019,9,9218,106,4390,963,123,0,14800
5/20/2019,10,9413,109,4358,1003,170,0,15053
5/20/2019,11,9657,129,4378,719,194,0,15077
5/20/2019,12,9799,129,4309,406,138,0,14781
5/20/2019,13,9801,129,4314,390,109,0,14743
5/20/2019,14,9808,130,4378,669,86,0,15071
5/20/2019,15,9807,130,4455,595,65,0,15052
5/20/2019,16,9805,130,4557,924,100,0,15516
5/20/2019,17,9808,129,4597,1294,100,0,15928
5/20/2019,18,9806,133,4724,1204,45,0,15912
5/20/2019,19,9807,132,4722,1284,15,0,15960
5/20/2019,20,9811,131,4810,1575,0,0,16327
5/20/2019,21,9807,135,4743,1191,0,0,15876
5/20/2019,22,9810,135,4451,957,0,0,15353
5/20/2019,23,9812,144,4167,832,0,0,14955
5/20/2019,24,9813,163,4052,611,0,0,14639
5/21/2019,1,9813,163,3965,427,0,7,14375
5/21/2019,2,9652,246,3918,144,0,13,13973
5/21/2019,3,9224,297,4111,154,0,11,13797
5/21/2019,4,8981,289,4083,544,0,12,13909
5/21/2019,5,9134,301,4139,799,1,14,14388
5/21/2019,6,9563,358,4382,801,10,22,15136
5/21/2019,7,9790,527,4707,614,68,26,15732
5/21/2019,8,9817,594,4769,369,185,27,15761
5/21/2019,9,9822,597,4518,358,301,27,15623
5/21/2019,10,9822,598,4580,326,399,27,15752
5/21/2019,11,9822,597,4628,373,409,27,15856
5/21/2019,12,9822,596,4460,166,254,27,15325
5/21/2019,13,9827,602,4504,202,233,27,15395
5/21/2019,14,9829,613,4431,265,269,27,15434
5/21/2019,15,9829,624,4524,387,342,28,15734
5/21/2019,16,9822,638,4530,295,281,31,15597
5/21/2019,17,9827,772,4941,570,231,46,16387
5/21/2019,18,9827,782,5027,433,114,78,16261
5/21/2019,19,9826,751,5384,294,29,81,16365
5/21/2019,20,9826,752,5473,214,5,90,16360
5/21/2019,21,9823,797,5561,202,0,133,16516
5/21/2019,22,9824,600,5109,191,0,85,15809
5/21/2019,23,9830,317,4543,439,0,27,15156
5/21/2019,24,9831,167,4210,757,0,12,14977
5/22/2019,1,9829,167,3886,714,0,11,14607
5/22/2019,2,9576,166,3840,453,0,11,14046
5/22/2019,3,9537,164,3782,387,0,11,13881
5/22/2019,4,9541,160,3780,561,1,11,14054
5/22/2019,5,9690,160,3787,831,2,13,14483
5/22/2019,6,9842,168,3861,1399,14,23,15307
5/22/2019,7,9837,219,4312,1668,50,28,16114
5/22/2019,8,9833,316,4647,1640,70,28,16534
5/22/2019,9,9831,406,4669,1607,106,28,16647
5/22/2019,10,9836,538,4713,1396,103,28,16614
5/22/2019,11,9840,552,4712,1552,121,28,16805
5/22/2019,12,9726,553,4786,1712,124,28,16929
5/22/2019,13,9684,553,4588,1940,110,27,16902
5/22/2019,14,9685,604,4588,1629,121,28,16655
5/22/2019,15,9688,668,4667,1591,91,27,16732
5/22/2019,16,9684,577,4838,1992,92,28,17211
5/22/2019,17,9739,558,5064,2058,90,28,17537
5/22/2019,18,9840,554,4958,1429,37,26,16844
5/22/2019,19,9846,429,5271,1267,12,26,16851
5/22/2019,20,9842,417,5301,1138,3,26,16727
5/22/2019,21,9840,416,5258,1294,0,27,16835
5/22/2019,22,9840,282,4574,1207,0,27,15930
5/22/2019,23,9844,141,4059,1311,0,16,15371
5/22/2019,24,9842,138,4183,518,0,12,14693
5/23/2019,1,9652,134,4056,323,0,13,14178
5/23/2019,2,9025,134,4002,699,0,13,13873
5/23/2019,3,8991,133,4016,638,0,13,13791
5/23/2019,4,8993,134,4012,835,0,13,13987
5/23/2019,5,9157,134,3944,1300,2,14,14551
5/23/2019,6,9643,145,4250,1522,9,21,15590
5/23/2019,7,9837,198,4456,1719,30,27,16267
5/23/2019,8,9838,340,4681,1643,51,27,16580
5/23/2019,9,9841,454,4719,1926,57,27,17024
5/23/2019,10,9845,523,4670,2345,85,27,17495
5/23/2019,11,9845,512,4476,2329,144,29,17335
5/23/2019,12,9849,510,4703,1812,170,27,17071
5/23/2019,13,9842,510,4801,1514,213,27,16907
5/23/2019,14,9837,520,4687,1400,236,27,16707
5/23/2019,15,9825,524,4745,1376,239,28,16737
5/23/2019,16,9821,546,4616,1650,206,27,16866
5/23/2019,17,9830,437,4726,1697,140,27,16857
5/23/2019,18,9825,419,4680,1684,68,27,16703
5/23/2019,19,9825,406,4559,1931,18,27,16766
5/23/2019,20,9837,409,4692,2103,3,26,17070
5/23/2019,21,10012,420,4591,1858,0,27,16908
5/23/2019,22,10027,413,4600,524,0,26,15590
5/23/2019,23,10030,232,4136,847,0,18,15263
5/23/2019,24,10037,131,3965,445,0,12,14590
5/24/2019,1,9891,126,3939,344,0,11,14311
5/24/2019,2,9469,125,3965,289,0,11,13859
5/24/2019,3,9298,126,3912,449,0,11,13796
5/24/2019,4,9283,129,4075,483,0,11,13981
5/24/2019,5,9488,127,4078,735,1,14,14443
5/24/2019,6,10098,138,4266,627,4,24,15157
5/24/2019,7,10371,252,4766,390,33,27,15839
5/24/2019,8,10367,393,5056,412,103,28,16359
5/24/2019,9,10367,479,4716,290,145,28,16025
5/24/2019,10,10372,529,4757,115,120,28,15921
5/24/2019,11,10374,653,4750,282,250,27,16336
5/24/2019,12,10375,721,4706,87,198,29,16116
5/24/2019,13,10386,728,4798,86,252,27,16277
5/24/2019,14,10394,725,4780,200,238,27,16364
5/24/2019,15,10394,725,4735,247,163,24,16288
5/24/2019,16,10389,728,4863,160,133,26,16299
5/24/2019,17,10388,727,4951,233,92,51,16442
5/24/2019,18,10386,678,4838,106,44,84,16136
5/24/2019,19,10388,454,4869,262,21,141,16135
5/24/2019,20,10386,435,4963,293,4,156,16237
5/24/2019,21,10375,419,5016,356,0,131,16297
5/24/2019,22,10375,419,4776,243,0,78,15891
5/24/2019,23,9998,203,4680,210,0,29,15120
5/24/2019,24,9393,109,4145,589,0,12,14248
5/25/2019,1,9241,110,4055,682,0,0,14088
5/25/2019,2,9257,109,3925,589,0,0,13880
5/25/2019,3,9254,109,3897,321,0,0,13581
5/25/2019,4,9251,109,3970,292,0,0,13622
5/25/2019,5,9245,113,4025,154,1,0,13538
5/25/2019,6,8984,121,4371,190,6,0,13672
5/25/2019,7,8954,138,4668,642,17,0,14419
5/25/2019,8,8948,140,4777,1450,46,0,15361
5/25/2019,9,9054,134,5009,1356,81,3,15637
5/25/2019,10,9408,132,4954,1295,171,25,15985
5/25/2019,11,10128,131,4618,1111,221,53,16262
5/25/2019,12,10276,131,4544,1110,239,59,16359
5/25/2019,13,10271,130,4524,938,241,59,16163
5/25/2019,14,10269,131,4562,901,226,59,16148
5/25/2019,15,10271,132,4558,1251,200,59,16471
5/25/2019,16,10278,130,4683,1478,168,20,16757
5/25/2019,17,10452,131,4749,1893,122,1,17348
5/25/2019,18,10622,131,4670,1694,40,0,17157
5/25/2019,19,10623,132,4616,1532,16,0,16919
5/25/2019,20,10621,115,4641,1533,5,0,16915
5/25/2019,21,10610,111,4602,1441,0,0,16764
5/25/2019,22,10523,113,4626,682,0,0,15944
5/25/2019,23,10002,112,4259,631,0,0,15004
5/25/2019,24,9325,113,4091,462,0,0,13991
5/26/2019,1,8739,111,4062,486,0,0,13398
5/26/2019,2,8564,111,4032,680,0,0,13387
5/26/2019,3,8562,110,3954,654,0,0,13280
5/26/2019,4,8565,110,3941,467,0,0,13083
5/26/2019,5,8567,114,4037,364,1,0,13083
5/26/2019,6,8478,113,4311,451,11,0,13364
5/26/2019,7,8498,115,4671,296,48,0,13628
5/26/2019,8,8670,154,5271,304,112,0,14511
5/26/2019,9,9622,121,4990,317,184,0,15234
5/26/2019,10,9935,110,4705,407,244,0,15401
5/26/2019,11,9941,108,4908,449,274,19,15699
5/26/2019,12,9937,107,4589,245,263,49,15190
5/26/2019,13,9937,109,4619,384,255,57,15361
5/26/2019,14,9940,110,4716,508,244,57,15575
5/26/2019,15,9963,110,4734,604,195,59,15665
5/26/2019,16,9993,113,5298,533,144,113,16194
5/26/2019,17,10163,113,5632,589,124,132,16753
5/26/2019,18,10374,112,5321,309,57,78,16251
5/26/2019,19,10465,112,5604,483,24,70,16758
5/26/2019,20,10636,111,5487,387,7,113,16741
5/26/2019,21,10632,112,5381,489,0,127,16741
5/26/2019,22,10536,109,4935,613,0,99,16292
5/26/2019,23,10525,107,4177,612,0,16,15437
5/26/2019,24,10175,107,4100,200,0,0,14582
5/27/2019,1,9364,108,4028,245,0,12,13757
5/27/2019,2,9158,187,3949,303,0,18,13615
5/27/2019,3,8935,265,4029,324,0,14,13567
5/27/2019,4,8968,265,4377,457,0,14,14081
5/27/2019,5,9138,275,4165,389,2,17,13986
5/27/2019,6,9671,363,4304,535,9,20,14902
5/27/2019,7,10235,499,5079,538,70,51,16472
5/27/2019,8,10606,520,5227,227,192,85,16857
5/27/2019,9,10618,537,5252,78,312,128,16925
5/27/2019,10,10622,543,5532,48,387,92,17224
5/27/2019,11,10616,554,5343,34,370,91,17008
5/27/2019,12,10618,552,5239,80,414,118,17021
5/27/2019,13,10632,541,5067,97,312,92,16741
5/27/2019,14,10626,539,4965,117,383,84,16714
5/27/2019,15,10634,542,5196,122,347,83,16924
5/27/2019,16,10629,540,5608,266,284,82,17409
5/27/2019,17,10664,543,5739,354,151,48,17499
5/27/2019,18,10732,563,5647,334,77,27,17380
5/27/2019,19,10730,545,5616,430,25,29,17375
5/27/2019,20,10738,541,5966,493,2,27,17767
5/27/2019,21,10744,542,5623,736,0,27,17672
5/27/2019,22,10743,445,4668,1080,0,27,16963
5/27/2019,23,10744,287,4047,777,0,16,15871
5/27/2019,24,10606,191,3958,352,0,13,15120
5/28/2019,1,9928,191,3932,576,0,13,14640
5/28/2019,2,9827,191,3862,347,0,12,14239
5/28/2019,3,9683,191,3817,484,0,12,14187
5/28/2019,4,9529,190,3940,537,0,12,14208
5/28/2019,5,9618,193,4113,848,2,16,14790
5/28/2019,6,10257,192,4097,1214,3,20,15783
5/28/2019,7,10756,264,4361,1013,18,27,16439
5/28/2019,8,10776,392,4648,834,56,44,16750
5/28/2019,9,10775,477,4837,1152,107,87,17435
5/28/2019,10,10773,603,4740,1102,133,124,17475
5/28/2019,11,10773,751,4672,1107,155,147,17605
5/28/2019,12,10778,773,4655,1012,166,156,17540
5/28/2019,13,10783,776,4566,1132,191,160,17608
5/28/2019,14,10787,792,4615,810,187,161,17352
5/28/2019,15,10786,657,4623,671,173,139,17049
5/28/2019,16,10789,600,5217,809,133,134,17682
5/28/2019,17,10792,845,5230,730,105,137,17839
5/28/2019,18,10829,898,4979,322,61,152,17241
5/28/2019,19,10874,834,5262,223,15,114,17322
5/28/2019,20,10896,583,5313,289,2,85,17168
5/28/2019,21,10900,337,5207,177,0,104,16725
5/28/2019,22,10903,192,5042,173,0,125,16435
5/28/2019,23,10915,191,4531,200,0,40,15877
5/28/2019,24,10970,191,4200,182,0,22,15565
5/29/2019,1,10657,190,4111,168,0,24,15150
5/29/2019,2,10259,190,4173,166,0,23,14811
5/29/2019,3,10037,189,4227,257,0,21,14731
5/29/2019,4,10037,259,4094,335,0,24,14749
5/29/2019,5,10110,342,4349,446,2,28,15277
5/29/2019,6,10628,408,4506,484,17,37,16080
5/29/2019,7,10925,433,5245,119,44,63,16829
5/29/2019,8,10926,586,5523,46,83,99,17263
5/29/2019,9,10926,681,5347,81,87,142,17264
5/29/2019,10,10916,944,5145,63,105,123,17296
5/29/2019,11,10773,910,4769,62,140,85,16739
5/29/2019,12,10814,783,4986,46,115,85,16829
5/29/2019,13,10910,824,4932,48,129,85,16928
5/29/2019,14,10912,933,4975,47,103,85,17055
5/29/2019,15,10914,1107,4921,38,93,85,17158
5/29/2019,16,10913,1217,4743,50,128,85,17136
5/29/2019,17,10910,1123,5045,46,154,36,17314
5/29/2019,18,10911,1104,4962,62,22,27,17088
5/29/2019,19,10911,1108,5145,85,14,28,17291
5/29/2019,20,10908,1106,5210,118,2,27,17371
5/29/2019,21,10908,1123,5146,246,0,27,17450
5/29/2019,22,10907,888,4997,163,0,27,16982
5/29/2019,23,10909,626,4368,259,0,19,16181
5/29/2019,24,10612,272,4380,368,0,12,15644
5/30/2019,1,10093,192,4238,445,0,9,14977
5/30/2019,2,9709,213,4304,350,0,11,14587
5/30/2019,3,9697,340,4312,316,0,10,14675
5/30/2019,4,9699,374,4393,347,0,13,14826
5/30/2019,5,9852,442,4577,421,2,14,15308
5/30/2019,6,10467,559,4682,478,13,17,16216
5/30/2019,7,11000,565,4699,370,55,25,16714
5/30/2019,8,11052,638,5077,195,97,27,17086
5/30/2019,9,11065,973,5154,337,124,27,17680
5/30/2019,10,11056,1140,5202,492,145,27,18062
5/30/2019,11,11057,1147,5069,381,164,31,17849
5/30/2019,12,11055,1156,4785,144,70,42,17252
5/30/2019,13,11050,1148,4790,171,105,72,17336
5/30/2019,14,11047,995,4593,601,193,82,17511
5/30/2019,15,11057,969,4573,366,247,82,17294
5/30/2019,16,11053,979,4709,509,197,108,17555
5/30/2019,17,11055,981,5073,668,152,147,18076
5/30/2019,18,11059,943,5196,339,82,106,17725
5/30/2019,19,11062,716,5171,540,40,113,17642
5/30/2019,20,11055,713,5173,675,7,156,17779
5/30/2019,21,11054,715,5085,804,0,129,17787
5/30/2019,22,11052,555,4854,776,0,40,17277
5/30/2019,23,10908,336,4411,564,0,19,16238
5/30/2019,24,10319,203,4397,501,0,16,15436
5/31/2019,1,9738,220,4457,730,0,13,15158
5/31/2019,2,9345,220,4504,678,0,12,14759
5/31/2019,3,9337,220,4463,669,0,12,14701
5/31/2019,4,9339,319,4404,626,0,14,14702
5/31/2019,5,9515,458,4494,604,1,15,15087
5/31/2019,6,10100,560,4803,384,16,23,15886
5/31/2019,7,10675,569,5355,317,62,29,17007
5/31/2019,8,10890,601,5583,195,138,27,17434
5/31/2019,9,11110,716,5422,132,233,28,17641
5/31/2019,10,11124,820,5033,156,328,27,17488
5/31/2019,11,11145,753,4979,178,366,27,17448
5/31/2019,12,11146,620,4938,191,384,27,17306
5/31/2019,13,11152,486,5195,264,393,27,17517
5/31/2019,14,11161,559,5183,284,390,27,17604
5/31/2019,15,11161,406,5152,348,331,29,17427
5/31/2019,16,11154,560,5080,525,259,44,17622
5/31/2019,17,11149,466,5017,550,175,84,17441
5/31/2019,18,11155,479,5016,759,78,154,17641
5/31/2019,19,11152,479,4990,702,34,162,17519
5/31/2019,20,11147,482,5000,856,6,160,17651
5/31/2019,21,11129,451,4960,978,0,159,17677
5/31/2019,22,11129,447,4846,1062,0,131,17615
5/31/2019,23,10989,343,4421,550,0,23,16326
5/31/2019,24,10342,200,4397,312,0,1,15252
6/1/2019,1,9367,106,4359,1038,0,0,14870
6/1/2019,2,9211,106,4360,888,0,0,14565
6/1/2019,3,9210,104,4322,800,0,0,14436
6/1/2019,4,9213,105,4278,818,0,0,14414
6/1/2019,5,9217,105,4362,639,2,0,14325
6/1/2019,6,9214,192,4498,600,14,0,14518
6/1/2019,7,9499,342,4487,716,66,0,15110
6/1/2019,8,9802,453,5212,427,109,0,16003
6/1/2019,9,10031,459,5475,304,191,0,16460
6/1/2019,10,10308,474,5466,218,256,0,16722
6/1/2019,11,10298,463,5394,224,346,0,16725
6/1/2019,12,10315,472,5454,279,314,2,16836
6/1/2019,13,10314,498,5427,209,336,4,16788
6/1/2019,14,10543,469,4966,346,259,33,16616
6/1/2019,15,10618,457,4537,594,216,62,16484
6/1/2019,16,10909,450,4853,262,101,55,16630
6/1/2019,17,11178,452,5070,581,109,68,17458
6/1/2019,18,11174,450,5126,292,56,121,17219
6/1/2019,19,11172,450,5016,436,18,131,17223
6/1/2019,20,11168,448,5037,196,2,106,16957
6/1/2019,21,10953,450,5031,433,0,64,16931
6/1/2019,22,10875,262,5037,516,0,57,16747
6/1/2019,23,10866,103,4518,464,0,9,15960
6/1/2019,24,10647,105,4127,303,0,0,15182
6/2/2019,1,9977,109,4121,402,0,0,14609
6/2/2019,2,9354,107,4104,514,0,0,14079
6/2/2019,3,8764,104,4044,578,0,0,13490
6/2/2019,4,8728,103,4007,705,0,0,13543
6/2/2019,5,8719,105,4122,352,1,0,13299
6/2/2019,6,8734,106,4133,652,3,0,13628
6/2/2019,7,8791,105,4207,762,16,1,13882
6/2/2019,8,9264,108,4745,971,47,0,15135
6/2/2019,9,9809,183,5189,906,75,0,16162
6/2/2019,10,9995,266,4902,937,148,0,16248
6/2/2019,11,10294,331,4531,450,171,0,15777
6/2/2019,12,10442,331,4538,494,266,0,16071
6/2/2019,13,10567,378,4603,193,121,0,15862
6/2/2019,14,10469,453,4497,257,92,0,15768
6/2/2019,15,10268,452,4562,293,86,0,15661
6/2/2019,16,10264,451,4690,308,123,0,15836
6/2/2019,17,10288,453,4741,884,217,0,16583
6/2/2019,18,10553,449,4705,1022,114,0,16843
6/2/2019,19,10722,457,4638,899,29,0,16745
6/2/2019,20,10709,282,4657,1559,6,0,17213
6/2/2019,21,10714,141,4643,1715,0,0,17213
6/2/2019,22,10711,108,4459,1408,0,0,16686
6/2/2019,23,10546,103,4081,1144,0,0,15874
6/2/2019,24,9981,106,4037,684,0,2,14810
6/3/2019,1,9528,102,3961,794,0,11,14396
6/3/2019,2,9509,102,3963,600,0,11,14185
6/3/2019,3,9320,105,3808,522,0,10,13765
6/3/2019,4,9270,104,3842,598,0,11,13825
6/3/2019,5,9349,108,3964,732,0,13,14166
6/3/2019,6,9866,212,4066,1181,12,17,15354
6/3/2019,7,10485,328,4544,918,68,26,16369
6/3/2019,8,10717,432,4627,648,149,26,16599
6/3/2019,9,10716,546,4680,431,142,26,16541
6/3/2019,10,10724,547,4553,344,158,26,16352
6/3/2019,11,10742,552,4483,408,227,26,16438
6/3/2019,12,10751,571,4461,347,206,26,16362
6/3/2019,13,10757,663,4434,269,152,26,16301
6/3/2019,14,10761,659,4468,207,114,26,16235
6/3/2019,15,10759,684,4407,313,143,26,16332
6/3/2019,16,10643,722,4429,413,135,26,16368
6/3/2019,17,10810,693,4447,648,219,26,16843
6/3/2019,18,10941,701,4562,656,107,30,16997
6/3/2019,19,10943,699,4554,773,30,40,17039
6/3/2019,20,10941,689,4944,748,8,85,17415
6/3/2019,21,10936,346,4904,621,0,159,16966
6/3/2019,22,10940,195,4800,727,0,161,16823
6/3/2019,23,10938,187,3957,805,0,124,16011
6/3/2019,24,10736,188,3859,257,0,62,15102
6/4/2019,1,10139,188,3744,454,0,19,14544
6/4/2019,2,9911,188,3701,422,0,11,14233
6/4/2019,3,9743,188,3711,599,0,12,14253
6/4/2019,4,9754,189,3763,622,0,13,14341
6/4/2019,5,9911,187,3947,570,0,13,14628
6/4/2019,6,10468,188,4198,683,16,16,15569
6/4/2019,7,10865,189,4718,303,60,23,16158
6/4/2019,8,10930,228,4672,279,145,26,16280
6/4/2019,9,10925,396,4618,570,232,27,16768
6/4/2019,10,10920,430,4723,647,258,28,17006
6/4/2019,11,10922,468,4641,919,215,28,17193
6/4/2019,12,10927,663,4457,1032,211,55,17345
6/4/2019,13,10927,703,4442,999,196,79,17346
6/4/2019,14,10923,860,4491,837,198,84,17393
6/4/2019,15,10922,979,4505,783,194,90,17473
6/4/2019,16,11072,1061,4443,874,157,83,17690
6/4/2019,17,11115,1048,4507,1095,105,100,17970
6/4/2019,18,11117,821,4632,1141,58,90,17859
6/4/2019,19,11118,969,4505,1235,22,123,17972
6/4/2019,20,11112,1006,4019,1736,2,121,17996
6/4/2019,21,11116,822,4079,1816,0,93,17926
6/4/2019,22,11121,336,4065,1423,0,148,17093
6/4/2019,23,11120,157,3706,654,0,106,15743
6/4/2019,24,10693,179,3554,572,0,15,15013
6/5/2019,1,10139,185,3484,677,0,12,14497
6/5/2019,2,9997,185,3476,584,0,12,14254
6/5/2019,3,9978,180,3559,213,0,12,13942
6/5/2019,4,9802,159,3615,444,1,12,14033
6/5/2019,5,9851,156,3713,634,1,16,14371
6/5/2019,6,10276,157,4043,1153,11,19,15659
6/5/2019,7,10826,164,4451,837,50,26,16354
6/5/2019,8,11128,202,4806,1044,86,27,17293
6/5/2019,9,11133,224,4794,653,135,26,16965
6/5/2019,10,11131,395,4707,726,180,27,17166
6/5/2019,11,11126,444,4559,677,215,27,17048
6/5/2019,12,11107,588,4911,602,205,27,17440
6/5/2019,13,11132,654,5018,847,178,27,17856
6/5/2019,14,11129,570,4795,746,115,27,17382
6/5/2019,15,11141,670,5090,538,97,30,17566
6/5/2019,16,11136,709,5163,335,69,47,17459
6/5/2019,17,11127,579,5023,204,58,77,17068
6/5/2019,18,11130,602,5132,236,39,79,17218
6/5/2019,19,11135,538,5104,425,18,79,17299
6/5/2019,20,11121,539,5028,429,3,79,17199
6/5/2019,21,11123,544,4976,467,0,79,17189
6/5/2019,22,11126,536,4641,473,0,79,16855
6/5/2019,23,11132,332,4234,588,0,33,16319
6/5/2019,24,11135,187,3687,629,0,15,15653
6/6/2019,1,11138,190,3399,452,0,15,15194
6/6/2019,2,11080,190,3393,286,0,15,14964
6/6/2019,3,10845,186,3443,280,0,16,14770
6/6/2019,4,10854,187,3545,204,0,15,14805
6/6/2019,5,10891,186,3522,487,1,15,15102
6/6/2019,6,11031,190,3726,495,12,19,15473
6/6/2019,7,11186,190,4613,476,41,26,16532
6/6/2019,8,11178,225,4752,374,120,27,16676
6/6/2019,9,11120,235,4917,100,192,27,16591
6/6/2019,10,11109,293,4988,65,238,26,16719
6/6/2019,11,11114,482,4866,29,308,26,16825
6/6/2019,12,11102,601,4695,51,308,27,16784
6/6/2019,13,11138,711,4724,67,317,28,16985
6/6/2019,14,11293,863,4736,70,242,47,17251
6/6/2019,15,11340,889,4756,53,58,80,17176
6/6/2019,16,11403,1000,4832,58,59,80,17432
6/6/2019,17,11512,733,5074,160,166,80,17725
6/6/2019,18,11523,703,5278,110,69,82,17765
6/6/2019,19,11668,704,5162,97,23,83,17737
6/6/2019,20,11523,705,5249,94,6,83,17660
6/6/2019,21,11451,713,5377,135,0,82,17758
6/6/2019,22,11459,777,5047,182,0,83,17548
6/6/2019,23,11464,355,3888,166,0,41,15914
6/6/2019,24,11438,185,3645,120,0,17,15405
6/7/2019,1,11000,186,3444,90,0,16,14736
6/7/2019,2,10747,187,3398,96,0,17,14445
6/7/2019,3,10464,187,3468,96,0,16,14231
6/7/2019,4,10368,186,3525,101,1,16,14197
6/7/2019,5,10371,186,3827,131,1,16,14532
6/7/2019,6,10377,190,4129,152,11,23,14882
6/7/2019,7,11008,243,4819,161,67,26,16324
6/7/2019,8,11653,391,4465,40,58,26,16633
6/7/2019,9,11827,303,4401,25,55,27,16638
6/7/2019,10,11616,303,4382,38,103,26,16468
6/7/2019,11,11570,391,4302,75,272,27,16637
6/7/2019,12,11446,472,4412,290,408,27,17055
6/7/2019,13,11479,655,4548,438,406,27,17553
6/7/2019,14,11714,781,4407,210,405,27,17544
6/7/2019,15,11798,774,4417,234,363,27,17613
6/7/2019,16,11939,673,4360,323,261,27,17583
6/7/2019,17,11946,522,4417,608,256,27,17776
6/7/2019,18,11952,521,4569,564,129,26,17761
6/7/2019,19,11930,524,4696,572,28,27,17777
6/7/2019,20,11928,525,4578,578,6,27,17642
6/7/2019,21,11939,526,4491,539,0,27,17522
6/7/2019,22,11963,436,4042,381,0,26,16848
6/7/2019,23,11777,198,3691,259,0,18,15943
6/7/2019,24,10946,102,3592,156,0,10,14806
6/8/2019,1,10210,101,3540,182,0,0,14033
6/8/2019,2,9655,102,3635,158,0,0,13550
6/8/2019,3,9515,103,3482,282,0,0,13382
6/8/2019,4,9116,104,3518,668,0,0,13406
6/8/2019,5,9120,103,3622,567,2,0,13414
6/8/2019,6,9116,104,3830,189,6,0,13245
6/8/2019,7,9118,105,4337,337,40,0,13937
6/8/2019,8,9115,105,4410,611,167,0,14408
6/8/2019,9,9116,106,4421,780,284,2,14709
6/8/2019,10,9148,106,4254,844,348,2,14702
6/8/2019,11,9409,107,4345,901,365,0,15127
6/8/2019,12,9433,106,4362,661,397,0,14959
6/8/2019,13,9700,105,4511,512,296,0,15124
6/8/2019,14,9712,106,4482,776,405,0,15481
6/8/2019,15,9702,108,4513,819,410,0,15552
6/8/2019,16,9725,105,4571,1077,355,0,15833
6/8/2019,17,10136,104,4601,1380,248,0,16469
6/8/2019,18,10541,105,4562,1451,116,0,16775
6/8/2019,19,10572,104,4669,1525,36,0,16906
6/8/2019,20,11010,103,4570,1017,8,0,16708
6/8/2019,21,11114,98,4454,1242,0,0,16908
6/8/2019,22,11150,103,4341,600,0,0,16194
6/8/2019,23,11046,102,3784,211,0,0,15143
6/8/2019,24,10416,102,3575,243,0,0,14336
6/9/2019,1,9994,103,3566,530,0,0,14193
6/9/2019,2,9850,103,3577,385,0,0,13915
6/9/2019,3,9632,103,3574,260,0,0,13569
6/9/2019,4,9404,101,3623,583,1,0,13712
6/9/2019,5,9394,98,3680,412,2,0,13586
6/9/2019,6,9196,100,3825,415,15,0,13551
6/9/2019,7,9106,101,4331,307,47,0,13892
6/9/2019,8,9114,100,4443,768,175,0,14600
6/9/2019,9,9415,101,4388,981,244,0,15129
6/9/2019,10,10018,102,4284,892,278,0,15574
6/9/2019,11,10438,102,4356,1136,328,0,16360
6/9/2019,12,11074,101,4301,962,340,0,16778
6/9/2019,13,11147,101,4290,633,334,0,16505
6/9/2019,14,11143,101,4447,668,296,0,16655
6/9/2019,15,11139,101,4463,1013,266,0,16982
6/9/2019,16,11134,101,4512,1086,256,0,17089
6/9/2019,17,11120,100,4627,1506,178,0,17531
6/9/2019,18,11124,102,4922,1434,104,0,17686
6/9/2019,19,11127,104,5126,1414,37,0,17808
6/9/2019,20,11131,102,4929,1626,8,0,17796
6/9/2019,21,11121,99,4583,2099,0,0,17902
6/9/2019,22,11126,97,4335,1728,0,0,17286
6/9/2019,23,11121,101,3737,1361,0,0,16320
6/9/2019,24,11128,103,3654,641,0,0,15526
6/10/2019,1,10800,106,3635,227,0,0,14768
6/10/2019,2,10301,104,3683,387,0,9,14484
6/10/2019,3,10282,103,3656,303,0,14,14358
6/10/2019,4,10284,104,3683,410,1,14,14496
6/10/2019,5,10282,118,3849,710,2,14,14975
6/10/2019,6,10660,166,3873,1160,9,18,15886
6/10/2019,7,11116,224,4520,832,46,26,16764
6/10/2019,8,11129,300,4535,1530,80,27,17601
6/10/2019,9,11132,371,4587,1396,137,27,17650
6/10/2019,10,11127,484,4849,1557,145,27,18189
6/10/2019,11,11119,487,4625,1360,161,27,17779
6/10/2019,12,11133,486,4977,1386,150,27,18159
6/10/2019,13,11300,507,4931,1660,163,28,18589
6/10/2019,14,11337,490,4713,2118,135,28,18821
6/10/2019,15,11333,490,4579,1919,63,37,18421
6/10/2019,16,11334,489,4645,2002,48,43,18561
6/10/2019,17,11334,491,4744,1936,34,40,18579
6/10/2019,18,11345,491,4751,1752,23,29,18391
6/10/2019,19,11347,489,4761,1752,13,27,18389
6/10/2019,20,11343,313,4870,1899,4,27,18456
6/10/2019,21,11497,208,4868,1792,0,27,18392
6/10/2019,22,11653,187,4638,1180,0,27,17685
6/10/2019,23,11644,186,3765,925,0,22,16542
6/10/2019,24,11490,186,3629,338,0,15,15658
6/11/2019,1,10866,193,3586,237,0,12,14894
6/11/2019,2,10267,199,3621,430,0,11,14528
6/11/2019,3,9982,195,3664,418,0,11,14270
6/11/2019,4,9910,195,3735,566,0,11,14417
6/11/2019,5,9926,202,4190,448,1,10,14777
6/11/2019,6,10511,206,4270,630,16,10,15643
6/11/2019,7,11188,223,4503,604,69,10,16597
6/11/2019,8,11354,247,4648,526,171,10,16956
6/11/2019,9,11307,251,4653,475,283,10,16979
6/11/2019,10,11333,362,4530,360,339,9,16933
6/11/2019,11,11471,409,4453,297,319,10,16959
6/11/2019,12,11492,431,4517,260,271,10,16981
6/11/2019,13,11503,466,4488,389,328,9,17183
6/11/2019,14,11502,463,4488,442,313,10,17218
6/11/2019,15,11509,544,4487,200,161,10,16911
6/11/2019,16,11512,656,4601,233,144,10,17156
6/11/2019,17,11519,664,4633,440,208,10,17474
6/11/2019,18,11533,757,4848,269,91,20,17518
6/11/2019,19,11538,759,5243,313,38,27,17918
6/11/2019,20,11536,806,5349,314,8,27,18040
6/11/2019,21,11538,592,5234,405,0,27,17796
6/11/2019,22,11544,545,4927,443,0,27,17486
6/11/2019,23,11475,299,4150,205,0,16,16145
6/11/2019,24,10624,199,4100,156,0,11,15090
6/12/2019,1,10027,202,3696,566,0,12,14503
6/12/2019,2,9893,202,3651,473,0,13,14232
6/12/2019,3,9894,203,3575,441,0,12,14125
6/12/2019,4,9898,193,3656,344,0,11,14102
6/12/2019,5,9918,200,3778,533,2,14,14445
6/12/2019,6,10324,205,3908,712,14,20,15183
6/12/2019,7,10659,229,4570,929,66,26,16479
6/12/2019,8,11141,313,4491,587,173,26,16731
6/12/2019,9,11390,342,4445,358,265,26,16826
6/12/2019,10,11408,370,4433,482,316,26,17035
6/12/2019,11,11616,372,4308,469,307,26,17098
6/12/2019,12,11576,511,4252,450,336,26,17151
6/12/2019,13,11555,649,4304,358,360,26,17252
6/12/2019,14,11558,765,4362,258,349,27,17319
6/12/2019,15,11555,780,4472,364,354,26,17551
6/12/2019,16,11618,786,4530,524,287,26,17771
6/12/2019,17,11905,826,4678,574,199,27,18209
6/12/2019,18,11911,823,4771,743,105,27,18380
6/12/2019,19,11907,750,4855,876,40,27,18455
6/12/2019,20,11907,774,4809,852,8,27,18377
6/12/2019,21,11909,518,4751,945,0,27,18150
6/12/2019,22,11892,422,4371,769,0,27,17481
6/12/2019,23,11415,190,3674,899,0,18,16196
6/12/2019,24,11031,186,3641,319,0,12,15189
6/13/2019,1,10485,185,3678,309,0,10,14667
6/13/2019,2,10215,188,3638,374,0,10,14425
6/13/2019,3,10136,191,3637,356,0,10,14330
6/13/2019,4,9876,205,3673,514,0,10,14278
6/13/2019,5,9892,288,3681,886,2,9,14758
6/13/2019,6,10351,435,3742,894,5,9,15436
6/13/2019,7,11221,459,4476,733,29,9,16927
6/13/2019,8,11412,452,4650,918,55,6,17493
6/13/2019,9,11646,468,4912,761,51,9,17847
6/13/2019,10,11914,487,4739,795,58,9,18002
6/13/2019,11,11930,485,4761,776,79,9,18040
6/13/2019,12,11931,485,4642,740,82,9,17889
6/13/2019,13,11938,483,4511,818,110,9,17869
6/13/2019,14,11935,486,4509,933,96,9,17968
6/13/2019,15,11930,257,4628,896,82,9,17802
6/13/2019,16,11923,204,4710,1083,91,9,18020
6/13/2019,17,11920,179,4630,1050,64,9,17852
6/13/2019,18,11929,187,4758,786,47,9,17716
6/13/2019,19,11933,184,4621,1128,11,24,17901
6/13/2019,20,11939,177,4595,1275,1,27,18014
6/13/2019,21,11926,173,4592,1024,0,28,17743
6/13/2019,22,11848,173,4390,385,0,27,16823
6/13/2019,23,11305,173,3748,738,0,18,15982
6/13/2019,24,10749,172,3636,412,0,12,14981
6/14/2019,1,10276,173,3593,304,0,10,14356
6/14/2019,2,9814,172,3580,276,0,10,13852
6/14/2019,3,9560,172,3556,351,0,10,13649
6/14/2019,4,9548,172,3612,404,0,9,13745
6/14/2019,5,9551,174,3711,653,2,9,14100
6/14/2019,6,9830,177,4125,877,14,9,15032
6/14/2019,7,10626,176,4439,865,42,9,16157
6/14/2019,8,11328,174,4457,399,102,9,16469
6/14/2019,9,11393,176,4599,208,118,9,16503
6/14/2019,10,11395,177,4640,179,33,9,16433
6/14/2019,11,11401,181,4615,211,59,9,16476
6/14/2019,12,11403,178,4409,303,174,11,16478
6/14/2019,13,11408,177,4219,480,261,10,16555
6/14/2019,14,11409,176,4004,699,303,9,16600
6/14/2019,15,11402,177,4034,697,307,10,16627
6/14/2019,16,11481,176,4019,1094,250,10,17030
6/14/2019,17,11919,178,3999,1066,199,13,17374
6/14/2019,18,12007,179,4489,869,94,12,17650
6/14/2019,19,12014,179,4590,962,37,14,17796
6/14/2019,20,12013,179,4549,1333,8,22,18104
6/14/2019,21,12015,178,4284,1546,0,26,18049
6/14/2019,22,12076,179,4222,465,0,26,16968
6/14/2019,23,11607,103,3718,658,0,16,16102
6/14/2019,24,10630,94,3654,814,0,9,15201
6/15/2019,1,10075,104,3959,423,0,1,14562
6/15/2019,2,9792,102,3598,745,0,0,14237
6/15/2019,3,9773,102,3369,671,0,0,13915
6/15/2019,4,9775,102,3348,621,0,0,13846
6/15/2019,5,9774,102,3431,618,2,0,13927
6/15/2019,6,9776,100,3467,929,5,0,14277
6/15/2019,7,9915,101,4236,525,32,2,14811
6/15/2019,8,10305,101,4479,720,67,1,15673
6/15/2019,9,10742,104,4445,686,100,0,16077
6/15/2019,10,11241,102,4357,688,162,0,16550
6/15/2019,11,11268,103,4341,378,176,0,16266
6/15/2019,12,11268,104,4188,1059,144,0,16763
6/15/2019,13,11461,105,4217,587,56,0,16426
6/15/2019,14,11512,105,4282,468,57,0,16424
6/15/2019,15,11512,104,4321,575,46,0,16558
6/15/2019,16,11600,105,4309,893,37,0,16944
6/15/2019,17,11819,106,4432,785,32,0,17174
6/15/2019,18,11853,108,4363,957,17,0,17298
6/15/2019,19,12112,108,4393,970,8,0,17591
6/15/2019,20,12118,106,4247,815,4,0,17290
6/15/2019,21,12111,108,4138,555,0,0,16912
6/15/2019,22,11963,104,4306,404,0,0,16777
6/15/2019,23,11597,105,3995,213,0,0,15910
6/15/2019,24,10930,105,3896,221,0,0,15152
6/16/2019,1,10544,105,3648,312,0,0,14609
6/16/2019,2,10225,106,3455,397,0,0,14183
6/16/2019,3,10077,106,3525,440,0,0,14148
6/16/2019,4,10082,104,3510,399,1,0,14096
6/16/2019,5,9929,103,3527,430,2,0,13991
6/16/2019,6,9776,104,3731,437,10,0,14058
6/16/2019,7,9774,104,3955,663,57,0,14553
6/16/2019,8,9843,104,4105,698,143,0,14893
6/16/2019,9,10288,103,4316,325,214,0,15246
6/16/2019,10,10381,103,4372,597,267,0,15720
6/16/2019,11,10372,103,4256,209,274,0,15214
6/16/2019,12,10372,104,4186,444,274,0,15380
6/16/2019,13,10336,104,4257,437,242,0,15376
6/16/2019,14,10379,104,4418,366,221,0,15488
6/16/2019,15,10379,104,4732,280,200,0,15695
6/16/2019,16,10467,111,4917,317,190,0,16002
6/16/2019,17,11315,106,4450,268,148,0,16287
6/16/2019,18,11491,105,4458,117,101,0,16272
6/16/2019,19,11521,106,5158,199,35,0,17019
6/16/2019,20,11844,104,4814,128,8,0,16898
6/16/2019,21,12095,105,4668,105,0,0,16973
6/16/2019,22,11896,104,4376,129,0,0,16505
6/16/2019,23,11504,106,3953,167,0,0,15730
6/16/2019,24,11037,105,3677,77,0,0,14896
6/17/2019,1,10331,104,3713,151,0,2,14301
6/17/2019,2,10073,106,3946,137,0,12,14274
6/17/2019,3,10073,106,3927,203,0,11,14320
6/17/2019,4,10150,105,3941,235,0,12,14443
6/17/2019,5,10797,109,3696,176,2,14,14794
6/17/2019,6,11180,127,3838,133,13,22,15313
6/17/2019,7,11739,175,4387,176,68,28,16573
6/17/2019,8,12115,301,4222,78,107,35,16858
6/17/2019,9,12117,332,4276,37,155,36,16953
6/17/2019,10,12120,340,4266,24,132,35,16917
6/17/2019,11,12147,337,4303,71,329,37,17224
6/17/2019,12,12163,341,4305,91,322,38,17260
6/17/2019,13,12157,376,4585,112,327,35,17592
6/17/2019,14,12157,516,4525,171,323,33,17725
6/17/2019,15,12150,524,4505,65,245,32,17521
6/17/2019,16,12151,525,4768,107,270,27,17848
6/17/2019,17,12151,527,4834,94,191,27,17824
6/17/2019,18,12154,526,5066,46,45,27,17864
6/17/2019,19,12149,527,5203,79,41,27,18026
6/17/2019,20,12148,529,5294,81,8,27,18087
6/17/2019,21,12144,533,5251,86,0,27,18041
6/17/2019,22,12076,536,5020,98,0,27,17757
6/17/2019,23,11832,327,4105,72,0,17,16353
6/17/2019,24,11606,226,3921,28,0,11,15792
6/18/2019,1,11324,186,3908,50,0,10,15478
6/18/2019,2,11116,184,3747,62,0,10,15119
6/18/2019,3,10999,188,3769,113,0,10,15079
6/18/2019,4,11001,187,3765,179,0,11,15143
6/18/2019,5,11070,187,3983,236,0,14,15490
6/18/2019,6,11416,187,4048,208,10,23,15892
6/18/2019,7,11798,197,4524,163,59,28,16769
6/18/2019,8,12131,341,4820,52,113,28,17485
6/18/2019,9,11972,457,4687,27,173,29,17345
6/18/2019,10,11964,569,4656,8,277,28,17502
6/18/2019,11,11968,568,4683,3,109,35,17366
6/18/2019,12,11966,569,4660,13,354,36,17598
6/18/2019,13,11969,568,4744,11,267,40,17599
6/18/2019,14,11962,566,4782,17,234,53,17614
6/18/2019,15,11961,566,4826,40,263,87,17743
6/18/2019,16,12091,570,5148,70,234,83,18196
6/18/2019,17,12128,611,5300,115,207,80,18441
6/18/2019,18,12145,628,5351,91,105,80,18400
6/18/2019,19,12151,624,5214,62,36,80,18167
6/18/2019,20,12152,576,5012,31,7,80,17858
6/18/2019,21,12143,565,5068,19,0,80,17875
6/18/2019,22,12138,360,5150,9,0,80,17737
6/18/2019,23,11839,224,4353,4,0,69,16489
6/18/2019,24,11166,203,4026,9,0,36,15440
6/19/2019,1,11004,180,4191,8,0,10,15393
6/19/2019,2,11006,180,3986,15,0,10,15197
6/19/2019,3,10855,183,3891,25,0,10,14964
6/19/2019,4,10701,184,4097,19,0,10,15011
6/19/2019,5,10774,184,4352,25,3,14,15352
6/19/2019,6,11051,184,4323,18,14,20,15610
6/19/2019,7,11468,285,5177,34,66,27,17057
6/19/2019,8,11977,427,4735,23,171,27,17360
6/19/2019,9,12110,567,4446,10,272,27,17432
6/19/2019,10,12141,523,4330,8,282,27,17311
6/19/2019,11,12136,552,4495,15,216,44,17458
6/19/2019,12,11986,551,4984,22,287,75,17905
6/19/2019,13,11949,572,5009,48,335,80,17993
6/19/2019,14,11955,596,4902,72,308,81,17914
6/19/2019,15,12124,627,4898,22,145,81,17897
6/19/2019,16,12131,725,5128,54,213,81,18332
6/19/2019,17,12139,825,5068,81,167,84,18364
6/19/2019,18,12135,877,5195,120,111,90,18528
6/19/2019,19,12134,957,5388,119,40,83,18721
6/19/2019,20,12125,935,5535,129,7,84,18815
6/19/2019,21,12114,906,5432,171,0,84,18707
6/19/2019,22,12106,874,5155,140,0,40,18315
6/19/2019,23,11923,695,4458,104,0,24,17204
6/19/2019,24,11527,417,4595,260,0,15,16814
6/20/2019,1,11123,196,3903,318,0,12,15552
6/20/2019,2,10938,185,3847,401,0,12,15383
6/20/2019,3,10943,204,3751,373,0,12,15283
6/20/2019,4,10947,332,3718,186,0,20,15203
6/20/2019,5,10803,346,3848,234,0,33,15264
6/20/2019,6,10867,346,4257,681,3,45,16199
6/20/2019,7,11365,350,4713,591,18,47,17084
6/20/2019,8,11751,230,4672,551,44,49,17297
6/20/2019,9,12025,165,4648,531,72,52,17493
6/20/2019,10,12152,280,4568,507,93,51,17651
6/20/2019,11,12141,414,4335,374,106,58,17428
6/20/2019,12,12137,523,4399,361,135,59,17614
6/20/2019,13,12141,528,4362,257,157,54,17499
6/20/2019,14,12138,530,4503,393,150,52,17766
6/20/2019,15,12137,528,4515,444,131,47,17802
6/20/2019,16,12138,531,4554,935,94,51,18303
6/20/2019,17,12142,530,4568,858,74,50,18222
6/20/2019,18,12136,525,4797,619,45,42,18164
6/20/2019,19,12119,432,4694,779,19,35,18078
6/20/2019,20,12109,270,4674,989,3,28,18073
6/20/2019,21,12121,186,4503,1326,0,27,18163
6/20/2019,22,12132,190,4529,702,0,36,17589
6/20/2019,23,11651,190,3909,561,0,35,16346
6/20/2019,24,10953,191,3768,502,0,39,15453
6/21/2019,1,10551,192,3642,543,0,40,14968
6/21/2019,2,10251,193,3524,441,0,38,14447
6/21/2019,3,10102,194,3461,448,0,38,14243
6/21/2019,4,10102,193,3507,428,0,42,14272
6/21/2019,5,10100,191,3667,441,1,52,14452
6/21/2019,6,10390,192,4051,777,11,58,15479
6/21/2019,7,10695,202,4715,483,55,63,16213
6/21/2019,8,11115,268,4859,499,149,64,16954
6/21/2019,9,11611,222,4569,373,276,64,17115
6/21/2019,10,11836,219,4428,284,334,61,17162
6/21/2019,11,11839,228,4390,490,305,56,17308
6/21/2019,12,11843,233,4298,714,294,56,17438
6/21/2019,13,12112,231,3993,624,272,58,17290
6/21/2019,14,12154,216,4146,442,273,56,17287
6/21/2019,15,12153,214,4197,894,269,52,17779
6/21/2019,16,12143,215,4362,762,220,54,17756
6/21/2019,17,12146,214,4516,1046,159,51,18132
6/21/2019,18,12146,215,4658,1017,100,48,18184
6/21/2019,19,12151,168,4937,716,38,48,18058
6/21/2019,20,12146,176,5230,490,9,53,18104
6/21/2019,21,12152,172,4564,464,0,43,17395
6/21/2019,22,12150,168,4451,361,0,43,17173
6/21/2019,23,11751,109,3894,666,0,34,16454
6/21/2019,24,11196,106,3655,159,0,25,15141
6/22/2019,1,10497,107,3400,292,0,19,14315
6/22/2019,2,10191,106,3377,252,0,2,13928
6/22/2019,3,9960,105,3357,335,0,0,13757
6/22/2019,4,9810,105,3428,438,0,0,13781
6/22/2019,5,9813,104,3409,506,1,2,13835
6/22/2019,6,9817,104,3700,839,12,6,14478
6/22/2019,7,10055,104,4227,587,66,15,15054
6/22/2019,8,10472,105,4774,219,175,5,15750
6/22/2019,9,10923,105,4781,68,302,0,16179
6/22/2019,10,10949,105,4391,86,390,0,15921
6/22/2019,11,10943,99,4575,172,422,0,16211
6/22/2019,12,10941,180,4447,317,421,8,16314
6/22/2019,13,10941,213,4337,495,410,16,16412
6/22/2019,14,10949,255,4206,616,413,17,16456
6/22/2019,15,11177,321,4195,384,412,17,16506
6/22/2019,16,11266,323,4393,599,358,19,16958
6/22/2019,17,11692,326,4600,638,257,18,17531
6/22/2019,18,12127,326,4471,525,133,15,17597
6/22/2019,19,12148,325,4571,459,39,15,17557
6/22/2019,20,12153,324,4459,434,9,16,17395
6/22/2019,21,12150,193,4323,463,0,10,17139
6/22/2019,22,12154,103,4442,392,0,17,17108
6/22/2019,23,11793,102,3848,380,0,21,16144
6/22/2019,24,11270,101,4009,333,0,21,15734
6/23/2019,1,10963,104,3537,299,0,22,14925
6/23/2019,2,10157,104,3435,233,0,23,13952
6/23/2019,3,9675,105,3748,215,0,23,13766
6/23/2019,4,9641,104,3772,164,0,26,13707
6/23/2019,5,9639,104,3697,134,2,25,13601
6/23/2019,6,9645,104,3731,96,16,30,13622
6/23/2019,7,9644,104,4097,96,68,30,14039
6/23/2019,8,10150,96,4395,34,182,30,14887
6/23/2019,9,10948,115,4616,43,292,31,16045
6/23/2019,10,11269,104,4592,83,384,32,16464
6/23/2019,11,11722,217,4541,149,417,33,17079
6/23/2019,12,11838,327,4202,126,418,11,16922
6/23/2019,13,11835,444,4213,275,423,0,17190
6/23/2019,14,11835,447,4198,237,401,0,17118
6/23/2019,15,11825,450,4365,170,385,0,17195
6/23/2019,16,11821,452,4956,311,343,0,17883
6/23/2019,17,12115,464,5458,378,246,0,18661
6/23/2019,18,12134,544,5568,396,135,0,18777
6/23/2019,19,12138,532,5493,405,38,0,18606
6/23/2019,20,12129,494,4971,571,8,0,18173
6/23/2019,21,12117,401,4947,618,0,0,18083
6/23/2019,22,12120,223,4633,464,0,1,17441
6/23/2019,23,11875,103,3841,949,0,0,16768
6/23/2019,24,11823,104,3496,745,0,0,16168
6/24/2019,1,11845,102,3355,687,0,5,15994
6/24/2019,2,11848,102,3279,284,0,12,15525
6/24/2019,3,11647,101,3302,238,0,11,15299
6/24/2019,4,11546,101,3376,296,0,13,15332
6/24/2019,5,11543,104,3360,619,2,13,15641
6/24/2019,6,11696,137,3687,692,12,20,16244
6/24/2019,7,12117,154,4318,384,46,25,17044
6/24/2019,8,12128,191,4441,836,133,27,17756
6/24/2019,9,12122,191,4464,622,171,27,17597
6/24/2019,10,12127,190,4419,862,211,30,17839
6/24/2019,11,12127,272,4372,1257,305,32,18365
6/24/2019,12,12118,346,4437,1205,290,27,18423
6/24/2019,13,12111,413,4468,1470,320,28,18810
6/24/2019,14,12108,406,4409,1463,328,27,18741
6/24/2019,15,12107,407,4485,1357,269,28,18653
6/24/2019,16,12104,412,4812,1597,191,39,19155
6/24/2019,17,12104,641,5128,1326,149,68,19416
6/24/2019,18,12104,552,5172,1187,97,83,19195
6/24/2019,19,12102,433,5142,1021,32,85,18815
6/24/2019,20,12094,406,4927,1165,5,86,18683
6/24/2019,21,12088,282,4739,1439,0,86,18634
6/24/2019,22,12087,196,4483,1059,0,45,17870
6/24/2019,23,12091,160,4002,761,0,19,17033
6/24/2019,24,12026,153,3399,284,0,13,15875
6/25/2019,1,11497,154,3325,350,0,11,15337
6/25/2019,2,11189,153,3319,406,0,11,15078
6/25/2019,3,11188,150,3350,1009,0,11,15708
6/25/2019,4,11186,151,3398,1217,0,11,15963
6/25/2019,5,11560,151,3469,935,1,14,16130
6/25/2019,6,12013,224,3660,815,3,22,16737
6/25/2019,7,12090,316,4293,734,26,27,17486
6/25/2019,8,12085,395,4307,1194,97,27,18105
6/25/2019,9,12086,441,4426,838,208,27,18026
6/25/2019,10,12083,449,4387,850,277,27,18073
6/25/2019,11,12079,461,4253,1098,338,27,18256
6/25/2019,12,12075,498,4195,1248,343,28,18387
6/25/2019,13,12071,568,4236,1221,327,38,18461
6/25/2019,14,12070,543,4288,1241,324,67,18533
6/25/2019,15,12072,453,4397,1276,334,86,18618
6/25/2019,16,12074,520,4626,1368,264,87,18939
6/25/2019,17,12082,515,4979,1406,203,86,19271
6/25/2019,18,12077,539,5043,1510,111,84,19364
6/25/2019,19,12083,891,5095,1334,31,83,19517
6/25/2019,20,12083,547,4829,1192,7,83,18741
6/25/2019,21,12084,515,4473,1134,1,83,18290
6/25/2019,22,12084,524,4432,977,0,36,18053
6/25/2019,23,12093,308,3618,796,0,18,16833
6/25/2019,24,12090,224,3324,542,0,12,16192
6/26/2019,1,12077,227,3271,501,0,10,16086
6/26/2019,2,12073,227,3295,630,0,10,16235
6/26/2019,3,12059,229,3295,383,0,10,15976
6/26/2019,4,12077,235,3248,256,1,11,15828
6/26/2019,5,12090,285,3310,368,2,14,16069
6/26/2019,6,12089,330,3426,491,12,22,16370
6/26/2019,7,12083,420,4106,789,46,28,17472
6/26/2019,8,12066,528,4380,1140,112,28,18254
6/26/2019,9,12047,745,4435,971,225,37,18460
6/26/2019,10,12034,783,4443,882,338,50,18530
6/26/2019,11,12023,898,4411,882,384,72,18670
6/26/2019,12,11901,1114,4452,376,182,103,18128
6/26/2019,13,11866,1320,4579,606,365,104,18840
6/26/2019,14,11935,1664,4402,507,268,101,18877
6/26/2019,15,12028,1777,4535,447,206,104,19097
6/26/2019,16,12042,1750,4595,941,260,97,19685
6/26/2019,17,12057,1781,4617,1242,230,112,20039
6/26/2019,18,12061,1644,5085,1062,122,153,20127
6/26/2019,19,12070,1814,5463,758,32,157,20294
6/26/2019,20,12073,1804,5470,464,8,163,19982
6/26/2019,21,12072,1324,5367,344,1,166,19274
6/26/2019,22,12071,1318,4861,324,0,165,18739
6/26/2019,23,12067,626,3918,423,0,112,17146
6/26/2019,24,12059,242,3647,240,0,54,16242
6/27/2019,1,12057,189,3293,194,0,36,15769
6/27/2019,2,11860,190,3196,184,0,34,15464
6/27/2019,3,11563,202,3312,324,0,31,15432
6/27/2019,4,11468,287,3638,274,1,20,15688
6/27/2019,5,11469,524,3736,181,2,13,15925
6/27/2019,6,11665,855,3792,193,10,19,16534
6/27/2019,7,11830,1111,4149,189,65,27,17371
6/27/2019,8,12046,1179,4553,142,148,27,18095
6/27/2019,9,12031,1411,4921,42,240,46,18691
6/27/2019,10,12029,1697,4854,23,304,80,18987
6/27/2019,11,12032,1828,4771,49,328,104,19112
6/27/2019,12,12031,1997,4497,62,321,103,19011
6/27/2019,13,12034,2017,4752,163,327,107,19400
6/27/2019,14,12035,2185,4726,223,359,100,19628
6/27/2019,15,12033,1906,4925,316,344,101,19625
6/27/2019,16,12039,1939,5248,244,304,111,19885
6/27/2019,17,12040,2024,5136,213,228,133,19774
6/27/2019,18,12030,1928,5196,161,132,140,19587
6/27/2019,19,12023,2102,5455,113,35,171,19899
6/27/2019,20,12014,1765,5468,99,8,177,19531
6/27/2019,21,12012,1449,5307,252,0,142,19162
6/27/2019,22,12018,978,5111,250,0,141,18498
6/27/2019,23,12014,405,4205,174,0,97,16895
6/27/2019,24,12011,255,3639,118,0,24,16047
6/28/2019,1,12008,249,3535,154,0,11,15957
6/28/2019,2,12016,253,3351,258,0,11,15889
6/28/2019,3,11782,254,3296,97,0,11,15440
6/28/2019,4,11432,331,3332,303,0,11,15409
6/28/2019,5,11417,341,3345,253,2,13,15371
6/28/2019,6,11433,486,3746,286,9,21,15981
6/28/2019,7,11504,766,4532,414,57,27,17300
6/28/2019,8,11939,1117,4740,260,152,29,18237
6/28/2019,9,12008,1366,4487,166,259,27,18313
6/28/2019,10,12001,1531,4538,126,335,27,18558
6/28/2019,11,11984,1820,4634,165,308,37,18948
6/28/2019,12,11999,1847,4798,378,312,65,19399
6/28/2019,13,12003,2017,5016,411,328,83,19858
6/28/2019,14,12001,2154,4878,266,315,83,19697
6/28/2019,15,12002,2016,4653,74,142,83,18970
6/28/2019,16,12010,1692,4780,97,128,84,18791
6/28/2019,17,12012,1235,4893,344,136,84,18704
6/28/2019,18,12020,1061,4939,281,82,84,18467
6/28/2019,19,12016,681,5080,219,24,82,18102
6/28/2019,20,12018,629,5534,333,7,38,18559
6/28/2019,21,12007,494,4986,558,0,27,18072
6/28/2019,22,12015,326,5230,312,0,27,17910
6/28/2019,23,12035,215,4689,388,0,21,17348
6/28/2019,24,12017,187,3643,440,0,8,16295
6/29/2019,1,11748,185,3563,285,0,0,15781
6/29/2019,2,11732,182,3367,293,0,0,15574
6/29/2019,3,11737,180,3323,268,0,0,15508
6/29/2019,4,11740,182,3258,344,0,0,15524
6/29/2019,5,11723,183,3211,354,2,0,15473
6/29/2019,6,11456,181,3581,203,6,0,15427
6/29/2019,7,11510,182,3815,249,51,0,15807
6/29/2019,8,11887,183,4618,223,121,0,17032
6/29/2019,9,12030,183,4510,221,196,0,17140
6/29/2019,10,12032,185,4822,164,281,0,17484
6/29/2019,11,12035,383,4873,162,307,5,17765
6/29/2019,12,12045,384,4584,296,303,5,17617
6/29/2019,13,12044,420,4691,423,261,18,17857
6/29/2019,14,12048,441,4589,576,300,52,18006
6/29/2019,15,12041,469,4743,640,304,59,18256
6/29/2019,16,12038,693,4920,922,289,59,18921
6/29/2019,17,12032,684,5206,1251,212,59,19444
6/29/2019,18,12038,628,5091,1374,123,57,19311
6/29/2019,19,12031,594,5383,1067,34,10,19119
6/29/2019,20,12026,622,5454,724,6,0,18832
6/29/2019,21,12041,550,4812,605,0,0,18008
6/29/2019,22,12048,243,4518,507,0,0,17316
6/29/2019,23,12061,182,4292,358,0,0,16893
6/29/2019,24,12058,184,3304,383,0,0,15929
6/30/2019,1,11926,182,3018,267,0,0,15393
6/30/2019,2,11725,183,2996,302,0,0,15206
6/30/2019,3,11502,182,3006,753,0,0,15443
6/30/2019,4,11502,182,2990,296,0,0,14970
6/30/2019,5,11179,182,3081,268,1,0,14711
6/30/2019,6,10957,183,3543,200,8,0,14891
6/30/2019,7,11032,182,3638,477,45,0,15374
6/30/2019,8,11522,182,3722,444,158,0,16028
6/30/2019,9,12089,180,3708,266,235,0,16478
6/30/2019,10,12114,181,3724,258,309,0,16586
6/30/2019,11,12119,292,3718,217,247,0,16593
6/30/2019,12,12118,402,3783,276,231,0,16810
6/30/2019,13,12123,513,3799,323,386,0,17144
6/30/2019,14,12096,517,4198,216,164,0,17191
6/30/2019,15,12115,529,4352,219,113,0,17328
6/30/2019,16,12121,532,4554,178,157,0,17542
6/30/2019,17,12144,547,4509,649,255,0,18104
6/30/2019,18,12158,702,4887,524,135,0,18406
6/30/2019,19,12154,709,4704,517,38,0,18122
6/30/2019,20,12156,708,4468,201,7,0,17540
6/30/2019,21,12152,620,4583,219,0,0,17574
6/30/2019,22,12144,342,4236,338,0,0,17060
6/30/2019,23,12067,178,3808,264,0,0,16317
6/30/2019,24,11734,179,3311,188,0,0,15412
7/1/2019,1,11138,177,3406,217,0,0,14938
7/1/2019,2,10987,177,3356,259,0,0,14779
7/1/2019,3,10992,178,3026,280,0,0,14476
7/1/2019,4,10997,178,2905,235,0,0,14315
7/1/2019,5,11005,184,2921,191,2,0,14303
7/1/2019,6,11011,184,3306,153,6,0,14660
7/1/2019,7,11145,220,3620,203,60,8,15256
7/1/2019,8,11253,238,3867,72,148,6,15584
7/1/2019,9,11256,402,3763,87,269,0,15777
7/1/2019,10,11322,583,3973,177,324,0,16379
7/1/2019,11,11532,829,3947,171,351,0,16830
7/1/2019,12,11737,1008,4005,267,357,0,17374
7/1/2019,13,11811,1025,4334,317,364,0,17851
7/1/2019,14,11879,1162,4340,361,368,0,18110
7/1/2019,15,12093,1278,4512,221,204,0,18308
7/1/2019,16,12102,1323,4790,699,306,0,19220
7/1/2019,17,12100,1271,5171,755,224,0,19521
7/1/2019,18,12106,1350,5349,799,123,0,19727
7/1/2019,19,12117,1458,5425,676,39,0,19715
7/1/2019,20,12124,1165,4941,610,7,0,18847
7/1/2019,21,12117,1127,4775,551,0,0,18570
7/1/2019,22,12111,643,4523,343,0,0,17620
7/1/2019,23,12117,292,4471,345,1,0,17226
7/1/2019,24,12121,357,3808,423,4,0,16713
7/2/2019,1,12055,406,3033,266,10,1,15771
7/2/2019,2,11855,503,3234,111,16,2,15721
7/2/2019,3,11905,599,3490,104,24,7,16129
7/2/2019,4,11951,693,3742,99,35,12,16532
7/2/2019,5,11997,790,3999,95,44,18,16943
7/2/2019,6,12045,884,4252,88,56,23,17348
7/2/2019,7,12092,984,4502,83,66,28,17755
7/2/2019,8,12118,1228,4436,40,106,43,17971
7/2/2019,9,12120,1290,4564,17,222,74,18287
7/2/2019,10,12122,1442,4842,70,299,89,18864
7/2/2019,11,12118,1594,4824,144,337,103,19120
7/2/2019,12,12107,1730,4848,153,309,109,19256
7/2/2019,13,12102,1878,4875,157,280,114,19406
7/2/2019,14,12096,2065,4859,172,258,126,19576
7/2/2019,15,12090,2564,4856,213,244,147,20114
7/2/2019,16,12084,2503,4872,203,208,139,20009
7/2/2019,17,12085,2395,4755,191,187,133,19746
7/2/2019,18,12084,2287,4639,179,168,128,19485
7/2/2019,19,12082,2173,4525,171,147,122,19220
7/2/2019,20,12083,2066,4406,158,127,116,18956
7/2/2019,21,12081,1951,4293,145,106,110,18686
7/2/2019,22,12082,1845,4175,135,86,104,18427
7/2/2019,23,12082,1734,4061,128,66,98,18169
7/2/2019,24,12082,1625,3948,116,45,93,17909
7/3/2019,1,12084,1519,3814,111,26,86,17640
7/3/2019,2,12119,1468,3835,156,19,83,17680
7/3/2019,3,12118,1357,3714,148,20,80,17437
7/3/2019,4,12123,1259,3819,127,22,80,17430
7/3/2019,5,12129,1165,3926,107,26,79,17432
7/3/2019,6,12135,1072,4028,89,29,78,17431
7/3/2019,7,12133,1046,4249,62,63,99,17652
7/3/2019,8,12132,1219,4224,28,154,116,17873
7/3/2019,9,12124,1247,4630,27,263,94,18385
7/3/2019,10,12136,1666,4752,32,263,85,18934
7/3/2019,11,12125,2490,4613,53,384,145,19810
7/3/2019,12,12139,2596,4604,50,378,158,19925
7/3/2019,13,11975,3054,4785,169,353,187,20523
7/3/2019,14,12074,3114,4816,181,388,186,20759
7/3/2019,15,12071,3371,4751,208,338,178,20917
7/3/2019,16,12070,3454,5056,254,303,141,21278
7/3/2019,17,12079,3531,5168,266,229,139,21412
7/3/2019,18,12084,3421,5276,201,127,139,21248
7/3/2019,19,12095,3451,5162,141,40,139,21028
7/3/2019,20,12108,3476,5079,143,9,135,20950
7/3/2019,21,12097,3194,5114,181,0,126,20712
7/3/2019,22,12097,3154,4800,197,0,132,20380
7/3/2019,23,12106,1941,4459,214,0,125,18845
7/3/2019,24,12102,835,4066,179,0,112,17294
7/4/2019,1,12108,487,3672,190,0,92,16549
7/4/2019,2,12107,334,3545,213,0,70,16269
7/4/2019,3,12103,253,3362,203,0,72,15993
7/4/2019,4,12090,254,3151,284,0,70,15849
7/4/2019,5,12086,342,3234,336,2,74,16074
7/4/2019,6,12089,654,3751,228,8,121,16851
7/4/2019,7,12091,1228,3980,203,48,134,17684
7/4/2019,8,12086,1867,4228,62,55,170,18468
7/4/2019,9,12087,2221,4414,52,81,163,19018
7/4/2019,10,12088,2374,4499,152,283,166,19562
7/4/2019,11,12089,2474,4720,156,364,169,19972
7/4/2019,12,12098,3133,4736,122,397,176,20662
7/4/2019,13,12106,3446,4793,155,381,173,21054
7/4/2019,14,12105,3553,4867,195,391,172,21283
7/4/2019,15,12100,3782,4961,148,385,129,21505
7/4/2019,16,12086,3790,5058,122,316,107,21479
7/4/2019,17,12075,3987,5219,181,225,126,21813
7/4/2019,18,12080,3913,5252,197,123,112,21677
7/4/2019,19,12078,3850,5206,176,39,104,21453
7/4/2019,20,12082,3920,5192,226,8,105,21533
7/4/2019,21,12080,3440,5194,361,0,138,21213
7/4/2019,22,12076,3478,4899,457,0,181,21091
7/4/2019,23,12076,2385,4333,475,0,95,19364
7/4/2019,24,12077,1252,3866,405,0,109,17709
7/5/2019,1,12093,586,3488,414,0,91,16672
7/5/2019,2,12079,449,3313,319,0,84,16244
7/5/2019,3,12083,472,3300,359,0,80,16294
7/5/2019,4,12080,548,3326,394,0,81,16429
7/5/2019,5,12074,820,3304,272,2,80,16552
7/5/2019,6,12063,1136,3889,306,5,83,17482
7/5/2019,7,12040,1613,4299,363,40,88,18443
7/5/2019,8,12029,2437,4579,298,149,105,19597
7/5/2019,9,12046,3150,4770,222,226,181,20595
7/5/2019,10,12059,3872,4716,248,292,166,21353
7/5/2019,11,12051,3896,4836,279,332,166,21560
7/5/2019,12,12060,4016,4728,362,375,182,21723
7/5/2019,13,12063,3903,4727,422,374,112,21601
7/5/2019,14,12067,3914,4819,444,381,111,21736
7/5/2019,15,12068,4154,4870,517,376,128,22113
7/5/2019,16,12054,4207,5195,528,317,116,22417
7/5/2019,17,12034,4398,5267,770,225,117,22811
7/5/2019,18,12032,4241,5326,554,123,111,22387
7/5/2019,19,12019,4163,5143,412,33,104,21874
7/5/2019,20,12001,4014,4934,334,5,127,21415
7/5/2019,21,11977,3886,4674,307,0,148,20992
7/5/2019,22,11976,3689,4587,418,0,144,20814
7/5/2019,23,11994,2710,4420,590,0,82,19796
7/5/2019,24,12014,1547,4106,580,0,58,18305
7/6/2019,1,12024,569,4099,559,0,68,17319
7/6/2019,2,12025,371,3865,461,0,13,16735
7/6/2019,3,12031,170,3710,355,0,0,16266
7/6/2019,4,12027,214,3709,276,0,0,16226
7/6/2019,5,12041,195,3442,296,2,0,15976
7/6/2019,6,12054,428,3374,202,6,0,16064
7/6/2019,7,12056,985,3755,145,25,0,16966
7/6/2019,8,12058,1615,4112,202,86,0,18073
7/6/2019,9,12057,2562,4297,184,126,1,19227
7/6/2019,10,12050,3306,4349,173,179,17,20074
7/6/2019,11,12048,3288,4280,171,210,65,20062
7/6/2019,12,12044,3405,4400,336,191,132,20508
7/6/2019,13,12027,3471,4358,365,235,155,20611
7/6/2019,14,12030,3225,4458,466,317,140,20636
7/6/2019,15,12003,2952,4561,680,254,130,20580
7/6/2019,16,12009,2563,4691,829,293,118,20503
7/6/2019,17,12030,2816,4956,925,157,155,21039
7/6/2019,18,12029,2829,4979,947,108,146,21038
7/6/2019,19,12040,2401,5033,1048,33,103,20658
7/6/2019,20,12054,1914,4799,1304,8,67,20146
7/6/2019,21,12053,1537,4596,1262,0,56,19504
7/6/2019,22,12056,792,4540,1345,0,10,18743
7/6/2019,23,12055,221,4027,1526,0,0,17829
7/6/2019,24,12038,109,3355,965,0,0,16467
7/7/2019,1,12053,106,3375,578,0,0,16112
7/7/2019,2,12064,108,3226,459,0,0,15857
7/7/2019,3,12043,107,3042,336,0,0,15528
7/7/2019,4,12024,107,3045,208,0,0,15384
7/7/2019,5,11743,106,3188,457,2,0,15496
7/7/2019,6,11716,107,3096,596,7,0,15522
7/7/2019,7,11712,110,3306,433,49,0,15610
7/7/2019,8,11786,142,3745,684,159,0,16516
7/7/2019,9,12020,265,3900,759,270,0,17214
7/7/2019,10,12024,610,4042,700,356,12,17744
7/7/2019,11,12021,889,4182,549,381,9,18031
7/7/2019,12,12022,1067,4414,515,386,1,18405
7/7/2019,13,12015,1035,4435,646,405,0,18536
7/7/2019,14,12011,1103,4222,702,425,0,18463
7/7/2019,15,11997,1156,4391,668,411,0,18623
7/7/2019,16,11959,1274,4527,793,360,1,18914
7/7/2019,17,11908,1307,5109,1022,257,0,19603
7/7/2019,18,11910,1376,5155,940,137,0,19518
7/7/2019,19,11926,1531,5013,807,38,0,19315
7/7/2019,20,11943,1281,4600,737,7,0,18568
7/7/2019,21,11971,952,4321,720,0,0,17964
7/7/2019,22,11984,683,4082,560,0,0,17309
7/7/2019,23,11992,197,3715,620,0,0,16524
7/7/2019,24,12005,113,3451,325,0,0,15894
7/8/2019,1,12026,111,3410,248,0,8,15803
7/8/2019,2,11837,111,3095,219,0,11,15273
7/8/2019,3,11506,111,3073,230,0,11,14931
7/8/2019,4,11500,110,3063,222,1,11,14907
7/8/2019,5,11502,114,3257,288,2,12,15175
7/8/2019,6,11602,145,3664,382,15,20,15828
7/8/2019,7,11849,296,4137,435,62,26,16805
7/8/2019,8,11977,520,4232,208,163,26,17126
7/8/2019,9,11984,834,4118,124,263,27,17350
7/8/2019,10,11995,1257,4088,131,316,27,17814
7/8/2019,11,11987,1354,4219,188,397,28,18173
7/8/2019,12,11961,1445,4227,244,412,27,18316
7/8/2019,13,11984,1794,4135,251,419,28,18611
7/8/2019,14,12019,1969,4112,306,408,27,18841
7/8/2019,15,12024,2029,4154,318,382,27,18934
7/8/2019,16,12020,2289,4305,358,327,28,19327
7/8/2019,17,12019,2340,4545,378,233,27,19542
7/8/2019,18,12015,2408,4761,268,121,29,19602
7/8/2019,19,12016,2356,4625,228,45,31,19301
7/8/2019,20,12008,2356,4735,253,9,28,19389
7/8/2019,21,11998,2159,4602,316,0,28,19103
7/8/2019,22,11995,1504,4195,238,0,27,17959
7/8/2019,23,11992,475,3944,199,0,27,16637
7/8/2019,24,11990,190,3618,138,0,24,15960
7/9/2019,1,11654,190,3431,113,0,15,15403
7/9/2019,2,11441,192,3499,100,0,13,15245
7/9/2019,3,11430,202,3314,111,0,13,15070
7/9/2019,4,11444,279,3348,99,0,14,15184
7/9/2019,5,11445,572,3065,98,1,24,15205
7/9/2019,6,11455,924,3292,101,16,31,15819
7/9/2019,7,11782,1053,3802,97,60,43,16837
7/9/2019,8,12021,1107,3939,74,157,78,17376
7/9/2019,9,12017,1316,3909,14,239,85,17580
7/9/2019,10,12016,1651,4026,41,351,84,18169
7/9/2019,11,12019,1923,3858,45,359,86,18290
7/9/2019,12,12022,2247,3910,78,417,85,18759
7/9/2019,13,12014,2499,3768,86,391,84,18842
7/9/2019,14,11998,2654,3971,174,416,84,19297
7/9/2019,15,12003,2758,4377,219,390,85,19832
7/9/2019,16,11992,3019,4727,198,332,86,20354
7/9/2019,17,11988,3598,4862,142,233,131,20954
7/9/2019,18,11983,3616,4881,97,127,141,20845
7/9/2019,19,11983,3304,4954,75,47,109,20472
7/9/2019,20,11985,3092,4992,67,11,85,20232
7/9/2019,21,11998,2846,4858,133,0,83,19918
7/9/2019,22,11994,2133,4403,175,0,83,18788
7/9/2019,23,11993,906,3870,193,0,33,16995
7/9/2019,24,12001,434,3455,237,0,15,16142
7/10/2019,1,11921,383,3157,191,0,12,15664
7/10/2019,2,11790,281,3152,161,0,13,15397
7/10/2019,3,11615,201,2992,172,0,14,14994
7/10/2019,4,11491,278,3135,226,0,12,15142
7/10/2019,5,11492,500,3201,209,2,19,15423
7/10/2019,6,11510,838,3393,163,15,25,15944
7/10/2019,7,11804,1319,3981,147,62,27,17340
7/10/2019,8,12024,1581,3884,131,132,27,17779
7/10/2019,9,12020,2075,3992,136,235,26,18484
7/10/2019,10,12003,2217,3882,126,322,27,18577
7/10/2019,11,12006,2484,4064,283,382,27,19246
7/10/2019,12,11860,2563,4101,490,403,30,19447
7/10/2019,13,11824,2721,4400,706,386,44,20081
7/10/2019,14,11770,3074,4558,837,365,94,20698
7/10/2019,15,11877,3101,4730,800,347,113,20968
7/10/2019,16,11913,3486,4831,696,295,112,21333
7/10/2019,17,11918,3858,4928,631,219,97,21651
7/10/2019,18,11916,3809,4730,568,116,95,21234
7/10/2019,19,11915,3662,4678,581,34,96,20966
7/10/2019,20,11908,3082,4823,898,6,101,20818
7/10/2019,21,11891,3116,4604,1176,1,93,20881
7/10/2019,22,11892,2601,4135,1370,0,37,20035
7/10/2019,23,11904,1515,3487,1503,0,17,18426
7/10/2019,24,11939,489,3414,1264,0,13,17119
7/11/2019,1,11933,208,3335,1467,0,13,16956
7/11/2019,2,11924,210,3186,1446,0,13,16779
7/11/2019,3,11922,217,3091,995,0,14,16239
7/11/2019,4,11923,294,3129,905,0,15,16266
7/11/2019,5,11918,554,3202,899,0,16,16589
7/11/2019,6,11903,948,3320,597,3,20,16791
7/11/2019,7,11905,1423,3783,685,15,25,17836
7/11/2019,8,11888,1852,4128,784,59,26,18737
7/11/2019,9,11863,2192,4397,855,88,27,19422
7/11/2019,10,11858,2682,4392,850,131,35,19948
7/11/2019,11,11883,3170,4342,1075,195,38,20703
7/11/2019,12,11901,2724,4478,1603,242,40,20988
7/11/2019,13,11897,3067,4561,1696,255,80,21556
7/11/2019,14,11889,2864,4630,1474,252,100,21209
7/11/2019,15,11873,2603,4448,1571,214,104,20813
7/11/2019,16,11887,2964,4872,1432,135,107,21397
7/11/2019,17,11882,3112,4956,1123,86,108,21267
7/11/2019,18,11905,2822,4847,1193,58,102,20927
7/11/2019,19,11924,2446,4488,1368,34,84,20344
7/11/2019,20,11933,2027,4138,1396,8,85,19587
7/11/2019,21,11942,1817,4560,1070,0,84,19473
7/11/2019,22,11952,1500,3969,848,0,84,18353
7/11/2019,23,11680,521,3464,698,0,74,16437
7/11/2019,24,11092,223,3287,618,0,71,15291
7/12/2019,1,11106,204,3135,492,0,71,15008
7/12/2019,2,11049,207,3172,763,0,78,15269
7/12/2019,3,10846,216,3040,697,0,24,14823
7/12/2019,4,10855,290,3152,569,0,14,14880
7/12/2019,5,10864,514,3421,395,3,15,15212
7/12/2019,6,11047,810,3469,258,5,24,15613
7/12/2019,7,11089,1156,3847,168,28,27,16315
7/12/2019,8,11077,1409,4276,201,76,27,17066
7/12/2019,9,11077,1628,4193,301,139,28,17366
7/12/2019,10,11030,2042,4530,383,131,27,18143
7/12/2019,11,11021,2203,4197,539,139,26,18125
7/12/2019,12,11052,2451,4182,411,165,41,18302
7/12/2019,13,11082,2584,4023,366,161,76,18292
7/12/2019,14,11096,2578,3858,268,181,84,18065
7/12/2019,15,11102,2563,3882,178,196,83,18004
7/12/2019,16,11108,2294,4356,311,179,83,18331
7/12/2019,17,11114,2212,4713,364,142,85,18630
7/12/2019,18,11122,2414,4756,372,89,90,18843
7/12/2019,19,11122,2628,4838,370,34,134,19126
7/12/2019,20,11121,2286,4773,291,7,171,18649
7/12/2019,21,11099,2359,4518,334,0,177,18487
7/12/2019,22,11091,1544,4338,367,0,105,17445
7/12/2019,23,11121,401,4089,455,0,27,16093
7/12/2019,24,11154,203,3285,505,0,1,15148
7/13/2019,1,11161,204,2915,529,0,0,14809
7/13/2019,2,11171,205,2763,640,0,0,14779
7/13/2019,3,11163,206,2788,743,0,0,14900
7/13/2019,4,11083,212,2800,797,0,0,14892
7/13/2019,5,10858,295,2804,917,1,0,14875
7/13/2019,6,10810,581,2807,891,6,0,15095
7/13/2019,7,10793,975,3376,438,36,0,15618
7/13/2019,8,10787,1350,3505,833,118,0,16593
7/13/2019,9,11025,1366,3447,1160,199,0,17197
7/13/2019,10,11084,1496,3577,1242,249,0,17648
7/13/2019,11,11063,1523,3756,1574,281,0,18197
7/13/2019,12,11058,1427,3879,1893,277,0,18534
7/13/2019,13,11058,1362,4048,2072,288,1,18829
7/13/2019,14,11066,1301,4132,2220,242,0,18961
7/13/2019,15,11077,1416,4136,2252,234,0,19115
7/13/2019,16,11090,1601,4017,2132,187,0,19027
7/13/2019,17,11092,1687,4526,2055,98,0,19458
7/13/2019,18,11092,1784,4863,1881,83,1,19704
7/13/2019,19,11094,2396,4802,1574,29,0,19895
7/13/2019,20,11102,2259,4793,1200,8,0,19362
7/13/2019,21,11176,2343,4234,1276,0,0,19029
7/13/2019,22,11199,1573,3804,1504,0,0,18080
7/13/2019,23,11196,637,3484,1777,0,0,17094
7/13/2019,24,11183,409,3045,1386,0,0,16023
7/14/2019,1,11212,287,2735,1203,0,0,15437
7/14/2019,2,10813,201,2891,1202,0,0,15107
7/14/2019,3,10407,201,2758,554,0,0,13920
7/14/2019,4,10458,208,2892,657,0,0,14215
7/14/2019,5,10505,303,3433,476,1,0,14718
7/14/2019,6,10499,528,3269,400,5,0,14701
7/14/2019,7,10497,992,3525,268,43,0,15325
7/14/2019,8,10674,1506,3514,138,133,0,15965
7/14/2019,9,10796,1819,3429,97,167,0,16308
7/14/2019,10,10803,1955,3435,147,297,0,16637
7/14/2019,11,10815,1973,3431,152,332,0,16703
7/14/2019,12,10817,1941,3772,233,352,0,17115
7/14/2019,13,10814,2100,3885,358,348,0,17505
7/14/2019,14,10836,2158,4059,400,329,0,17782
7/14/2019,15,10879,2180,4177,447,333,0,18016
7/14/2019,16,10885,2445,4561,412,293,0,18596
7/14/2019,17,10888,3160,4750,416,213,0,19427
7/14/2019,18,10878,3492,5083,337,115,0,19905
7/14/2019,19,10871,3605,4838,314,34,0,19662
7/14/2019,20,10867,3333,4780,307,6,0,19293
7/14/2019,21,10969,2882,4614,333,0,0,18798
7/14/2019,22,11065,2450,4085,365,0,0,17965
7/14/2019,23,11054,1430,3806,436,0,0,16726
7/14/2019,24,11074,578,3564,353,0,0,15569
7/15/2019,1,11119,457,3318,253,0,0,15147
7/15/2019,2,11134,346,2940,216,0,4,14640
7/15/2019,3,11152,286,2779,184,0,13,14414
7/15/2019,4,11153,367,2935,140,0,14,14609
7/15/2019,5,11160,652,2941,135,1,15,14904
7/15/2019,6,11159,1136,2830,161,7,24,15317
7/15/2019,7,11166,1842,3513,276,45,26,16868
7/15/2019,8,11153,2221,3623,202,125,29,17353
7/15/2019,9,11135,2493,3881,226,217,29,17981
7/15/2019,10,11120,2778,3633,272,289,27,18119
7/15/2019,11,11117,2872,3792,373,322,28,18504
7/15/2019,12,11114,3068,3979,409,319,43,18932
7/15/2019,13,11136,3227,4230,532,322,74,19521
7/15/2019,14,11168,3328,4181,646,285,83,19691
7/15/2019,15,11180,3364,4519,780,269,83,20195
7/15/2019,16,11182,3758,4715,738,217,105,20715
7/15/2019,17,11204,4356,4671,726,161,99,21217
7/15/2019,18,11209,4108,4526,757,88,114,20802
7/15/2019,19,11169,3853,4516,799,26,132,20495
7/15/2019,20,11168,3916,4524,814,5,135,20562
7/15/2019,21,11159,3819,4197,1012,0,140,20327
7/15/2019,22,11147,2900,3644,1272,0,139,19102
7/15/2019,23,11149,1890,3359,1408,0,118,17924
7/15/2019,24,11134,1099,3005,1567,0,92,16897
7/16/2019,1,11099,806,2710,1808,0,24,16447
7/16/2019,2,11092,714,2650,1544,0,10,16010
7/16/2019,3,11109,718,2680,1574,0,0,16081
7/16/2019,4,11178,820,2638,1481,0,0,16117
7/16/2019,5,11216,1160,2604,1156,1,1,16138
7/16/2019,6,11215,1633,2564,1268,4,1,16685
7/16/2019,7,11224,2281,3202,617,30,0,17354
7/16/2019,8,11222,2553,3559,969,113,0,18416
7/16/2019,9,11221,2894,3597,1258,209,19,19198
7/16/2019,10,11214,3144,3746,1465,247,27,19843
7/16/2019,11,11212,3457,4100,1448,250,27,20494
7/16/2019,12,11197,3837,4104,1589,277,53,21057
7/16/2019,13,11175,3459,4048,2110,248,89,21129
7/16/2019,14,11156,3508,3992,1907,278,94,20935
7/16/2019,15,11156,3885,4413,1497,218,118,21287
7/16/2019,16,11163,4301,4608,1315,175,168,21730
7/16/2019,17,11164,4021,4950,1337,123,155,21750
7/16/2019,18,11169,3826,5106,1254,76,133,21564
7/16/2019,19,11177,3849,5107,1169,28,137,21467
7/16/2019,20,11184,3750,4941,1198,6,106,21185
7/16/2019,21,11194,4442,4397,1154,0,158,21345
7/16/2019,22,11202,4030,3847,1084,0,159,20322
7/16/2019,23,11206,2700,3822,1082,0,84,18894
7/16/2019,24,11199,1763,3328,1157,0,29,17476
7/17/2019,1,11194,1516,3132,1015,0,13,16870
7/17/2019,2,11200,1518,2831,890,0,13,16452
7/17/2019,3,11212,1523,2671,860,0,13,16279
7/17/2019,4,11201,1614,2635,695,0,14,16159
7/17/2019,5,11189,1853,2807,684,1,14,16548
7/17/2019,6,11201,2130,3300,511,3,21,17166
7/17/2019,7,11209,2795,3678,389,15,27,18113
7/17/2019,8,11214,3348,3737,305,23,27,18654
7/17/2019,9,11210,3748,3672,182,57,27,18896
7/17/2019,10,11210,4007,3726,149,145,43,19280
7/17/2019,11,11201,4105,3983,148,175,71,19683
7/17/2019,12,11200,4181,4104,190,216,78,19969
7/17/2019,13,11070,4521,4173,250,217,89,20320
7/17/2019,14,11068,4690,4098,343,269,88,20556
7/17/2019,15,11199,4144,4325,449,252,92,20461
7/17/2019,16,11206,3857,4772,680,256,130,20901
7/17/2019,17,11209,3954,4817,810,171,149,21110
7/17/2019,18,11214,3871,4915,788,107,148,21043
7/17/2019,19,11216,3954,4883,751,32,149,20985
7/17/2019,20,11217,4035,4943,513,6,154,20868
7/17/2019,21,11218,4259,4607,514,0,153,20751
7/17/2019,22,11214,3872,3908,513,0,85,19592
7/17/2019,23,11223,2881,3685,464,0,35,18288
7/17/2019,24,11222,1834,3623,494,0,12,17185
7/18/2019,1,11224,1542,2919,511,0,11,16207
7/18/2019,2,11226,1521,2859,519,0,10,16135
7/18/2019,3,11218,1515,2948,487,0,11,16179
7/18/2019,4,11190,1610,2637,374,0,16,15827
7/18/2019,5,11181,1862,2670,182,1,20,15916
7/18/2019,6,11191,2152,2810,466,6,20,16645
7/18/2019,7,11200,2499,3414,219,28,27,17387
7/18/2019,8,11198,2735,3847,120,70,27,17997
7/18/2019,9,11201,2823,4237,184,173,27,18645
7/18/2019,10,11208,3064,4196,249,217,27,18961
7/18/2019,11,11215,3314,4363,249,286,46,19473
7/18/2019,12,11210,3507,4491,319,321,75,19923
7/18/2019,13,11204,3737,4448,423,310,125,20247
7/18/2019,14,11205,3877,4527,586,309,146,20650
7/18/2019,15,11206,3863,4698,812,304,109,20992
7/18/2019,16,11205,3849,4739,1346,274,101,21514
7/18/2019,17,11196,3766,4815,1254,194,100,21325
7/18/2019,18,11170,3993,4789,1187,102,56,21297
7/18/2019,19,11135,3850,4821,1241,24,40,21111
7/18/2019,20,11123,3500,4982,1218,4,41,20868
7/18/2019,21,11120,3479,4941,1218,0,30,20788
7/18/2019,22,11139,3288,4225,1398,0,30,20080
7/18/2019,23,11152,2500,3732,1513,0,23,18920
7/18/2019,24,11164,1681,3045,2005,0,18,17913
7/19/2019,1,11165,1510,2803,2138,0,10,17626
7/19/2019,2,11165,1501,2528,1698,0,10,16902
7/19/2019,3,11173,1516,2534,1968,0,10,17201
7/19/2019,4,11168,1678,2597,1961,0,11,17415
7/19/2019,5,11155,2073,2673,1603,2,14,17520
7/19/2019,6,11146,2616,2817,1417,4,19,18019
7/19/2019,7,11136,3027,3469,1304,40,27,19003
7/19/2019,8,11133,3128,4083,1450,123,30,19947
7/19/2019,9,11142,3334,4350,1444,168,30,20468
7/19/2019,10,11143,4124,4357,1220,237,60,21141
7/19/2019,11,11141,4237,4573,1326,290,94,21661
7/19/2019,12,11135,4181,4628,1340,295,126,21705
7/19/2019,13,11143,3990,4599,1379,226,150,21487
7/19/2019,14,10659,3840,4784,1604,155,169,21211
7/19/2019,15,10378,3616,4617,2134,131,167,21043
7/19/2019,16,10383,3798,4894,1940,151,159,21325
7/19/2019,17,10384,4106,5069,1790,112,165,21626
7/19/2019,18,10388,4155,4984,1518,62,163,21270
7/19/2019,19,10395,4393,4980,1210,22,157,21157
7/19/2019,20,10392,4601,4805,1018,4,106,20926
7/19/2019,21,10398,4643,4882,1009,0,94,21026
7/19/2019,22,10399,4440,4311,948,0,83,20181
7/19/2019,23,10391,3828,3879,761,0,30,18889
7/19/2019,24,10385,2675,3672,883,0,2,17617
7/20/2019,1,10395,2519,3522,838,0,0,17274
7/20/2019,2,10399,2218,3232,1251,0,0,17100
7/20/2019,3,10406,2051,2998,1608,0,0,17063
7/20/2019,4,10399,2052,2897,1224,0,0,16572
7/20/2019,5,10404,2145,2913,1435,1,0,16898
7/20/2019,6,10391,2307,2930,870,3,0,16501
7/20/2019,7,10393,2524,3441,929,22,0,17309
7/20/2019,8,10394,2677,3679,1118,68,0,17936
7/20/2019,9,10393,3378,4129,1207,175,0,19282
7/20/2019,10,10417,4057,4055,1156,224,1,19910
7/20/2019,11,10389,4167,4114,1288,327,25,20310
7/20/2019,12,10366,4533,4287,1364,359,54,20963
7/20/2019,13,10360,4458,4264,1379,356,74,20891
7/20/2019,14,10359,4740,4521,1353,349,76,21398
7/20/2019,15,10363,4777,4552,1269,336,74,21371
7/20/2019,16,10364,4597,4637,1382,269,75,21324
7/20/2019,17,10374,4450,4744,1138,175,76,20957
7/20/2019,18,10375,4836,4877,1038,86,75,21287
7/20/2019,19,10375,3697,4576,1282,24,74,20028
7/20/2019,20,10373,4044,4564,1164,2,58,20205
7/20/2019,21,10380,4304,4473,1047,0,84,20288
7/20/2019,22,10378,3372,4300,861,0,94,19005
7/20/2019,23,10384,2564,3426,1329,0,89,17792
7/20/2019,24,10371,1631,3616,1463,0,22,17103
7/21/2019,1,10369,1416,3548,1514,0,0,16847
7/21/2019,2,10377,1149,3523,1395,0,0,16444
7/21/2019,3,10374,1211,3438,1217,0,0,16240
7/21/2019,4,10380,1421,3237,1001,0,0,16039
7/21/2019,5,10375,1655,3324,713,1,0,16068
7/21/2019,6,10361,1886,3119,698,4,0,16068
7/21/2019,7,10361,2027,3610,534,38,0,16570
7/21/2019,8,10357,2100,3725,476,116,0,16774
7/21/2019,9,10359,2218,3631,347,207,0,16762
7/21/2019,10,10354,2358,3700,347,255,0,17014
7/21/2019,11,10356,2718,3762,437,303,0,17576
7/21/2019,12,10348,2941,3947,431,303,0,17970
7/21/2019,13,10352,3730,4022,413,339,0,18856
7/21/2019,14,10356,3839,4030,564,315,2,19106
7/21/2019,15,10329,3424,4116,652,323,1,18845
7/21/2019,16,10365,3615,4239,699,301,8,19227
7/21/2019,17,10369,4511,4292,729,217,12,20130
7/21/2019,18,10371,4516,4158,862,115,8,20030
7/21/2019,19,10516,4334,4177,742,36,0,19805
7/21/2019,20,10585,3836,4157,428,4,0,19010
7/21/2019,21,10689,3591,4127,332,0,0,18739
7/21/2019,22,10648,3254,3743,423,0,0,18068
7/21/2019,23,10355,2365,3700,489,0,0,16909
7/21/2019,24,10351,1650,3562,455,0,3,16021
7/22/2019,1,10344,1165,3652,483,0,11,15655
7/22/2019,2,10328,641,3506,486,0,13,14974
7/22/2019,3,10324,628,3604,447,0,15,15018
7/22/2019,4,10335,644,3524,372,0,15,14890
7/22/2019,5,10344,803,3669,331,1,15,15163
7/22/2019,6,10351,1147,3531,354,5,18,15406
7/22/2019,7,10353,1670,3615,380,19,27,16064
7/22/2019,8,10356,2123,3596,289,69,31,16464
7/22/2019,9,10355,2304,3820,380,110,45,17014
7/22/2019,10,10356,2667,3886,344,152,50,17455
7/22/2019,11,10355,2902,4011,281,224,40,17813
7/22/2019,12,10347,3365,4032,344,256,30,18374
7/22/2019,13,10340,3569,3969,617,256,43,18794
7/22/2019,14,10332,3462,3953,794,247,27,18815
7/22/2019,15,10324,3199,3988,1208,237,27,18983
7/22/2019,16,10312,2694,3970,1186,182,28,18372
7/22/2019,17,10316,2655,4178,1150,111,27,18437
7/22/2019,18,10507,2204,4266,1367,53,27,18424
7/22/2019,19,10515,1827,4292,1811,28,27,18500
7/22/2019,20,10679,1668,4460,1735,5,27,18574
7/22/2019,21,10759,1805,4172,1602,0,27,18365
7/22/2019,22,10768,791,3805,1582,0,27,16973
7/22/2019,23,10959,258,3352,1355,0,17,15941
7/22/2019,24,10988,216,2832,1169,0,14,15219
7/23/2019,1,10986,217,2664,994,0,14,14875
7/23/2019,2,10985,222,2755,944,0,14,14920
7/23/2019,3,10985,236,2801,946,0,14,14982
7/23/2019,4,11005,355,2855,812,0,14,15041
7/23/2019,5,11019,547,2761,418,0,16,14761
7/23/2019,6,11020,957,2857,238,5,26,15103
7/23/2019,7,11022,1361,3504,322,42,27,16278
7/23/2019,8,11016,1715,3650,311,126,27,16845
7/23/2019,9,11022,1707,3610,385,199,27,16950
7/23/2019,10,11017,1726,3559,377,270,27,16976
7/23/2019,11,11049,2134,3638,442,290,27,17580
7/23/2019,12,11126,2141,3714,549,293,27,17850
7/23/2019,13,11125,2091,3775,602,271,27,17891
7/23/2019,14,11126,2079,3808,579,286,27,17905
7/23/2019,15,11128,2061,3975,535,302,27,18028
7/23/2019,16,11127,2215,4243,505,234,27,18351
7/23/2019,17,10285,3041,4859,422,147,28,18782
7/23/2019,18,10476,3172,4671,638,82,27,19066
7/23/2019,19,11147,2265,4185,737,24,27,18385
7/23/2019,20,11159,1910,4245,385,5,27,17731
7/23/2019,21,11163,1880,4224,298,0,27,17592
7/23/2019,22,11193,1009,3865,352,0,27,16446
7/23/2019,23,11196,636,3298,454,0,17,15601
7/23/2019,24,11196,440,3105,474,0,14,15229
7/24/2019,1,11199,407,2984,413,0,15,15018
7/24/2019,2,11201,411,2846,321,0,13,14792
7/24/2019,3,11014,415,2815,208,0,14,14466
7/24/2019,4,10815,483,2805,373,0,15,14491
7/24/2019,5,10735,742,3017,492,1,15,15002
7/24/2019,6,11146,1039,2940,323,9,21,15478
7/24/2019,7,11218,1347,3204,307,43,26,16145
7/24/2019,8,11209,1592,3412,206,131,32,16582
7/24/2019,9,11195,1745,3355,74,210,35,16614
7/24/2019,10,11185,1844,3722,61,267,40,17119
7/24/2019,11,11184,2186,3528,61,268,44,17271
7/24/2019,12,11053,2287,3746,138,272,44,17540
7/24/2019,13,11017,2554,3685,227,287,27,17797
7/24/2019,14,11011,2613,3707,191,308,27,17857
7/24/2019,15,11062,2548,3843,182,237,33,17905
7/24/2019,16,11167,2515,4202,497,229,45,18655
7/24/2019,17,11180,2583,4552,481,179,49,19024
7/24/2019,18,11189,2697,4812,456,106,42,19302
7/24/2019,19,11195,2671,4620,389,36,38,18949
7/24/2019,20,11196,2507,4445,265,5,29,18447
7/24/2019,21,11200,2518,4217,130,0,27,18092
7/24/2019,22,11180,2042,4034,115,0,27,17398
7/24/2019,23,11207,1022,3571,195,0,24,16019
7/24/2019,24,11208,483,3241,182,0,14,15128
7/25/2019,1,11207,408,3180,221,0,12,15028
7/25/2019,2,11210,412,2887,215,0,12,14736
7/25/2019,3,11157,420,2708,230,0,13,14528
7/25/2019,4,10970,494,2735,263,0,12,14474
7/25/2019,5,10970,741,2949,207,1,16,14884
7/25/2019,6,11172,1012,2967,235,8,21,15415
7/25/2019,7,11213,1341,3267,106,29,26,15982
7/25/2019,8,11193,1672,3583,69,78,27,16622
7/25/2019,9,11183,1946,3682,32,215,27,17085
7/25/2019,10,11180,2074,3733,94,304,27,17412
7/25/2019,11,11180,2331,3826,177,360,27,17901
7/25/2019,12,11200,2544,4084,254,363,27,18472
7/25/2019,13,11192,2834,4109,345,335,27,18842
7/25/2019,14,11196,2935,4149,460,326,27,19093
7/25/2019,15,11207,3129,4258,596,277,27,19494
7/25/2019,16,11212,3708,4576,557,188,27,20268
7/25/2019,17,11219,3697,4715,572,149,27,20379
7/25/2019,18,11221,3606,4702,557,95,27,20208
7/25/2019,19,11216,3653,4534,497,37,29,19966
7/25/2019,20,11210,3851,4412,454,7,30,19964
7/25/2019,21,11200,3808,4472,544,1,27,20052
7/25/2019,22,11188,3346,3991,593,1,27,19146
7/25/2019,23,11176,2360,3283,750,1,23,17593
7/25/2019,24,11166,1259,3029,878,1,14,16347
7/26/2019,1,11173,823,2703,719,1,13,15432
7/26/2019,2,11175,791,2526,751,1,13,15257
7/26/2019,3,11194,804,2731,723,1,13,15466
7/26/2019,4,11207,887,2879,532,1,12,15518
7/26/2019,5,11212,1103,2575,330,2,17,15239
7/26/2019,6,11205,1475,2756,142,6,29,15613
7/26/2019,7,11191,1798,3151,119,33,36,16328
7/26/2019,8,11173,2266,3385,82,67,27,17000
7/26/2019,9,11172,2566,3678,155,231,28,17830
7/26/2019,10,11154,3119,3877,211,312,26,18699
7/26/2019,11,11131,3677,3870,298,358,26,19360
7/26/2019,12,11141,3909,4012,419,363,26,19870
7/26/2019,13,11131,4228,4213,483,356,27,20438
7/26/2019,14,11136,4159,4287,548,341,26,20497
7/26/2019,15,11153,4122,4396,572,322,27,20592
7/26/2019,16,11164,3827,4565,574,275,43,20448
7/26/2019,17,11166,3822,4888,544,200,78,20698
7/26/2019,18,11153,3826,4902,512,110,95,20598
7/26/2019,19,11136,3763,4871,584,33,93,20480
7/26/2019,20,11112,3502,4759,676,6,78,20133
7/26/2019,21,11085,3222,4638,787,1,76,19809
7/26/2019,22,11103,2738,3955,931,1,78,18806
7/26/2019,23,11117,1914,3537,1007,1,29,17605
7/26/2019,24,11128,747,3380,1108,1,10,16374
7/27/2019,1,11144,319,2905,1194,1,0,15563
7/27/2019,2,11149,290,2584,1055,1,0,15079
7/27/2019,3,11155,290,2569,1120,1,0,15135
7/27/2019,4,11152,296,2571,1229,1,0,15249
7/27/2019,5,11161,387,2524,1068,2,0,15142
7/27/2019,6,11181,608,2714,733,5,0,15241
7/27/2019,7,11176,966,3228,639,37,0,16046
7/27/2019,8,11161,1347,3353,1025,114,0,17000
7/27/2019,9,11157,1611,3606,1288,178,0,17840
7/27/2019,10,11157,2112,3714,1478,261,0,18722
7/27/2019,11,11135,2237,3750,1918,314,0,19354
7/27/2019,12,11102,2226,3823,1850,275,0,19276
7/27/2019,13,11095,2084,3854,2026,315,1,19375
7/27/2019,14,11096,2103,3885,2542,323,15,19964
7/27/2019,15,11117,2042,4027,2701,299,44,20230
7/27/2019,16,11115,1568,4256,2903,261,53,20156
7/27/2019,17,11116,1760,4704,2736,175,56,20547
7/27/2019,18,11106,2160,4676,2504,88,57,20591
7/27/2019,19,11061,2023,4536,2341,30,57,20048
7/27/2019,20,11070,1733,4467,2185,5,57,19517
7/27/2019,21,11058,1536,4494,2161,0,55,19304
7/27/2019,22,11057,1534,4048,2196,0,55,18890
7/27/2019,23,11056,491,3544,2245,0,12,17348
7/27/2019,24,11050,291,3236,2083,0,0,16660
7/28/2019,1,11054,276,2805,1767,0,0,15902
7/28/2019,2,11050,276,2794,1778,0,0,15898
7/28/2019,3,11055,273,2610,1593,0,0,15531
7/28/2019,4,11064,285,2671,1380,0,0,15400
7/28/2019,5,11069,293,2757,1313,3,0,15435
7/28/2019,6,11078,409,2783,1190,3,0,15463
7/28/2019,7,11084,799,3143,869,35,0,15930
7/28/2019,8,11080,1158,3419,513,97,0,16267
7/28/2019,9,11065,1555,3619,814,148,0,17201
7/28/2019,10,11050,2323,3766,844,179,0,18162
7/28/2019,11,11044,3308,3788,887,279,0,19306
7/28/2019,12,11044,3127,4108,866,303,0,19448
7/28/2019,13,11051,3661,4093,1119,319,1,20244
7/28/2019,14,11011,3612,4305,1407,289,4,20628
7/28/2019,15,11055,3662,4411,1518,261,14,20921
7/28/2019,16,11033,3907,4558,1390,207,50,21145
7/28/2019,17,11030,4149,4612,1260,130,128,21309
7/28/2019,18,11037,4284,4556,887,81,139,20984
7/28/2019,19,11044,3968,4474,787,30,93,20396
7/28/2019,20,11043,3878,4578,727,4,110,20340
7/28/2019,21,11040,4255,4469,618,0,147,20529
7/28/2019,22,11041,3874,4121,657,0,52,19745
7/28/2019,23,11048,2699,3653,899,0,0,18299
7/28/2019,24,11044,1786,3202,1094,0,2,17128
7/29/2019,1,11047,1169,2944,1113,0,13,16286
7/29/2019,2,11049,948,2682,971,0,12,15662
7/29/2019,3,11049,861,2666,1079,0,12,15667
7/29/2019,4,11040,955,2697,1295,0,13,16000
7/29/2019,5,11037,1375,2626,882,0,14,15934
7/29/2019,6,11038,1969,2621,1346,5,16,16995
7/29/2019,7,11027,2570,3319,1104,37,24,18081
7/29/2019,8,11018,2756,3673,1371,113,26,18957
7/29/2019,9,11015,3475,3757,1521,189,43,20000
7/29/2019,10,11012,4039,3849,1740,282,83,21005
7/29/2019,11,11005,3855,4154,2068,308,146,21536
7/29/2019,12,10997,3706,4156,2374,318,149,21700
7/29/2019,13,11003,3347,4237,2679,323,104,21693
7/29/2019,14,11003,3332,4374,2872,300,102,21983
7/29/2019,15,11002,3477,4526,2755,273,102,22135
7/29/2019,16,10995,3488,4646,2649,209,102,22089
7/29/2019,17,10996,4564,4682,2237,145,103,22727
7/29/2019,18,10984,4620,4706,1577,69,56,22012
7/29/2019,19,10969,4556,4713,1085,26,42,21391
7/29/2019,20,10953,4766,4514,1055,3,37,21328
7/29/2019,21,10965,4320,4323,1300,0,26,20934
7/29/2019,22,10955,3847,3919,1042,0,26,19789
7/29/2019,23,10971,3141,3421,936,0,16,18485
7/29/2019,24,10980,2081,2885,1076,0,10,17032
7/30/2019,1,10982,1840,2753,1075,0,10,16660
7/30/2019,2,10985,1636,2756,817,0,11,16205
7/30/2019,3,10981,1602,2880,709,0,10,16182
7/30/2019,4,10982,1684,2651,662,0,11,15990
7/30/2019,5,10980,1985,2664,356,1,13,15999
7/30/2019,6,10983,2371,2947,402,4,19,16726
7/30/2019,7,10980,2654,3474,432,27,25,17592
7/30/2019,8,10971,2970,3791,468,59,26,18285
7/30/2019,9,10955,3761,3707,379,96,26,18924
7/30/2019,10,10943,3926,3844,273,145,27,19158
7/30/2019,11,10948,4281,4191,261,197,27,19905
7/30/2019,12,10940,4286,4150,418,230,27,20051
7/30/2019,13,10945,4488,4194,545,227,34,20433
7/30/2019,14,10945,4737,4170,691,251,37,20831
7/30/2019,15,10947,4789,4422,869,260,36,21323
7/30/2019,16,10943,4785,4661,768,261,41,21459
7/30/2019,17,10954,4941,4914,579,173,46,21607
7/30/2019,18,10946,4695,4691,610,86,45,21073
7/30/2019,19,10943,4515,4595,647,31,39,20770
7/30/2019,20,10941,3819,4523,683,4,34,20004
7/30/2019,21,10941,3939,4422,487,0,38,19827
7/30/2019,22,10939,3361,3894,536,0,34,18764
7/30/2019,23,10939,2589,3436,678,0,25,17667
7/30/2019,24,10942,1833,3024,789,0,24,16612
7/31/2019,1,10942,1226,2828,715,0,34,15745
7/31/2019,2,10942,1170,2737,608,0,39,15496
7/31/2019,3,10933,1181,2683,708,0,38,15543
7/31/2019,4,11095,1259,2696,599,0,40,15689
7/31/2019,5,11130,1494,2683,554,2,41,15904
7/31/2019,6,11392,1721,2799,227,4,51,16194
7/31/2019,7,11406,1896,3394,349,39,50,17134
7/31/2019,8,11406,2036,3499,341,123,51,17456
7/31/2019,9,11339,2133,3528,325,216,55,17596
7/31/2019,10,11315,2289,3717,245,317,55,17938
7/31/2019,11,11323,2506,3729,209,341,55,18163
7/31/2019,12,11324,2697,3955,211,342,56,18585
7/31/2019,13,11392,2825,4143,275,333,57,19025
7/31/2019,14,11400,2887,4181,379,326,57,19230
7/31/2019,15,11390,3016,4354,501,282,56,19599
7/31/2019,16,11390,3244,4610,574,247,57,20122
7/31/2019,17,11389,3520,4737,610,204,54,20514
7/31/2019,18,11386,3606,4750,657,116,56,20571
7/31/2019,19,11399,3477,4678,610,31,59,20254
7/31/2019,20,11404,3236,4404,552,5,60,19661
7/31/2019,21,11411,2805,4291,643,0,55,19205
7/31/2019,22,11423,2073,3602,700,0,54,17852
7/31/2019,23,11438,787,3174,824,0,38,16261
7/31/2019,24,11456,236,2940,412,0,33,15077
8/1/2019,1,11472,189,2813,364,0,37,14875
8/1/2019,2,11489,187,2635,486,0,36,14833
8/1/2019,3,11498,198,2669,470,0,36,14871
8/1/2019,4,11507,268,2690,382,0,33,14880
8/1/2019,5,11511,476,2650,448,2,34,15121
8/1/2019,6,11516,886,2668,249,5,43,15367
8/1/2019,7,11520,1267,3280,334,41,48,16490
8/1/2019,8,11515,1619,3425,249,126,30,16964
8/1/2019,9,11444,1868,3455,104,225,27,17123
8/1/2019,10,11310,2204,3551,75,301,27,17468
8/1/2019,11,11309,2475,3723,64,336,27,17934
8/1/2019,12,11464,2567,3713,24,305,27,18100
8/1/2019,13,11472,2817,3836,82,299,27,18533
8/1/2019,14,11464,2868,3894,161,304,27,18718
8/1/2019,15,11460,2867,3817,58,263,27,18492
8/1/2019,16,11461,2886,4152,290,296,27,19112
8/1/2019,17,11460,3002,4644,346,214,27,19693
8/1/2019,18,11472,3501,4589,402,115,27,20106
8/1/2019,19,11484,3492,4467,390,31,27,19891
8/1/2019,20,11493,3130,4456,451,5,27,19562
8/1/2019,21,11494,2746,4314,625,0,27,19206
8/1/2019,22,11507,2070,3721,586,0,27,17911
8/1/2019,23,11516,986,3299,611,0,17,16429
8/1/2019,24,11527,272,2949,497,0,13,15258
8/2/2019,1,11621,223,2647,234,0,13,14738
8/2/2019,2,11742,230,2603,205,0,12,14792
8/2/2019,3,11740,232,2679,203,0,13,14867
8/2/2019,4,11720,248,2763,206,0,12,14949
8/2/2019,5,11704,311,2613,71,1,14,14714
8/2/2019,6,11705,590,3041,86,5,20,15447
8/2/2019,7,11703,843,3206,183,42,27,16004
8/2/2019,8,11688,1093,3400,105,127,27,16440
8/2/2019,9,11692,1541,3508,86,237,27,17091
8/2/2019,10,11702,2137,3488,50,329,27,17733
8/2/2019,11,11695,2416,3672,55,372,25,18235
8/2/2019,12,11695,2753,3826,106,385,27,18792
8/2/2019,13,11696,2786,3785,125,391,33,18816
8/2/2019,14,11692,2820,3830,214,390,34,18980
8/2/2019,15,11700,2810,3957,305,371,27,19170
8/2/2019,16,11690,3021,4372,276,294,26,19679
8/2/2019,17,11681,3702,4506,181,195,27,20292
8/2/2019,18,11675,4098,4497,105,101,28,20504
8/2/2019,19,11685,3819,4548,113,28,28,20221
8/2/2019,20,11683,3409,4385,140,5,27,19649
8/2/2019,21,11682,2849,4264,216,0,27,19038
8/2/2019,22,11675,1973,3732,235,0,27,17642
8/2/2019,23,11683,1193,3440,179,0,20,16515
8/2/2019,24,11677,329,3127,124,0,12,15269
8/3/2019,1,11663,104,2736,75,0,1,14579
8/3/2019,2,11650,106,2940,85,0,0,14781
8/3/2019,3,11545,108,2662,56,0,0,14371
8/3/2019,4,11228,176,2837,65,0,0,14306
8/3/2019,5,11119,411,2980,132,1,0,14643
8/3/2019,6,11134,669,2698,182,4,0,14687
8/3/2019,7,10915,774,3073,123,37,0,14922
8/3/2019,8,11037,1056,3564,112,133,0,15902
8/3/2019,9,11557,1073,3666,32,228,0,16556
8/3/2019,10,11731,1199,3596,11,300,0,16837
8/3/2019,11,11715,1205,3663,16,349,0,16948
8/3/2019,12,11698,1348,3809,43,375,0,17273
8/3/2019,13,11675,1607,3936,112,360,0,17690
8/3/2019,14,11638,1773,4187,177,353,0,18128
8/3/2019,15,11646,1928,4190,265,343,0,18372
8/3/2019,16,11650,2189,4330,348,229,0,18746
8/3/2019,17,11663,2631,4370,387,158,0,19209
8/3/2019,18,11675,2797,4427,342,84,0,19325
8/3/2019,19,11678,2475,4544,282,29,0,19008
8/3/2019,20,11677,2347,4379,264,4,0,18671
8/3/2019,21,11686,1827,4332,296,0,0,18141
8/3/2019,22,11696,1510,3896,342,0,0,17444
8/3/2019,23,11709,543,3586,356,0,0,16194
8/3/2019,24,11714,124,2955,284,0,0,15077
8/4/2019,1,11721,103,2765,235,0,0,14824
8/4/2019,2,11726,103,2568,265,0,0,14662
8/4/2019,3,11723,103,2539,179,0,0,14544
8/4/2019,4,11545,103,2562,261,0,0,14471
8/4/2019,5,11405,105,2505,348,2,0,14365
8/4/2019,6,11396,114,2513,270,3,0,14296
8/4/2019,7,11383,191,2754,364,37,0,14729
8/4/2019,8,11416,507,3163,223,136,0,15445
8/4/2019,9,11660,905,3052,117,250,0,15984
8/4/2019,10,11656,1177,3300,94,332,0,16559
8/4/2019,11,11639,1434,3490,62,352,0,16977
8/4/2019,12,11588,1558,3528,63,345,0,17082
8/4/2019,13,11625,1727,3801,118,356,0,17627
8/4/2019,14,11612,1849,3802,225,372,0,17860
8/4/2019,15,11602,1558,3919,293,331,0,17703
8/4/2019,16,11596,1567,3934,366,286,0,17749
8/4/2019,17,11598,1925,4320,342,184,0,18369
8/4/2019,18,11599,2069,4517,214,96,0,18495
8/4/2019,19,11600,1818,4303,131,26,0,17878
8/4/2019,20,11602,1580,4265,153,3,0,17603
8/4/2019,21,11610,1364,4082,195,0,0,17251
8/4/2019,22,11609,564,3950,166,0,0,16289
8/4/2019,23,11614,158,3231,257,0,0,15260
8/4/2019,24,11610,101,2677,184,0,0,14572
8/5/2019,1,11577,102,2694,195,0,0,14568
8/5/2019,2,11174,103,2656,251,0,0,14184
8/5/2019,3,10828,102,2673,273,0,0,13876
8/5/2019,4,10726,101,2802,222,0,0,13851
8/5/2019,5,10720,110,2923,219,1,0,13973
8/5/2019,6,10713,211,2811,249,5,0,13989
8/5/2019,7,10722,460,3406,232,36,0,14856
8/5/2019,8,10738,788,3391,158,120,0,15195
8/5/2019,9,11164,1322,3499,98,227,0,16310
8/5/2019,10,11584,1536,3275,130,309,0,16834
8/5/2019,11,11599,1860,3330,209,342,0,17340
8/5/2019,12,11590,2047,3627,294,358,0,17916
8/5/2019,13,11585,2209,3752,265,373,0,18184
8/5/2019,14,11583,2384,3939,423,362,0,18691
8/5/2019,15,11571,2563,3980,439,348,0,18901
8/5/2019,16,11556,2826,4256,368,297,0,19303
8/5/2019,17,11542,3398,4397,383,205,0,19925
8/5/2019,18,11528,3225,4534,453,101,0,19841
8/5/2019,19,11522,3051,4488,500,27,0,19588
8/5/2019,20,11528,3085,4317,515,1,0,19446
8/5/2019,21,11550,2755,4170,683,0,0,19158
8/5/2019,22,11565,1969,3764,816,0,0,18114
8/5/2019,23,11578,973,3136,975,0,0,16662
8/5/2019,24,11580,394,2760,1015,0,0,15749
8/6/2019,1,11578,312,2510,1128,0,0,15528
8/6/2019,2,11572,318,2526,1191,0,16,15623
8/6/2019,3,11555,324,2389,1016,0,15,15299
8/6/2019,4,11541,381,2449,939,0,13,15323
8/6/2019,5,11533,670,2417,966,2,15,15603
8/6/2019,6,11514,1032,2437,865,2,39,15889
8/6/2019,7,11501,1525,2942,730,31,94,16823
8/6/2019,8,11501,2062,3247,793,114,178,17895
8/6/2019,9,11493,2585,3607,639,197,204,18725
8/6/2019,10,11488,2952,3581,666,266,205,19158
8/6/2019,11,11500,2912,3606,632,279,209,19138
8/6/2019,12,11507,2959,3914,460,216,209,19265
8/6/2019,13,11403,3608,4134,337,142,208,19832
8/6/2019,14,11388,4036,3985,222,167,204,20002
8/6/2019,15,11396,3969,4038,411,195,209,20218
8/6/2019,16,11500,3438,4180,510,139,207,19974
8/6/2019,17,11525,3743,4105,548,99,207,20227
8/6/2019,18,11505,3446,4281,406,57,204,19899
8/6/2019,19,11493,3546,4333,261,16,201,19850
8/6/2019,20,11472,3689,4116,141,2,203,19623
8/6/2019,21,11458,3504,3982,134,0,180,19258
8/6/2019,22,11454,2629,3852,144,0,96,18175
8/6/2019,23,11501,1663,3560,104,0,27,16855
8/6/2019,24,11534,1287,3104,101,0,13,16039
8/7/2019,1,11550,1180,2598,80,0,13,15421
8/7/2019,2,11576,1181,2705,74,0,15,15551
8/7/2019,3,11577,1186,2742,80,0,14,15599
8/7/2019,4,11567,1261,2775,104,0,14,15721
8/7/2019,5,11560,1561,2772,87,0,17,15997
8/7/2019,6,11563,1976,2806,81,3,49,16478
8/7/2019,7,11563,2228,3182,67,13,92,17145
8/7/2019,8,11556,2356,3136,34,67,182,17331
8/7/2019,9,11556,2752,3346,26,147,210,18037
8/7/2019,10,11606,2874,3723,23,208,207,18641
8/7/2019,11,11606,3131,3759,36,217,206,18955
8/7/2019,12,11460,3560,3741,71,227,207,19266
8/7/2019,13,11475,3783,3662,125,215,205,19465
8/7/2019,14,11615,3849,3691,183,231,205,19774
8/7/2019,15,11620,3875,3911,315,287,207,20215
8/7/2019,16,11612,3850,3957,357,268,206,20250
8/7/2019,17,11608,3920,4365,200,191,206,20490
8/7/2019,18,11594,4349,4336,187,92,205,20763
8/7/2019,19,11589,4088,4186,176,28,205,20272
8/7/2019,20,11576,3731,4148,182,1,206,19844
8/7/2019,21,11584,3540,4051,140,0,151,19466
8/7/2019,22,11598,2459,3758,286,0,44,18145
8/7/2019,23,11589,1444,3168,490,0,16,16707
8/7/2019,24,11579,563,2749,710,0,14,15615
8/8/2019,1,11584,376,2384,507,0,14,14865
8/8/2019,2,11594,390,2468,474,0,14,14940
8/8/2019,3,11574,407,2510,647,0,12,15150
8/8/2019,4,11577,478,2423,601,0,14,15093
8/8/2019,5,11589,754,2509,712,1,16,15581
8/8/2019,6,11570,1130,2649,660,2,47,16058
8/8/2019,7,11547,1226,3193,954,31,88,17039
8/8/2019,8,11541,1568,3611,1169,106,181,18176
8/8/2019,9,11534,1687,3447,1503,141,209,18521
8/8/2019,10,11521,1898,3239,1519,162,207,18546
8/8/2019,11,11512,1993,3266,1063,288,205,18327
8/8/2019,12,11529,2244,3294,1319,294,206,18886
8/8/2019,13,11559,2363,3447,1635,221,205,19430
8/8/2019,14,11572,2553,3503,1483,216,206,19533
8/8/2019,15,11577,2548,3527,965,235,206,19058
8/8/2019,16,11571,2332,3536,1315,213,206,19173
8/8/2019,17,11583,2197,3838,1593,182,209,19602
8/8/2019,18,11607,2354,4123,1296,95,205,19680
8/8/2019,19,11628,2448,4098,1010,29,144,19357
8/8/2019,20,11645,2153,4179,911,2,41,18931
8/8/2019,21,11667,1643,3743,940,0,27,18020
8/8/2019,22,11669,1409,3570,698,0,27,17373
8/8/2019,23,11662,412,3168,1169,0,17,16428
8/8/2019,24,11678,187,2683,1083,0,15,15646
8/9/2019,1,11689,186,2341,999,0,14,15229
8/9/2019,2,11706,199,2381,519,0,14,14819
8/9/2019,3,11470,240,2392,548,0,14,14664
8/9/2019,4,11428,437,2413,458,0,15,14751
8/9/2019,5,11426,630,2430,474,2,16,14978
8/9/2019,6,11433,752,2663,754,3,25,15630
8/9/2019,7,11672,824,3254,732,34,27,16543
8/9/2019,8,11752,911,3336,552,134,27,16712
8/9/2019,9,11750,1124,3300,613,241,27,17055
8/9/2019,10,11744,1438,3283,715,321,27,17528
8/9/2019,11,11745,1494,3355,981,307,27,17909
8/9/2019,12,11746,1622,3520,1521,285,27,18721
8/9/2019,13,11746,1795,3530,1495,260,27,18853
8/9/2019,14,11754,1793,3590,1292,252,27,18708
8/9/2019,15,11756,1462,3623,1197,298,27,18363
8/9/2019,16,11781,1228,3672,1025,267,27,18000
8/9/2019,17,11847,852,3786,1341,187,27,18040
8/9/2019,18,11846,760,4038,1267,79,27,18017
8/9/2019,19,11865,661,4186,1063,24,27,17826
8/9/2019,20,11871,566,4334,939,1,27,17738
8/9/2019,21,11870,566,3813,1064,0,27,17340
8/9/2019,22,11882,239,3247,1090,0,27,16485
8/9/2019,23,11894,191,2718,926,0,15,15744
8/9/2019,24,11874,190,2632,616,0,1,15313
8/10/2019,1,11910,191,2403,816,0,0,15320
8/10/2019,2,11911,191,2298,471,0,0,14871
8/10/2019,3,11745,192,2318,380,0,0,14635
8/10/2019,4,11629,192,2376,246,0,0,14443
8/10/2019,5,11434,192,2619,447,1,0,14693
8/10/2019,6,11373,192,2914,491,3,0,14973
8/10/2019,7,11452,165,3153,371,31,0,15172
8/10/2019,8,11920,165,3163,172,106,0,15526
8/10/2019,9,12006,165,3190,380,237,0,15978
8/10/2019,10,12004,164,3193,530,319,0,16210
8/10/2019,11,12002,163,3238,696,343,0,16442
8/10/2019,12,12003,162,3377,944,294,0,16780
8/10/2019,13,11999,166,3201,1047,290,0,16703
8/10/2019,14,11949,188,3185,996,288,0,16606
8/10/2019,15,11951,204,3252,912,265,0,16584
8/10/2019,16,11927,250,3316,876,258,0,16627
8/10/2019,17,11935,448,3517,864,192,0,16956
8/10/2019,18,11952,564,4189,625,100,0,17430
8/10/2019,19,11975,562,4315,371,26,2,17251
8/10/2019,20,11993,587,4282,280,1,10,17153
8/10/2019,21,12004,569,3843,240,0,3,16659
8/10/2019,22,12015,567,3464,258,0,1,16305
8/10/2019,23,12011,436,2921,257,0,0,15625
8/10/2019,24,11937,192,2700,266,0,0,15095
8/11/2019,1,11714,193,2563,348,0,0,14818
8/11/2019,2,11706,193,2368,381,0,0,14648
8/11/2019,3,11430,199,2362,424,0,0,14415
8/11/2019,4,11370,196,2374,290,0,0,14230
8/11/2019,5,11092,193,2460,558,1,0,14304
8/11/2019,6,11069,191,2582,282,2,0,14126
8/11/2019,7,11063,191,2835,177,15,0,14281
8/11/2019,8,11078,193,3297,237,91,0,14896
8/11/2019,9,11318,195,3329,245,189,0,15276
8/11/2019,10,11609,239,3422,193,330,0,15793
8/11/2019,11,11921,275,3291,263,343,0,16093
8/11/2019,12,11947,400,3512,380,345,0,16584
8/11/2019,13,11980,516,3398,509,336,0,16739
8/11/2019,14,11987,548,3549,657,300,0,17041
8/11/2019,15,11973,561,3592,529,284,0,16939
8/11/2019,16,11961,664,3661,612,281,0,17179
8/11/2019,17,11948,901,4147,652,206,0,17854
8/11/2019,18,11927,935,4543,544,100,0,18049
8/11/2019,19,11895,983,4666,419,27,0,17990
8/11/2019,20,11874,1128,4507,361,2,0,17872
8/11/2019,21,11874,1028,4308,384,0,0,17594
8/11/2019,22,11892,868,3959,421,0,0,17140
8/11/2019,23,11891,441,3264,517,0,0,16113
8/11/2019,24,11891,187,2933,691,0,0,15702
8/12/2019,1,11901,185,2503,776,4,8,15377
8/12/2019,2,11906,189,2531,767,2,11,15406
8/12/2019,3,11912,198,2540,771,0,12,15433
8/12/2019,4,11909,268,2640,671,0,11,15499
8/12/2019,5,11920,454,2857,570,0,13,15814
8/12/2019,6,11922,858,2698,510,6,15,16009
8/12/2019,7,11909,1152,3251,132,24,25,16493
8/12/2019,8,11898,1353,3285,88,52,27,16703
8/12/2019,9,11886,1553,3520,67,90,32,17148
8/12/2019,10,11883,1831,3469,139,252,32,17606
8/12/2019,11,11887,1917,3760,369,363,45,18341
8/12/2019,12,11891,1981,3839,720,376,49,18856
8/12/2019,13,11891,2130,3941,1071,357,38,19428
8/12/2019,14,11888,2425,3939,1161,331,27,19771
8/12/2019,15,11881,2499,4050,1135,254,27,19846
8/12/2019,16,11884,2570,4294,1068,198,27,20041
8/12/2019,17,11892,2861,4164,1059,146,26,20148
8/12/2019,18,11895,2891,4351,854,79,27,20097
8/12/2019,19,11899,2814,4363,697,18,27,19818
8/12/2019,20,11901,3033,4357,769,0,27,20087
8/12/2019,21,11901,2492,3923,819,0,27,19162
8/12/2019,22,11896,2292,3793,503,0,27,18511
8/12/2019,23,11902,1406,3660,319,0,22,17309
8/12/2019,24,11908,624,3083,251,0,14,15880
8/13/2019,1,11906,338,2453,283,0,14,14994
8/13/2019,2,11906,193,2467,189,0,14,14769
8/13/2019,3,11909,201,2483,150,0,13,14756
8/13/2019,4,11913,285,2467,69,0,14,14748
8/13/2019,5,11913,526,2442,65,0,16,14962
8/13/2019,6,11914,868,2553,132,2,33,15502
8/13/2019,7,11912,1422,3110,98,32,85,16659
8/13/2019,8,11916,2127,3450,94,99,177,17863
8/13/2019,9,11916,2498,3327,62,202,200,18205
8/13/2019,10,11913,2679,3460,35,253,200,18540
8/13/2019,11,11912,2900,3548,36,273,201,18870
8/13/2019,12,11894,3037,3713,43,329,200,19216
8/13/2019,13,11897,3264,3740,115,377,202,19595
8/13/2019,14,11902,3499,3816,363,359,202,20141
8/13/2019,15,11915,3621,3931,591,294,201,20553
8/13/2019,16,11923,3581,4167,824,256,201,20952
8/13/2019,17,11925,3495,4269,921,174,200,20984
8/13/2019,18,11931,3399,4260,898,81,202,20771
8/13/2019,19,11933,3066,4283,849,17,201,20349
8/13/2019,20,11933,2973,4196,1019,0,201,20322
8/13/2019,21,11933,2626,3818,1199,0,144,19720
8/13/2019,22,11932,2070,3392,803,0,46,18243
8/13/2019,23,11940,616,2749,1127,0,23,16455
8/13/2019,24,11942,222,2583,847,0,14,15608
8/14/2019,1,11948,193,2432,692,0,14,15279
8/14/2019,2,11939,193,2419,507,0,18,15076
8/14/2019,3,11945,196,2454,387,0,18,15000
8/14/2019,4,11952,205,2489,368,0,17,15031
8/14/2019,5,11954,290,2548,385,0,21,15198
8/14/2019,6,11954,531,2621,441,2,39,15588
8/14/2019,7,11952,903,3118,367,31,91,16462
8/14/2019,8,11863,1328,3237,498,117,55,17098
8/14/2019,9,11870,1579,3358,453,236,26,17522
8/14/2019,10,11857,1636,3301,396,322,26,17538
8/14/2019,11,11896,1813,3254,348,353,27,17691
8/14/2019,12,11886,1897,3346,315,408,26,17878
8/14/2019,13,11873,2053,3653,316,409,26,18330
8/14/2019,14,11860,2358,3486,403,402,27,18536
8/14/2019,15,11876,2275,3611,514,378,27,18681
8/14/2019,16,11968,2225,4114,740,313,27,19387
8/14/2019,17,11978,2341,4326,834,214,27,19720
8/14/2019,18,11981,2418,4425,847,107,26,19804
8/14/2019,19,11987,2386,4246,796,25,27,19467
8/14/2019,20,12038,2188,4271,726,2,27,19252
8/14/2019,21,12042,1962,3966,804,0,27,18801
8/14/2019,22,12048,1201,3431,776,0,27,17483
8/14/2019,23,12030,384,2887,703,0,18,16022
8/14/2019,24,12009,197,2760,382,0,15,15363
8/15/2019,1,12014,193,2626,319,0,15,15167
8/15/2019,2,12019,192,2642,495,0,15,15363
8/15/2019,3,12023,195,2600,545,0,14,15377
8/15/2019,4,12021,206,2602,452,0,14,15295
8/15/2019,5,12016,285,2632,732,1,15,15681
8/15/2019,6,12015,503,2679,957,3,22,16179
8/15/2019,7,12007,749,3214,359,36,27,16392
8/15/2019,8,12005,879,3398,640,116,27,17065
8/15/2019,9,12004,1041,3263,454,228,27,17017
8/15/2019,10,11993,1367,3166,317,294,28,17165
8/15/2019,11,11997,1589,3251,246,329,34,17446
8/15/2019,12,12000,1643,3521,246,302,27,17739
8/15/2019,13,11989,1771,3634,264,241,27,17926
8/15/2019,14,11969,1778,3513,205,269,27,17761
8/15/2019,15,11962,1814,3618,139,245,27,17805
8/15/2019,16,11970,1781,3602,334,257,27,17971
8/15/2019,17,11970,1672,3862,422,190,27,18143
8/15/2019,18,11978,1530,4231,458,82,26,18305
8/15/2019,19,11973,1371,4249,493,18,26,18130
8/15/2019,20,11966,1213,4260,540,0,26,18005
8/15/2019,21,11956,1198,3978,636,0,26,17794
8/15/2019,22,11955,398,3683,372,0,26,16434
8/15/2019,23,11967,189,3141,505,0,18,15820
8/15/2019,24,11980,190,2904,398,0,16,15488
8/16/2019,1,11982,191,2550,244,0,16,14983
8/16/2019,2,11953,191,2531,235,0,15,14925
8/16/2019,3,11947,192,2520,165,0,14,14838
8/16/2019,4,11948,192,2730,169,0,13,15052
8/16/2019,5,11944,196,2753,230,1,15,15139
8/16/2019,6,11932,229,2873,315,1,22,15372
8/16/2019,7,11935,313,3268,228,37,27,15808
8/16/2019,8,11935,565,3518,178,133,27,16356
8/16/2019,9,11925,1001,3422,60,246,27,16681
8/16/2019,10,11923,1274,3628,62,311,27,17225
8/16/2019,11,11903,1521,3679,79,329,27,17538
8/16/2019,12,11899,1662,3888,107,342,27,17925
8/16/2019,13,11908,1805,4015,166,308,27,18229
8/16/2019,14,11894,1892,3964,292,298,27,18367
8/16/2019,15,11892,2104,4110,347,274,32,18759
8/16/2019,16,11628,2483,4160,418,225,33,18947
8/16/2019,17,11392,2748,4338,431,180,27,19116
8/16/2019,18,11303,2854,4309,409,96,26,18997
8/16/2019,19,11147,2756,4361,296,21,26,18607
8/16/2019,20,11105,2650,4337,312,0,29,18433
8/16/2019,21,11086,2596,4093,402,0,27,18204
8/16/2019,22,11081,1841,3557,509,0,26,17014
8/16/2019,23,11078,440,3501,521,0,13,15553
8/16/2019,24,11076,190,2940,677,0,2,14885
8/17/2019,1,11074,191,2567,542,0,0,14374
8/17/2019,2,11069,189,2538,613,0,0,14409
8/17/2019,3,11072,190,2569,979,0,0,14810
8/17/2019,4,11074,190,2529,813,0,0,14606
8/17/2019,5,11067,189,2636,821,1,0,14714
8/17/2019,6,11066,193,2749,1009,1,0,15018
8/17/2019,7,11065,288,3140,1026,12,0,15531
8/17/2019,8,11053,431,3334,862,51,0,15731
8/17/2019,9,11035,682,3257,829,112,0,15915
8/17/2019,10,11024,1064,3492,785,190,0,16555
8/17/2019,11,11012,1391,3834,708,172,0,17117
8/17/2019,12,10991,1748,3739,976,231,0,17685
8/17/2019,13,10977,1845,3721,1156,267,0,17966
8/17/2019,14,10956,2204,3813,1224,281,0,18478
8/17/2019,15,10961,2333,4060,1052,277,0,18683
8/17/2019,16,10968,2479,4210,849,252,0,18758
8/17/2019,17,10961,2919,4338,672,170,0,19060
8/17/2019,18,10956,3258,4408,432,93,0,19147
8/17/2019,19,10951,3242,4290,331,22,0,18836
8/17/2019,20,10950,2600,4414,359,0,0,18323
8/17/2019,21,10958,2332,4175,393,0,0,17858
8/17/2019,22,10961,1086,4031,429,0,0,16507
8/17/2019,23,10962,473,3553,439,0,0,15427
8/17/2019,24,10956,229,2925,414,0,0,14524
8/18/2019,1,10959,188,2754,403,0,0,14304
8/18/2019,2,10944,194,2624,252,0,0,14014
8/18/2019,3,10937,209,2709,245,0,0,14100
8/18/2019,4,10928,214,2951,323,0,0,14416
8/18/2019,5,10928,288,2923,337,1,0,14477
8/18/2019,6,10933,533,2892,474,1,0,14833
8/18/2019,7,10936,787,2927,478,16,37,15181
8/18/2019,8,10914,926,3162,264,83,52,15401
8/18/2019,9,10919,1179,3391,549,157,55,16250
8/18/2019,10,10925,1493,3356,588,229,53,16644
8/18/2019,11,10932,1746,3320,937,253,51,17239
8/18/2019,12,10926,1982,3268,902,356,52,17486
8/18/2019,13,10928,1859,3287,1407,306,56,17843
8/18/2019,14,10922,1817,3635,2038,293,57,18762
8/18/2019,15,10881,1815,3991,1801,304,53,18845
8/18/2019,16,10893,1895,4332,1770,245,54,19189
8/18/2019,17,10901,1951,4179,1486,128,55,18700
8/18/2019,18,10898,2100,4326,1132,72,59,18587
8/18/2019,19,10891,2032,3732,1051,18,56,17780
8/18/2019,20,10883,2011,3822,1493,0,56,18265
8/18/2019,21,10884,2000,3789,1732,0,55,18460
8/18/2019,22,10892,1246,3600,1154,0,15,16907
8/18/2019,23,10889,517,3120,1968,0,0,16494
8/18/2019,24,10897,224,2900,2092,0,0,16113
8/19/2019,1,10902,203,2706,1953,0,0,15764
8/19/2019,2,10908,212,2574,1945,0,0,15639
8/19/2019,3,10903,257,2535,1468,0,0,15163
8/19/2019,4,10898,485,2599,1326,0,12,15320
8/19/2019,5,10901,1043,2587,860,0,15,15406
8/19/2019,6,10897,1526,2600,579,1,19,15622
8/19/2019,7,10897,1994,3274,591,14,26,16796
8/19/2019,8,10892,2244,3487,493,85,26,17227
8/19/2019,9,10888,2688,3731,360,193,26,17886
8/19/2019,10,10902,3211,3736,225,277,27,18378
8/19/2019,11,10933,3580,3843,244,333,27,18960
8/19/2019,12,10933,3788,3870,319,346,26,19282
8/19/2019,13,10931,3733,4097,465,351,27,19604
8/19/2019,14,10919,3719,4201,580,355,27,19801
8/19/2019,15,10918,4072,4165,717,356,27,20255
8/19/2019,16,10931,4192,4197,761,313,26,20420
8/19/2019,17,10940,4489,4402,694,216,27,20768
8/19/2019,18,10939,4433,4444,536,91,26,20469
8/19/2019,19,10940,4371,4424,336,18,27,20116
8/19/2019,20,10929,4180,4375,254,2,27,19767
8/19/2019,21,10936,3633,4377,226,0,27,19199
8/19/2019,22,10946,2724,3977,206,0,27,17880
8/19/2019,23,10967,1553,3127,225,0,19,15891
8/19/2019,24,11023,918,2687,253,0,14,14895
8/20/2019,1,11042,865,2610,246,0,12,14775
8/20/2019,2,11042,866,2694,421,0,12,15035
8/20/2019,3,11047,874,2740,261,0,12,14934
8/20/2019,4,11056,953,2654,221,0,14,14898
8/20/2019,5,11049,1176,2797,222,0,19,15263
8/20/2019,6,11053,1419,2996,417,1,43,15929
8/20/2019,7,11045,1587,3523,375,35,50,16615
8/20/2019,8,11034,1655,3587,287,139,28,16730
8/20/2019,9,11024,1938,3704,200,254,32,17152
8/20/2019,10,11012,2243,3682,363,339,29,17668
8/20/2019,11,11010,2406,3727,499,366,28,18036
8/20/2019,12,11007,2759,3834,500,363,58,18521
8/20/2019,13,10995,3336,4106,522,370,105,19434
8/20/2019,14,10977,3628,4131,654,346,172,19908
8/20/2019,15,10977,3971,4203,672,311,211,20345
8/20/2019,16,10965,4340,4341,703,253,215,20817
8/20/2019,17,10964,4670,4469,519,144,215,20981
8/20/2019,18,10956,4255,4379,493,65,207,20355
8/20/2019,19,10959,3924,4374,530,13,198,19998
8/20/2019,20,10950,3489,4442,817,1,204,19903
8/20/2019,21,10951,3696,4411,619,0,151,19828
8/20/2019,22,10951,2934,3861,807,0,44,18597
8/20/2019,23,10963,2191,3404,541,0,18,17117
8/20/2019,24,10972,1316,3037,540,0,13,15878
8/21/2019,1,10995,1242,2619,391,0,12,15259
8/21/2019,2,10994,1248,2596,413,0,12,15263
8/21/2019,3,10994,1251,2576,433,0,11,15265
8/21/2019,4,10989,1334,2612,226,0,13,15174
8/21/2019,5,10985,1567,3067,438,0,22,16079
8/21/2019,6,10978,1918,3087,374,0,46,16403
8/21/2019,7,10971,2199,3274,256,9,95,16804
8/21/2019,8,10966,2810,3647,205,55,179,17862
8/21/2019,9,10969,3700,3588,156,111,205,18729
8/21/2019,10,10956,4085,3654,156,222,205,19278
8/21/2019,11,10948,4270,3620,286,281,205,19610
8/21/2019,12,10948,4160,3774,367,341,205,19795
8/21/2019,13,10960,4416,3821,495,325,204,20221
8/21/2019,14,10968,4223,3722,689,349,208,20159
8/21/2019,15,10975,4263,3831,868,328,215,20480
8/21/2019,16,10988,4388,3817,1101,260,218,20772
8/21/2019,17,11023,4239,4004,1252,142,217,20877
8/21/2019,18,11057,3799,4124,1223,50,219,20472
8/21/2019,19,11057,3729,3997,1234,11,216,20244
8/21/2019,20,11048,4084,3996,1046,0,207,20381
8/21/2019,21,11036,3974,3795,1057,0,206,20068
8/21/2019,22,11027,3003,3312,1252,0,207,18801
8/21/2019,23,11035,1691,2782,1252,0,197,16957
8/21/2019,24,11039,485,2801,1175,0,177,15677
8/22/2019,1,11022,199,2685,1119,0,98,15123
8/22/2019,2,11023,196,2545,597,0,24,14385
8/22/2019,3,11053,198,2633,589,0,12,14485
8/22/2019,4,11106,209,2584,411,0,13,14323
8/22/2019,5,11126,316,2674,314,1,15,14446
8/22/2019,6,11123,569,2662,393,2,39,14788
8/22/2019,7,11123,860,3166,361,22,93,15625
8/22/2019,8,11139,1126,3256,561,56,181,16319
8/22/2019,9,11154,1237,3282,648,109,203,16633
8/22/2019,10,11169,1649,3199,649,194,206,17066
8/22/2019,11,11167,2183,3058,503,278,205,17394
8/22/2019,12,11159,2299,2987,531,306,205,17487
8/22/2019,13,11144,2430,3032,524,332,204,17666
8/22/2019,14,11126,2433,3015,627,338,207,17746
8/22/2019,15,11118,2500,3183,676,282,203,17962
8/22/2019,16,11099,2624,3360,934,263,206,18486
8/22/2019,17,11103,2615,3593,986,195,201,18693
8/22/2019,18,11113,2447,3794,972,89,201,18616
8/22/2019,19,11112,2210,3754,881,14,202,18173
8/22/2019,20,11125,1801,3624,577,1,196,17324
8/22/2019,21,11134,1647,3552,510,0,196,17039
8/22/2019,22,11160,827,3189,447,0,203,15826
8/22/2019,23,11203,275,2995,445,0,192,15110
8/22/2019,24,11212,211,2597,433,0,146,14599
8/23/2019,1,11222,200,2476,273,0,85,14256
8/23/2019,2,11247,198,2550,290,0,49,14334
8/23/2019,3,11254,203,2415,259,0,37,14168
8/23/2019,4,11259,222,2438,145,0,37,14101
8/23/2019,5,11254,409,2457,235,1,38,14394
8/23/2019,6,11245,765,2421,249,2,41,14723
8/23/2019,7,11235,1250,2896,246,33,54,15714
8/23/2019,8,11220,1603,3066,252,132,52,16325
8/23/2019,9,11206,1758,3391,199,243,50,16847
8/23/2019,10,11202,1830,3173,356,350,74,16985
8/23/2019,11,11202,1817,3073,307,347,110,16856
8/23/2019,12,11192,1831,3055,332,327,127,16864
8/23/2019,13,11055,1679,3100,723,326,125,17008
8/23/2019,14,11009,1648,3303,549,326,110,16945
8/23/2019,15,11050,1645,3454,424,250,106,16929
8/23/2019,16,11168,1270,3287,604,195,102,16626
8/23/2019,17,11206,1026,3396,996,158,97,16879
8/23/2019,18,11243,853,3421,1130,77,86,16810
8/23/2019,19,11269,813,3443,960,18,89,16592
8/23/2019,20,11286,471,3148,1046,0,89,16040
8/23/2019,21,11294,389,3234,1195,0,89,16201
8/23/2019,22,11301,223,3079,1183,0,89,15875
8/23/2019,23,11304,198,2605,946,0,79,15132
8/23/2019,24,11301,198,2524,443,0,61,14527
8/24/2019,1,11289,198,2382,323,0,63,14255
8/24/2019,2,11072,198,2351,371,0,92,14084
8/24/2019,3,10962,198,2395,384,0,88,14027
8/24/2019,4,10954,198,2463,487,0,71,14173
8/24/2019,5,10941,197,2439,447,0,59,14083
8/24/2019,6,10944,197,2501,465,2,4,14113
8/24/2019,7,10946,197,2781,403,26,0,14353
8/24/2019,8,11011,193,2888,469,85,0,14646
8/24/2019,9,11229,275,2950,250,211,0,14915
8/24/2019,10,11219,291,2770,324,277,0,14881
8/24/2019,11,11212,497,2873,349,255,0,15186
8/24/2019,12,11233,752,2911,342,285,1,15524
8/24/2019,13,11256,853,2882,243,328,1,15563
8/24/2019,14,11263,834,2851,284,322,0,15554
8/24/2019,15,11269,825,2989,179,312,0,15574
8/24/2019,16,11253,847,3140,247,266,0,15753
8/24/2019,17,11237,952,3270,482,197,0,16138
8/24/2019,18,11220,1006,3367,492,95,0,16180
8/24/2019,19,11197,1008,3417,381,16,0,16019
8/24/2019,20,11182,1012,3642,347,0,0,16183
8/24/2019,21,11175,538,3378,378,0,0,15469
8/24/2019,22,11168,388,3304,403,0,0,15263
8/24/2019,23,11172,365,2566,503,0,0,14606
8/24/2019,24,11175,199,2470,517,0,0,14361
8/25/2019,1,11093,195,2444,251,0,0,13983
8/25/2019,2,10880,196,2406,271,0,0,13753
8/25/2019,3,10872,195,2414,234,0,0,13715
8/25/2019,4,10677,196,2443,456,0,0,13772
8/25/2019,5,10695,197,2467,459,0,0,13818
8/25/2019,6,10692,197,2403,449,2,0,13743
8/25/2019,7,10687,195,2728,629,33,0,14272
8/25/2019,8,10668,196,2946,391,143,0,14344
8/25/2019,9,10850,194,3220,424,262,0,14950
8/25/2019,10,11136,276,2952,583,343,0,15290
8/25/2019,11,11204,289,3091,647,356,0,15587
8/25/2019,12,11018,491,3169,708,357,0,15743
8/25/2019,13,10981,741,3086,780,362,0,15950
8/25/2019,14,11009,844,3026,778,321,0,15978
8/25/2019,15,11145,812,3066,565,337,0,15925
8/25/2019,16,11143,804,3428,842,285,0,16502
8/25/2019,17,11144,803,3762,1019,185,0,16913
8/25/2019,18,11150,804,3904,1209,85,0,17152
8/25/2019,19,11146,805,3801,1126,15,0,16893
8/25/2019,20,11166,806,3579,1342,1,0,16894
8/25/2019,21,11183,806,3306,1317,0,0,16612
8/25/2019,22,11182,324,3194,1422,0,0,16122
8/25/2019,23,11179,193,2629,1591,0,0,15592
8/25/2019,24,11174,192,2538,1089,0,0,14993
8/26/2019,1,11179,194,2403,694,0,3,14473
8/26/2019,2,11175,193,2373,540,0,12,14293
8/26/2019,3,11168,194,2369,508,0,12,14251
8/26/2019,4,11175,194,2382,505,0,12,14268
8/26/2019,5,11174,198,2439,807,1,13,14632
8/26/2019,6,11179,213,2465,1229,2,22,15110
8/26/2019,7,11174,290,2879,1341,33,27,15744
8/26/2019,8,11174,558,3241,1721,140,27,16861
8/26/2019,9,11169,799,3687,1810,256,27,17748
8/26/2019,10,11167,961,3503,2109,320,27,18087
8/26/2019,11,11159,1100,3130,1819,348,27,17583
8/26/2019,12,11155,1159,3045,1786,354,27,17526
8/26/2019,13,11156,1315,3006,1818,334,27,17656
8/26/2019,14,11153,1452,3114,2106,328,27,18180
8/26/2019,15,11144,1296,3345,2040,337,27,18189
8/26/2019,16,11132,1244,3361,1966,261,27,17991
8/26/2019,17,11127,1244,3450,2349,167,27,18364
8/26/2019,18,11127,765,3778,2508,51,28,18257
8/26/2019,19,11114,617,3786,2332,11,29,17889
8/26/2019,20,11107,617,3628,2524,0,37,17913
8/26/2019,21,11099,281,3479,2372,0,35,17266
8/26/2019,22,11097,189,3465,1976,0,33,16760
8/26/2019,23,11082,188,2745,2148,0,25,16188
8/26/2019,24,11084,191,2488,1762,0,19,15544
8/27/2019,1,11076,171,2393,1392,0,18,15050
8/27/2019,2,11071,188,2343,1244,0,21,14867
8/27/2019,3,11077,189,2245,1197,0,21,14729
8/27/2019,4,11083,191,2270,1114,0,22,14680
8/27/2019,5,11077,206,2302,1283,1,21,14890
8/27/2019,6,11072,212,2433,2083,1,32,15833
8/27/2019,7,11056,345,2936,2584,15,38,16974
8/27/2019,8,11058,546,3219,2799,39,37,17698
8/27/2019,9,11049,924,3437,2589,71,38,18108
8/27/2019,10,11052,1355,3572,2275,108,41,18403
8/27/2019,11,11040,1472,3454,2025,131,40,18162
8/27/2019,12,11035,1312,3493,1917,130,43,17930
8/27/2019,13,11031,1394,3275,1929,153,44,17826
8/27/2019,14,11042,1328,3226,1695,145,45,17481
8/27/2019,15,11052,1515,3409,1384,145,45,17550
8/27/2019,16,11060,1580,3859,1508,117,51,18175
8/27/2019,17,11064,1564,3982,1459,76,52,18197
8/27/2019,18,11057,1548,3870,1330,41,46,17892
8/27/2019,19,11054,1548,3900,1217,9,37,17765
8/27/2019,20,11052,1593,4264,1113,0,43,18065
8/27/2019,21,11057,1353,3989,1176,0,35,17610
8/27/2019,22,11052,600,3574,1334,0,41,16601
8/27/2019,23,11062,218,3027,1351,0,30,15688
8/27/2019,24,11058,189,2975,1107,0,30,15359
8/28/2019,1,11078,189,3061,928,0,38,15294
8/28/2019,2,11078,190,2922,784,0,44,15018
8/28/2019,3,11067,190,2864,742,0,37,14900
8/28/2019,4,11069,203,2462,870,0,32,14636
8/28/2019,5,11065,234,2324,706,0,38,14367
8/28/2019,6,11068,311,2852,801,1,29,15062
8/28/2019,7,11069,609,3116,735,13,35,15577
8/28/2019,8,11072,913,3378,831,77,44,16315
8/28/2019,9,11058,1279,3504,759,153,43,16796
8/28/2019,10,11049,1447,3495,919,227,37,17174
8/28/2019,11,11041,1513,3320,1508,274,30,17686
8/28/2019,12,10916,1164,3168,2281,300,35,17864
8/28/2019,13,10882,1138,3198,2187,300,32,17737
8/28/2019,14,11026,1154,3210,2536,287,29,18242
8/28/2019,15,11028,1437,3375,2524,253,39,18656
8/28/2019,16,11019,1498,3723,2424,200,42,18906
8/28/2019,17,11018,1405,3857,2493,162,35,18970
8/28/2019,18,11015,1337,3751,2257,74,40,18474
8/28/2019,19,11019,1193,3764,2387,12,46,18421
8/28/2019,20,11022,920,4088,2248,0,43,18321
8/28/2019,21,11019,866,3733,2067,0,35,17720
8/28/2019,22,11018,323,3361,1867,0,50,16619
8/28/2019,23,11025,191,2714,1474,0,32,15436
8/28/2019,24,11033,198,2440,1359,0,29,15059
8/29/2019,1,11037,189,2438,1117,0,25,14806
8/29/2019,2,11039,188,2490,876,0,21,14614
8/29/2019,3,11050,189,2264,855,0,28,14386
8/29/2019,4,11057,189,2209,819,0,27,14301
8/29/2019,5,11063,189,2230,754,1,29,14266
8/29/2019,6,11068,195,2449,809,2,35,14558
8/29/2019,7,11068,206,3204,705,32,48,15263
8/29/2019,8,11075,310,3356,552,121,48,15462
8/29/2019,9,11081,538,3460,556,243,39,15917
8/29/2019,10,11077,755,3323,764,332,37,16288
8/29/2019,11,11078,838,3267,1075,307,39,16604
8/29/2019,12,11075,827,3201,1298,298,38,16737
8/29/2019,13,11065,831,3126,1478,298,34,16832
8/29/2019,14,11056,834,3182,1686,329,31,17118
8/29/2019,15,11061,835,3464,2137,289,36,17822
8/29/2019,16,11050,816,3496,2305,249,40,17956
8/29/2019,17,11051,872,3725,2795,180,36,18659
8/29/2019,18,11049,1009,3908,2953,72,30,19021
8/29/2019,19,11044,617,4122,2781,9,27,18600
8/29/2019,20,11058,510,3965,3101,0,27,18661
8/29/2019,21,11068,389,3340,3203,0,27,18027
8/29/2019,22,11077,231,3137,3189,0,27,17661
8/29/2019,23,11075,190,2555,2840,0,23,16683
8/29/2019,24,11103,191,2385,2165,0,14,15858
8/30/2019,1,11125,194,2364,1854,0,14,15551
8/30/2019,2,11145,194,2379,1902,0,14,15634
8/30/2019,3,11154,195,2424,1673,0,14,15460
8/30/2019,4,11144,195,2579,1559,0,14,15491
8/30/2019,5,11131,195,2679,1063,0,15,15083
8/30/2019,6,11125,196,2874,914,1,21,15131
8/30/2019,7,11141,193,3310,740,26,26,15436
8/30/2019,8,11155,216,3657,761,129,26,15944
8/30/2019,9,11172,298,3464,1046,244,26,16250
8/30/2019,10,11160,267,3293,1362,310,26,16418
8/30/2019,11,11152,283,3112,1656,338,26,16567
8/30/2019,12,11174,423,3341,1745,331,26,17040
8/30/2019,13,11184,606,3305,1683,326,27,17131
8/30/2019,14,11204,822,3165,1422,330,27,16970
8/30/2019,15,11223,840,3750,1238,308,27,17386
8/30/2019,16,11221,867,3947,1095,257,26,17413
8/30/2019,17,11219,1014,4022,918,157,27,17357
8/30/2019,18,11230,1028,4256,623,74,27,17238
8/30/2019,19,11241,1006,4210,475,13,27,16972
8/30/2019,20,11244,1003,4186,546,0,27,17006
8/30/2019,21,11248,858,3623,662,0,27,16418
8/30/2019,22,11245,506,3289,693,0,27,15760
8/30/2019,23,11225,165,2537,651,0,17,14595
8/30/2019,24,11212,120,2420,528,0,5,14285
8/31/2019,1,11207,120,2338,446,0,0,14111
8/31/2019,2,11207,119,2311,546,0,0,14183
8/31/2019,3,11212,119,2341,706,0,0,14378
8/31/2019,4,11227,119,2337,720,0,0,14403
8/31/2019,5,11247,118,2353,739,1,2,14460
8/31/2019,6,11267,118,2374,868,2,0,14629
8/31/2019,7,11275,119,2807,559,32,0,14792
8/31/2019,8,11282,117,3133,362,149,0,15043
8/31/2019,9,11304,120,3235,196,273,0,15128
8/31/2019,10,11319,119,3328,227,370,0,15363
8/31/2019,11,11317,120,3316,235,372,0,15360
8/31/2019,12,11303,119,3343,253,338,0,15356
8/31/2019,13,11301,119,3326,241,368,0,15355
8/31/2019,14,11279,120,3177,190,361,0,15127
8/31/2019,15,11232,120,3232,260,329,0,15173
8/31/2019,16,11240,120,3577,196,237,0,15370
8/31/2019,17,11220,120,3684,207,167,0,15398
8/31/2019,18,11210,120,3778,220,67,0,15395
8/31/2019,19,11214,120,3765,187,8,0,15294
8/31/2019,20,11222,120,4034,257,0,0,15633
8/31/2019,21,11221,119,3622,334,0,0,15296
8/31/2019,22,11209,114,3346,437,0,0,15106
8/31/2019,23,11239,118,2706,420,0,0,14483
8/31/2019,24,11271,119,2526,415,0,0,14331
9/1/2019,1,11283,120,2411,553,0,0,14367
9/1/2019,2,11283,118,2505,532,0,0,14438
9/1/2019,3,11306,115,2398,552,0,0,14371
9/1/2019,4,11324,118,2327,477,0,0,14246
9/1/2019,5,11319,118,2357,313,1,0,14108
9/1/2019,6,11303,120,2368,311,1,0,14103
9/1/2019,7,11298,119,2759,267,23,0,14466
9/1/2019,8,11301,120,2972,405,92,0,14890
9/1/2019,9,11296,119,3235,458,166,0,15274
9/1/2019,10,11281,120,3217,230,213,0,15061
9/1/2019,11,11243,120,3548,170,220,0,15301
9/1/2019,12,11201,122,3537,193,256,0,15309
9/1/2019,13,11177,123,3548,196,226,0,15270
9/1/2019,14,11169,122,3603,220,140,0,15254
9/1/2019,15,11164,122,3591,150,73,1,15101
9/1/2019,16,11152,121,3489,158,78,1,14999
9/1/2019,17,11175,120,3568,193,43,0,15099
9/1/2019,18,11206,120,3766,162,20,0,15274
9/1/2019,19,11233,121,3817,133,4,0,15308
9/1/2019,20,11244,165,4262,130,0,0,15801
9/1/2019,21,11252,120,3772,122,0,0,15266
9/1/2019,22,11218,121,3424,231,0,0,14994
9/1/2019,23,11191,119,2907,330,0,0,14547
9/1/2019,24,11159,120,2763,343,0,0,14385
9/2/2019,1,11116,125,2379,313,0,0,13933
9/2/2019,2,11089,119,2478,382,0,0,14068
9/2/2019,3,11079,119,2305,284,0,0,13787
9/2/2019,4,10860,119,2403,369,0,0,13751
9/2/2019,5,10796,119,2716,347,0,0,13978
9/2/2019,6,10807,120,3001,444,2,0,14374
9/2/2019,7,10826,119,2969,465,4,0,14383
9/2/2019,8,10834,120,3016,420,28,0,14418
9/2/2019,9,11061,169,3259,362,76,0,14927
9/2/2019,10,11133,261,3613,279,120,0,15406
9/2/2019,11,11127,314,3482,358,221,0,15502
9/2/2019,12,11116,297,3225,311,279,0,15228
9/2/2019,13,11101,369,3243,309,291,0,15313
9/2/2019,14,11083,513,3177,418,229,0,15420
9/2/2019,15,11071,525,3298,510,209,0,15613
9/2/2019,16,11061,527,3441,495,163,0,15687
9/2/2019,17,11065,529,3550,809,108,0,16061
9/2/2019,18,11076,528,3735,683,43,0,16065
9/2/2019,19,11081,531,4107,373,8,0,16100
9/2/2019,20,11078,688,4228,275,0,0,16269
9/2/2019,21,11084,454,3981,247,0,0,15766
9/2/2019,22,11029,342,3401,237,0,0,15009
9/2/2019,23,11012,152,3098,236,0,0,14498
9/2/2019,24,11024,119,2917,204,0,0,14264
9/3/2019,1,11037,116,2641,215,0,0,14009
9/3/2019,2,11042,115,2388,255,0,2,13802
9/3/2019,3,11049,115,2364,183,0,11,13722
9/3/2019,4,11051,114,2368,263,0,11,13807
9/3/2019,5,11046,122,2347,325,1,14,13855
9/3/2019,6,11040,148,2582,538,1,21,14330
9/3/2019,7,11034,265,2878,695,31,27,14930
9/3/2019,8,10975,289,3126,738,120,26,15274
9/3/2019,9,10964,464,3569,547,213,24,15781
9/3/2019,10,10963,586,3589,1214,287,27,16666
9/3/2019,11,10956,700,3398,1633,317,27,17031
9/3/2019,12,10948,842,3355,1661,265,27,17098
9/3/2019,13,10939,904,3510,1876,216,27,17472
9/3/2019,14,10673,1038,3117,2112,254,27,17221
9/3/2019,15,10664,1052,3050,1996,240,27,17029
9/3/2019,16,10665,1087,3209,2155,144,27,17287
9/3/2019,17,10663,1203,3255,2601,84,27,17833
9/3/2019,18,10659,1203,3486,2626,29,27,18030
9/3/2019,19,10644,879,3836,2476,6,26,17867
9/3/2019,20,10643,849,3899,2788,0,26,18205
9/3/2019,21,10629,283,3247,3242,0,27,17428
9/3/2019,22,10614,192,2950,3131,0,27,16914
9/3/2019,23,10601,193,2564,2966,0,20,16344
9/3/2019,24,10605,190,2621,1911,0,13,15340
9/4/2019,1,10604,186,2313,2146,0,11,15260
9/4/2019,2,10604,186,2302,2254,0,11,15357
9/4/2019,3,10601,192,2392,2276,0,11,15472
9/4/2019,4,10598,187,2293,2481,0,12,15571
9/4/2019,5,10606,184,2266,2194,0,13,15263
9/4/2019,6,10614,199,2390,2448,2,23,15676
9/4/2019,7,10619,208,3144,2222,9,27,16229
9/4/2019,8,10641,218,3089,2396,99,27,16470
9/4/2019,9,10655,274,3417,2374,210,27,16957
9/4/2019,10,10516,280,3364,2142,248,30,16580
9/4/2019,11,10526,378,3278,2104,271,30,16587
9/4/2019,12,10626,579,3121,1838,269,30,16463
9/4/2019,13,10712,1002,3387,1736,230,27,17094
9/4/2019,14,10718,1173,3193,1468,269,27,16848
9/4/2019,15,10717,1306,3180,1184,282,27,16696
9/4/2019,16,10720,1307,3321,921,220,27,16516
9/4/2019,17,10726,1186,3419,886,131,27,16375
9/4/2019,18,10730,1029,3843,772,58,27,16459
9/4/2019,19,10741,1378,4141,446,7,27,16740
9/4/2019,20,10740,1594,4136,316,0,27,16813
9/4/2019,21,10749,1082,3946,366,0,27,16170
9/4/2019,22,10747,448,3402,391,0,27,15015
9/4/2019,23,10750,368,2801,298,0,18,14235
9/4/2019,24,10744,191,2639,260,0,13,13847
9/5/2019,1,10741,184,2573,224,0,13,13735
9/5/2019,2,10741,154,2379,214,0,13,13501
9/5/2019,3,10738,154,2313,185,0,12,13402
9/5/2019,4,10726,240,2543,169,0,15,13693
9/5/2019,5,10712,275,2659,165,0,15,13826
9/5/2019,6,10722,519,2801,194,1,21,14258
9/5/2019,7,10733,752,2943,227,31,27,14713
9/5/2019,8,10745,946,3060,216,133,27,15127
9/5/2019,9,10761,1031,3288,110,254,27,15471
9/5/2019,10,10779,1229,3502,88,315,27,15940
9/5/2019,11,10784,1487,3366,45,345,27,16054
9/5/2019,12,10653,1621,3107,40,369,27,15817
9/5/2019,13,10745,1435,2930,55,341,29,15535
9/5/2019,14,10774,1412,3003,86,311,28,15614
9/5/2019,15,10714,1324,3182,126,346,27,15719
9/5/2019,16,10732,1446,3658,85,288,27,16236
9/5/2019,17,10717,2128,3840,50,185,27,16947
9/5/2019,18,10716,2003,3827,46,75,27,16694
9/5/2019,19,10716,2004,4177,60,8,27,16992
9/5/2019,20,10722,2039,4056,47,0,27,16891
9/5/2019,21,10732,1880,3672,32,0,27,16343
9/5/2019,22,10725,719,3575,20,0,27,15066
9/5/2019,23,10737,507,3128,19,0,15,14406
9/5/2019,24,10761,487,2744,68,0,13,14073
9/6/2019,1,10782,486,2730,148,0,13,14159
9/6/2019,2,10780,327,2833,146,0,13,14099
9/6/2019,3,10767,332,2745,113,0,12,13969
9/6/2019,4,10751,346,2769,135,0,13,14014
9/6/2019,5,10775,380,2971,179,0,13,14318
9/6/2019,6,10781,631,3039,242,2,17,14712
9/6/2019,7,10763,1012,2990,314,25,26,15130
9/6/2019,8,10747,1124,2988,210,110,26,15205
9/6/2019,9,10741,1227,3155,139,220,27,15509
9/6/2019,10,10727,1280,3495,81,285,27,15895
9/6/2019,11,10712,1566,3431,81,247,27,16064
9/6/2019,12,10700,1727,3338,92,222,27,16106
9/6/2019,13,10695,1636,3320,106,228,27,16012
9/6/2019,14,10696,1424,3306,88,209,27,15750
9/6/2019,15,10718,1274,3472,84,163,27,15738
9/6/2019,16,10731,1438,3661,86,121,27,16064
9/6/2019,17,10728,1251,3983,135,86,27,16210
9/6/2019,18,10729,1162,3974,119,23,27,16034
9/6/2019,19,10730,1004,4207,101,1,27,16070
9/6/2019,20,10722,845,4172,123,0,27,15889
9/6/2019,21,10715,849,3890,113,0,27,15594
9/6/2019,22,10708,549,3506,133,0,27,14923
9/6/2019,23,10703,144,2999,148,0,23,14017
9/6/2019,24,10694,109,2579,143,0,11,13536
9/7/2019,1,10684,107,2469,137,0,0,13397
9/7/2019,2,10677,108,2422,105,0,0,13312
9/7/2019,3,10669,107,2478,143,0,0,13397
9/7/2019,4,10668,109,2393,130,0,0,13300
9/7/2019,5,10668,108,2374,159,0,0,13309
9/7/2019,6,10684,109,2414,144,1,0,13352
9/7/2019,7,10709,106,2699,233,14,0,13761
9/7/2019,8,10712,106,2864,234,50,0,13966
9/7/2019,9,10707,107,3103,399,144,0,14460
9/7/2019,10,10701,107,3142,532,189,0,14671
9/7/2019,11,10698,108,3053,802,267,0,14928
9/7/2019,12,10686,110,3048,832,209,0,14885
9/7/2019,13,10665,111,3044,824,236,0,14880
9/7/2019,14,10654,110,3115,903,292,0,15074
9/7/2019,15,10642,113,3061,821,243,0,14880
9/7/2019,16,10630,113,3470,785,179,0,15177
9/7/2019,17,10617,114,4001,738,103,0,15573
9/7/2019,18,10618,126,4022,644,40,0,15450
9/7/2019,19,10618,110,4014,588,6,0,15336
9/7/2019,20,10627,116,3914,732,0,0,15389
9/7/2019,21,10633,117,3633,859,0,0,15242
9/7/2019,22,10638,114,3604,852,0,0,15208
9/7/2019,23,10654,114,2867,856,0,0,14491
9/7/2019,24,10664,109,2396,594,0,0,13763
9/8/2019,1,10679,109,2364,339,0,0,13491
9/8/2019,2,10491,109,2352,358,0,0,13310
9/8/2019,3,10088,108,2495,549,0,0,13240
9/8/2019,4,10079,107,2553,498,0,0,13237
9/8/2019,5,10089,110,2888,436,0,0,13523
9/8/2019,6,10105,125,2964,456,2,0,13652
9/8/2019,7,10094,118,3008,473,23,0,13716
9/8/2019,8,10061,123,3109,407,112,0,13812
9/8/2019,9,10061,155,3217,399,223,0,14055
9/8/2019,10,10067,211,3438,428,260,0,14404
9/8/2019,11,10085,209,3713,388,246,0,14641
9/8/2019,12,10355,206,3596,404,223,0,14784
9/8/2019,13,10382,202,3617,386,269,0,14856
9/8/2019,14,10385,118,3542,454,198,0,14697
9/8/2019,15,10608,112,3304,526,151,0,14701
9/8/2019,16,10682,113,3515,426,119,0,14855
9/8/2019,17,10690,111,3558,601,75,0,15035
9/8/2019,18,10700,115,3546,575,33,0,14969
9/8/2019,19,10708,114,3567,529,5,0,14923
9/8/2019,20,10711,115,3786,688,0,0,15300
9/8/2019,21,10720,114,3219,730,0,0,14783
9/8/2019,22,10724,114,2703,779,0,0,14320
9/8/2019,23,10732,115,2455,652,0,1,13955
9/8/2019,24,10735,115,2383,600,0,0,13833
9/9/2019,1,10725,114,2397,606,0,7,13849
9/9/2019,2,10726,115,2398,412,0,13,13664
9/9/2019,3,10717,132,2408,471,0,14,13742
9/9/2019,4,10704,161,2432,217,0,15,13529
9/9/2019,5,10696,186,2547,274,0,16,13719
9/9/2019,6,10694,217,3001,466,2,21,14401
9/9/2019,7,10691,239,3621,694,19,27,15291
9/9/2019,8,10695,257,3505,552,96,26,15131
9/9/2019,9,10700,336,3417,230,202,26,14911
9/9/2019,10,10695,372,3080,77,281,27,14532
9/9/2019,11,10696,517,3142,55,301,26,14737
9/9/2019,12,10682,839,3181,72,327,27,15128
9/9/2019,13,10685,987,3033,128,322,26,15181
9/9/2019,14,10688,983,3083,129,312,26,15221
9/9/2019,15,10689,1138,3063,74,235,27,15226
9/9/2019,16,10682,1143,3226,156,243,27,15477
9/9/2019,17,10683,1235,3734,180,132,26,15990
9/9/2019,18,10687,1294,3942,198,53,26,16200
9/9/2019,19,10691,1294,4141,256,5,26,16413
9/9/2019,20,10706,1568,3963,331,0,26,16594
9/9/2019,21,10701,1202,3555,484,0,26,15968
9/9/2019,22,10703,532,2944,712,0,26,14917
9/9/2019,23,10710,230,2470,554,0,16,13980
9/9/2019,24,10717,200,2418,487,0,12,13834
9/10/2019,1,10705,219,2416,736,0,12,14088
9/10/2019,2,10718,213,2398,748,0,12,14089
9/10/2019,3,10726,216,2378,790,0,13,14123
9/10/2019,4,10733,226,2441,799,0,13,14212
9/10/2019,5,10730,238,2472,581,0,15,14036
9/10/2019,6,10735,311,2469,848,2,18,14383
9/10/2019,7,10736,624,2890,1671,23,26,15970
9/10/2019,8,10724,935,3072,1622,104,27,16484
9/10/2019,9,10708,1248,3038,1506,150,26,16676
9/10/2019,10,10700,1404,3009,1561,219,26,16919
9/10/2019,11,10687,1199,3136,1222,261,26,16531
9/10/2019,12,10673,1214,3442,1569,247,26,17171
9/10/2019,13,10663,1257,3329,1590,245,27,17111
9/10/2019,14,10657,1318,3061,1495,227,26,16784
9/10/2019,15,10657,1465,3424,1512,151,26,17235
9/10/2019,16,10661,1512,3401,1829,102,26,17531
9/10/2019,17,10666,1546,3313,1995,61,26,17607
9/10/2019,18,10667,1069,3575,2018,28,26,17383
9/10/2019,19,10664,925,3722,2296,3,26,17636
9/10/2019,20,10657,767,3673,2429,0,28,17554
9/10/2019,21,10647,374,3324,2714,0,28,17087
9/10/2019,22,10649,198,2801,2524,0,26,16198
9/10/2019,23,10644,192,2566,2196,0,15,15613
9/10/2019,24,10643,198,2527,1895,0,15,15278
9/11/2019,1,10641,201,2486,1658,0,16,15002
9/11/2019,2,10649,206,2449,1508,0,16,14828
9/11/2019,3,10655,303,2545,1140,0,16,14659
9/11/2019,4,10657,676,2488,987,0,21,14829
9/11/2019,5,10656,1114,2626,642,0,22,15060
9/11/2019,6,10654,1713,3086,746,2,24,16225
9/11/2019,7,10651,2119,3270,644,8,31,16723
9/11/2019,8,10652,2398,3366,371,69,33,16889
9/11/2019,9,10642,2619,3380,162,146,33,16982
9/11/2019,10,10617,2774,3553,129,198,34,17305
9/11/2019,11,10643,2974,3512,136,264,38,17567
9/11/2019,12,10647,3100,3511,192,293,42,17785
9/11/2019,13,10498,3338,3703,269,291,46,18145
9/11/2019,14,10484,3999,3742,326,269,48,18868
9/11/2019,15,10642,3727,3923,472,266,48,19078
9/11/2019,16,10651,4084,4150,511,228,46,19670
9/11/2019,17,10644,4276,4168,680,90,48,19906
9/11/2019,18,10641,3908,4277,742,21,49,19638
9/11/2019,19,10657,3735,4360,658,1,51,19462
9/11/2019,20,10658,3316,4357,866,0,48,19245
9/11/2019,21,10657,3227,3989,650,0,50,18573
9/11/2019,22,10655,2442,3513,761,0,45,17416
9/11/2019,23,10658,843,3505,796,0,40,15842
9/11/2019,24,10657,263,3155,744,0,40,14859
9/12/2019,1,10660,195,2526,730,0,37,14148
9/12/2019,2,10664,196,2478,844,0,36,14218
9/12/2019,3,10659,202,2407,876,0,37,14181
9/12/2019,4,10694,294,2421,716,0,40,14165
9/12/2019,5,10696,485,2501,405,0,40,14127
9/12/2019,6,10686,801,2795,1121,2,47,15452
9/12/2019,7,10677,1050,3159,1140,6,52,16084
9/12/2019,8,10679,1047,3086,1202,28,51,16093
9/12/2019,9,10673,1059,3056,934,92,53,15867
9/12/2019,10,10678,1059,3133,706,199,58,15833
9/12/2019,11,10674,899,3031,710,244,53,15611
9/12/2019,12,10661,862,3063,908,270,53,15817
9/12/2019,13,10658,855,2939,972,285,54,15763
9/12/2019,14,10656,864,2901,950,280,53,15704
9/12/2019,15,10648,364,3319,1075,273,56,15735
9/12/2019,16,10644,251,3659,1108,235,53,15950
9/12/2019,17,10641,399,3903,1182,160,61,16346
9/12/2019,18,10639,394,3909,1183,54,63,16242
9/12/2019,19,10639,390,4010,1333,3,65,16440
9/12/2019,20,10649,392,3939,1597,0,69,16646
9/12/2019,21,10650,233,3576,1647,0,59,16165
9/12/2019,22,10658,197,3090,1763,0,60,15768
9/12/2019,23,10660,198,2563,1431,0,58,14910
9/12/2019,24,10672,198,2524,1171,0,58,14623
9/13/2019,1,10674,197,2365,996,0,57,14289
9/13/2019,2,10676,197,2372,785,0,57,14087
9/13/2019,3,10672,197,2397,598,0,57,13921
9/13/2019,4,10659,196,2373,923,0,57,14208
9/13/2019,5,10668,197,2446,1115,0,56,14482
9/13/2019,6,10670,198,2650,1534,2,60,15114
9/13/2019,7,10645,199,2908,2131,20,63,15966
9/13/2019,8,10628,197,2957,2327,90,67,16266
9/13/2019,9,10631,198,2941,2556,181,61,16568
9/13/2019,10,10624,202,3092,2487,248,63,16716
9/13/2019,11,10613,198,3099,2384,269,65,16628
9/13/2019,12,10603,205,3509,2274,257,65,16913
9/13/2019,13,10598,204,3388,2453,261,65,16969
9/13/2019,14,10595,205,3311,2603,209,65,16988
9/13/2019,15,10595,205,3253,2851,172,62,17138
9/13/2019,16,10588,202,3449,2955,95,67,17356
9/13/2019,17,10594,207,3532,3078,68,68,17547
9/13/2019,18,10593,207,3734,3054,23,68,17679
9/13/2019,19,10580,203,3489,3519,1,67,17859
9/13/2019,20,10580,203,3371,3322,0,68,17544
9/13/2019,21,10566,204,3172,3245,0,60,17247
9/13/2019,22,10556,206,3236,2878,0,68,16944
9/13/2019,23,10551,133,2621,2742,0,56,16103
9/13/2019,24,10562,128,2496,2447,0,44,15677
9/14/2019,1,10573,123,2534,2054,0,44,15328
9/14/2019,2,10562,116,2592,1599,0,45,14914
9/14/2019,3,10555,115,2591,1329,0,44,14634
9/14/2019,4,10565,103,2532,1198,0,45,14443
9/14/2019,5,10562,102,2531,1226,0,44,14465
9/14/2019,6,10566,106,2549,1503,1,45,14770
9/14/2019,7,10565,106,2792,1241,9,44,14757
9/14/2019,8,10565,105,2815,1946,66,44,15541
9/14/2019,9,10563,107,2862,2422,149,39,16142
9/14/2019,10,10559,106,2934,2467,243,41,16350
9/14/2019,11,10555,106,2943,2341,261,40,16246
9/14/2019,12,10551,106,2970,2143,281,32,16083
9/14/2019,13,10540,107,3093,1745,297,30,15812
9/14/2019,14,10535,106,3078,1844,292,30,15885
9/14/2019,15,10537,106,3402,1592,283,32,15952
9/14/2019,16,10539,106,3574,1913,253,41,16426
9/14/2019,17,10550,107,3772,1797,153,46,16425
9/14/2019,18,10565,122,4168,1432,47,45,16379
9/14/2019,19,10565,188,4139,1292,4,45,16233
9/14/2019,20,10567,129,3964,1298,0,43,16001
9/14/2019,21,10592,108,3733,1199,0,40,15672
9/14/2019,22,10602,108,3750,999,0,44,15503
9/14/2019,23,10605,108,3239,846,0,43,14841
9/14/2019,24,10610,108,2638,702,0,45,14103
9/15/2019,1,10591,110,2544,591,0,44,13880
9/15/2019,2,10594,107,2428,361,0,44,13534
9/15/2019,3,10590,108,2444,250,0,44,13436
9/15/2019,4,10353,107,2469,214,0,43,13186
9/15/2019,5,10318,106,2569,159,0,43,13195
9/15/2019,6,10322,117,2755,183,2,43,13422
9/15/2019,7,10541,116,2893,107,18,43,13718
9/15/2019,8,10613,113,3129,258,106,45,14264
9/15/2019,9,10606,118,3434,392,190,38,14778
9/15/2019,10,10607,177,3838,432,219,35,15308
9/15/2019,11,10607,395,3901,304,170,42,15419
9/15/2019,12,10602,377,3520,337,151,44,15031
9/15/2019,13,10602,320,3404,330,200,44,14900
9/15/2019,14,10602,280,3683,457,147,45,15214
9/15/2019,15,10566,207,3522,652,139,44,15130
9/15/2019,16,10593,183,3428,580,127,44,14955
9/15/2019,17,10593,381,3834,319,85,44,15256
9/15/2019,18,10593,473,3866,305,27,45,15309
9/15/2019,19,10594,538,4174,158,0,45,15509
9/15/2019,20,10587,535,3943,142,0,45,15252
9/15/2019,21,10585,419,3697,156,0,39,14896
9/15/2019,22,10573,167,3505,144,0,44,14433
9/15/2019,23,10569,121,2977,166,0,45,13878
9/15/2019,24,10570,118,2732,154,0,45,13619
9/16/2019,1,10567,126,2598,106,0,45,13442
9/16/2019,2,10442,163,2550,124,0,47,13326
9/16/2019,3,10283,201,2920,142,0,57,13603
9/16/2019,4,10290,281,2924,154,0,56,13705
9/16/2019,5,10551,347,2757,160,0,59,13874
9/16/2019,6,10598,515,3011,184,1,65,14374
9/16/2019,7,10598,619,3372,180,16,73,14858
9/16/2019,8,10595,714,3188,143,84,71,14795
9/16/2019,9,10592,939,3300,72,170,65,15138
9/16/2019,10,10580,1209,3193,40,245,67,15334
9/16/2019,11,10592,1281,3205,19,274,73,15444
9/16/2019,12,10589,1114,3222,22,305,71,15323
9/16/2019,13,10581,1109,3173,50,347,71,15331
9/16/2019,14,10583,1240,3196,34,168,69,15290
9/16/2019,15,10587,1392,3226,61,314,71,15651
9/16/2019,16,10588,1398,3347,172,230,71,15806
9/16/2019,17,10587,1492,3823,218,116,72,16308
9/16/2019,18,10590,1640,3822,266,34,70,16422
9/16/2019,19,10580,1584,3865,385,0,70,16484
9/16/2019,20,10581,1654,3900,606,0,71,16812
9/16/2019,21,10572,1156,3627,520,0,62,15937
9/16/2019,22,10571,387,3387,378,0,71,14794
9/16/2019,23,10574,197,2805,244,0,64,13884
9/16/2019,24,10573,198,2680,155,0,58,13664
9/17/2019,1,10580,199,2584,229,0,53,13645
9/17/2019,2,10579,200,2567,250,0,51,13647
9/17/2019,3,10583,229,2522,211,0,54,13599
9/17/2019,4,10588,330,2537,230,0,56,13741
9/17/2019,5,10586,497,2766,131,0,60,14040
9/17/2019,6,10580,781,3189,343,2,68,14963
9/17/2019,7,10552,1165,2990,399,23,68,15197
9/17/2019,8,10521,946,3198,171,129,69,15034
9/17/2019,9,10525,985,3524,143,257,58,15492
9/17/2019,10,10524,1094,3200,128,351,63,15360
9/17/2019,11,10515,1214,3205,149,394,68,15545
9/17/2019,12,10521,1082,3408,158,413,69,15651
9/17/2019,13,10524,1371,3310,176,408,68,15857
9/17/2019,14,10564,1431,3710,166,388,67,16326
9/17/2019,15,10556,1358,3808,92,281,66,16161
9/17/2019,16,10550,1466,4027,187,264,67,16561
9/17/2019,17,10550,1711,4122,221,158,67,16829
9/17/2019,18,10559,1735,3937,189,46,67,16533
9/17/2019,19,10568,1627,3847,210,1,66,16319
9/17/2019,20,10569,1546,3810,308,0,67,16300
9/17/2019,21,10597,1092,3443,318,0,66,15516
9/17/2019,22,10589,422,3145,390,0,62,14608
9/17/2019,23,10593,196,2879,328,0,60,14056
9/17/2019,24,10599,191,2668,299,0,58,13815
9/18/2019,1,10605,194,2584,434,0,53,13870
9/18/2019,2,10618,196,2573,532,0,53,13972
9/18/2019,3,10623,214,2585,387,0,54,13863
9/18/2019,4,10615,299,2730,400,0,53,14097
9/18/2019,5,10614,579,2629,616,0,55,14493
9/18/2019,6,10613,992,2574,797,1,58,15035
9/18/2019,7,10613,1170,2704,1145,19,64,15715
9/18/2019,8,10626,1306,3141,745,122,57,15997
9/18/2019,9,10618,1325,3482,587,247,31,16290
9/18/2019,10,10615,1249,3398,861,344,53,16520
9/18/2019,11,10623,1193,3353,726,390,66,16351
9/18/2019,12,10542,1395,3096,811,399,50,16293
9/18/2019,13,10502,1538,3101,851,393,49,16434
9/18/2019,14,10502,1618,3078,855,389,59,16501
9/18/2019,15,10538,1389,3338,746,352,61,16424
9/18/2019,16,10637,1307,3952,752,268,58,16974
9/18/2019,17,10650,1723,4018,813,153,60,17417
9/18/2019,18,10657,1378,3986,781,42,61,16905
9/18/2019,19,10659,1210,3856,1111,1,64,16901
9/18/2019,20,10672,1201,3353,1530,0,52,16808
9/18/2019,21,10647,1038,3160,1654,0,50,16549
9/18/2019,22,10620,669,2848,1700,0,45,15882
9/18/2019,23,10625,293,2787,1287,0,49,15041
9/18/2019,24,10626,192,2858,1132,0,49,14857
9/19/2019,1,10618,191,2677,836,0,49,14371
9/19/2019,2,10616,190,2660,449,0,51,13966
9/19/2019,3,10408,197,2728,682,0,54,14069
9/19/2019,4,10326,194,2744,743,0,54,14061
9/19/2019,5,10332,283,2878,672,0,55,14220
9/19/2019,6,10548,309,2876,1280,2,54,15069
9/19/2019,7,10613,529,3095,1749,19,61,16066
9/19/2019,8,10611,904,3425,1474,127,60,16601
9/19/2019,9,10610,1086,3579,1113,253,61,16702
9/19/2019,10,10616,1216,3586,1089,333,51,16891
9/19/2019,11,10612,1207,3520,953,383,50,16725
9/19/2019,12,10605,1315,3619,777,388,50,16754
9/19/2019,13,10600,1498,3573,651,388,51,16761
9/19/2019,14,10596,1742,3510,634,376,51,16909
9/19/2019,15,10596,1749,3348,673,366,53,16785
9/19/2019,16,10596,1719,3576,580,258,52,16781
9/19/2019,17,10594,1897,3849,587,145,53,17125
9/19/2019,18,10595,1773,3957,645,38,45,17053
9/19/2019,19,10595,1758,4234,801,1,43,17432
9/19/2019,20,10594,1346,3977,1216,0,48,17181
9/19/2019,21,10589,718,4049,1340,0,49,16745
9/19/2019,22,10589,275,3282,1452,0,56,15654
9/19/2019,23,10590,191,2846,1409,0,53,15089
9/19/2019,24,10597,191,2833,1032,0,49,14702
9/20/2019,1,10601,200,2852,669,0,50,14372
9/20/2019,2,10611,206,2727,559,0,50,14153
9/20/2019,3,10615,302,2708,375,0,51,14051
9/20/2019,4,10395,553,2728,436,0,54,14166
9/20/2019,5,10319,840,2805,339,0,53,14356
9/20/2019,6,10544,1069,2876,656,2,55,15202
9/20/2019,7,10610,1101,3170,672,15,65,15633
9/20/2019,8,10616,1394,3528,512,91,67,16208
9/20/2019,9,10612,1733,3527,274,212,66,16424
9/20/2019,10,10598,2025,3557,121,324,66,16691
9/20/2019,11,10552,2085,3334,86,362,66,16485
9/20/2019,12,10570,2215,3349,132,387,70,16723
9/20/2019,13,10599,2239,3704,133,385,70,17130
9/20/2019,14,10595,2389,3927,185,365,69,17530
9/20/2019,15,10592,2506,3928,229,312,68,17635
9/20/2019,16,10596,2686,4050,220,248,69,17869
9/20/2019,17,10595,2998,4271,168,117,69,18218
9/20/2019,18,10593,2786,4314,128,35,67,17923
9/20/2019,19,10594,2631,4428,167,1,67,17888
9/20/2019,20,10579,2714,4135,227,0,67,17722
9/20/2019,21,10589,1972,3934,317,0,57,16869
9/20/2019,22,10600,1470,3505,327,0,59,15961
9/20/2019,23,10605,542,3071,416,0,45,14679
9/20/2019,24,10609,273,2893,459,0,41,14275
9/21/2019,1,10597,203,2748,424,0,41,14013
9/21/2019,2,10585,203,2768,440,0,40,14036
9/21/2019,3,10591,208,2766,412,0,45,14022
9/21/2019,4,10589,217,2739,327,0,44,13916
9/21/2019,5,10602,285,2776,227,0,41,13931
9/21/2019,6,10611,519,2820,261,1,43,14255
9/21/2019,7,10611,762,2991,210,14,43,14631
9/21/2019,8,10603,855,3098,202,99,35,14892
9/21/2019,9,10597,911,3355,178,204,28,15273
9/21/2019,10,10582,1419,3690,147,303,32,16173
9/21/2019,11,10588,1634,3602,213,383,21,16441
9/21/2019,12,10602,1779,3596,428,409,10,16824
9/21/2019,13,10604,1957,3842,610,395,15,17423
9/21/2019,14,10599,1891,3612,773,374,15,17264
9/21/2019,15,10586,1914,3856,897,345,15,17613
9/21/2019,16,10580,2164,4065,938,267,15,18029
9/21/2019,17,10592,2625,4114,932,143,16,18422
9/21/2019,18,10593,2639,4209,995,35,24,18495
9/21/2019,19,10592,2038,4167,1147,0,24,17968
9/21/2019,20,10588,1794,3796,1336,0,23,17537
9/21/2019,21,10584,1365,3743,1369,0,18,17079
9/21/2019,22,10581,388,3390,1518,0,22,15899
9/21/2019,23,10589,201,2914,1576,0,26,15306
9/21/2019,24,10587,199,2785,1298,0,24,14893
9/22/2019,1,10589,200,2772,1379,0,24,14964
9/22/2019,2,10596,200,2750,1282,0,23,14851
9/22/2019,3,10593,199,2608,1129,0,21,14550
9/22/2019,4,10592,200,2711,960,0,20,14483
9/22/2019,5,10592,201,2753,1051,1,0,14598
9/22/2019,6,10587,204,2704,1477,2,0,14974
9/22/2019,7,10582,289,2951,746,7,0,14575
9/22/2019,8,10588,449,3037,1785,36,0,15895
9/22/2019,9,10580,613,2933,2226,156,0,16508
9/22/2019,10,10581,886,2953,2337,211,0,16968
9/22/2019,11,10577,1009,3041,2914,251,0,17792
9/22/2019,12,10574,1045,3142,3259,313,0,18333
9/22/2019,13,10574,1059,3349,3272,318,0,18572
9/22/2019,14,10511,1022,3394,3464,333,0,18724
9/22/2019,15,10571,1008,3635,3597,298,1,19110
9/22/2019,16,10566,1020,4095,3570,198,0,19449
9/22/2019,17,10563,1237,4566,3384,90,2,19842
9/22/2019,18,10556,1183,4332,3127,19,0,19217
9/22/2019,19,10555,1027,4518,3008,0,1,19109
9/22/2019,20,10558,1100,4457,2933,0,1,19049
9/22/2019,21,10562,865,4065,3094,0,0,18586
9/22/2019,22,10563,283,3625,2940,0,0,17411
9/22/2019,23,10573,184,3018,3013,0,0,16788
9/22/2019,24,10567,187,2779,2527,0,1,16061
9/23/2019,1,10567,186,2669,2297,0,10,15729
9/23/2019,2,10569,188,2648,1513,0,15,14933
9/23/2019,3,10584,196,2598,1920,0,14,15312
9/23/2019,4,10589,335,2666,1779,0,14,15383
9/23/2019,5,10586,823,2813,1437,0,14,15673
9/23/2019,6,10591,1113,3020,1805,2,17,16548
9/23/2019,7,10578,1496,3562,1690,2,27,17355
9/23/2019,8,10568,2031,3745,1471,27,28,17870
9/23/2019,9,10573,2455,3814,1372,73,30,18317
9/23/2019,10,10590,2322,3891,1464,118,33,18418
9/23/2019,11,10586,2475,3868,1621,160,32,18742
9/23/2019,12,10584,2279,3854,1746,160,33,18656
9/23/2019,13,10593,2109,3793,1970,210,33,18708
9/23/2019,14,10587,2017,3667,2449,167,33,18920
9/23/2019,15,10604,1878,3743,2392,180,33,18830
9/23/2019,16,10619,1825,3817,2581,146,35,19023
9/23/2019,17,10627,1820,3855,2750,124,37,19213
9/23/2019,18,10620,1646,3843,2689,31,33,18862
9/23/2019,19,10627,1593,4127,2477,0,33,18857
9/23/2019,20,10624,1502,4217,2270,0,33,18646
9/23/2019,21,10622,895,3997,2241,0,30,17785
9/23/2019,22,10617,266,3351,2286,0,32,16552
9/23/2019,23,10616,196,3101,1738,0,22,15673
9/23/2019,24,10618,194,2760,1672,0,19,15263
9/24/2019,1,10619,186,2721,1539,0,19,15084
9/24/2019,2,10615,171,2774,1335,0,18,14913
9/24/2019,3,10617,261,2596,1205,0,17,14696
9/24/2019,4,10620,518,2644,802,0,20,14604
9/24/2019,5,10624,942,2671,381,0,20,14638
9/24/2019,6,10626,1185,2941,374,2,27,15155
9/24/2019,7,10632,1220,3403,403,13,33,15704
9/24/2019,8,10644,1215,3637,341,104,32,15973
9/24/2019,9,10659,1265,3604,291,241,34,16094
9/24/2019,10,10677,1406,3463,339,326,35,16246
9/24/2019,11,10685,1423,3482,418,328,33,16369
9/24/2019,12,10682,1432,3556,463,295,33,16461
9/24/2019,13,10671,1648,3629,554,286,38,16826
9/24/2019,14,10668,1731,3447,665,292,39,16842
9/24/2019,15,10668,1876,3756,443,278,55,17076
9/24/2019,16,10667,1474,3733,748,204,65,16891
9/24/2019,17,10658,1395,4113,786,116,65,17133
9/24/2019,18,10650,1458,4369,608,32,66,17183
9/24/2019,19,10643,1803,4412,493,0,67,17418
9/24/2019,20,10641,1734,4234,586,0,68,17263
9/24/2019,21,10635,1258,4111,695,0,65,16764
9/24/2019,22,10627,545,3432,921,0,68,15593
9/24/2019,23,10660,226,2798,934,0,56,14674
9/24/2019,24,10679,190,2776,672,0,52,14369
9/25/2019,1,10685,195,2753,910,0,50,14593
9/25/2019,2,10707,194,2691,798,0,50,14440
9/25/2019,3,10738,193,2665,604,0,53,14253
9/25/2019,4,10749,192,2675,657,0,51,14324
9/25/2019,5,10773,192,2780,989,0,54,14788
9/25/2019,6,10780,192,2883,1432,1,66,15354
9/25/2019,7,10780,197,3229,2255,14,37,16512
9/25/2019,8,10772,199,3292,2243,107,30,16643
9/25/2019,9,10764,263,3318,2362,201,58,16966
9/25/2019,10,10761,287,3266,2512,304,65,17195
9/25/2019,11,10755,476,3282,2839,279,65,17696
9/25/2019,12,10622,759,3286,2856,307,64,17894
9/25/2019,13,10608,859,3234,3033,303,64,18101
9/25/2019,14,10728,869,3318,3027,293,65,18300
9/25/2019,15,10720,1008,3380,3038,213,65,18424
9/25/2019,16,10710,1011,3544,3165,185,65,18680
9/25/2019,17,10697,1007,3598,3213,99,64,18678
9/25/2019,18,10691,1009,3763,2844,15,65,18387
9/25/2019,19,10693,1013,3958,2815,0,66,18545
9/25/2019,20,10706,1001,4167,2640,0,65,18579
9/25/2019,21,10746,368,4162,2556,0,59,17891
9/25/2019,22,10761,196,3559,2473,0,61,17050
9/25/2019,23,10780,197,3116,1977,0,54,16124
9/25/2019,24,10786,198,3137,1669,0,52,15842
9/26/2019,1,10792,197,2717,1218,0,50,14974
9/26/2019,2,10799,196,2739,1295,0,48,15077
9/26/2019,3,10806,197,2743,1146,0,48,14940
9/26/2019,4,10813,199,2991,926,0,47,14976
9/26/2019,5,10813,213,2979,809,0,49,14863
9/26/2019,6,10813,250,3288,957,0,57,15365
9/26/2019,7,10807,333,4045,1271,2,60,16518
9/26/2019,8,10788,475,4035,1735,12,58,17103
9/26/2019,9,10772,462,4255,1739,59,61,17348
9/26/2019,10,10716,485,3720,2243,116,67,17347
9/26/2019,11,10710,411,3324,2650,190,68,17353
9/26/2019,12,10730,409,3243,2735,267,64,17448
9/26/2019,13,10751,409,3198,2441,336,65,17200
9/26/2019,14,10765,411,3243,2242,300,66,17027
9/26/2019,15,10760,416,3302,2245,227,65,17015
9/26/2019,16,10770,417,3730,2233,242,68,17460
9/26/2019,17,10773,477,4453,2045,154,68,17970
9/26/2019,18,10774,758,4956,1146,35,68,17737
9/26/2019,19,10775,1068,5020,628,0,69,17560
9/26/2019,20,10772,895,4648,537,0,74,16926
9/26/2019,21,10775,746,4432,415,0,58,16426
9/26/2019,22,10779,251,4149,406,0,58,15643
9/26/2019,23,10782,199,3545,424,0,49,14999
9/26/2019,24,10785,199,3021,384,0,40,14429
9/27/2019,1,10791,202,2717,355,0,38,14103
9/27/2019,2,10798,201,2722,269,0,39,14029
9/27/2019,3,10800,239,2702,296,0,38,14075
9/27/2019,4,10795,282,2715,309,0,40,14141
9/27/2019,5,10838,379,2770,277,0,42,14306
9/27/2019,6,10845,554,3301,416,0,48,15164
9/27/2019,7,10839,676,3752,1016,14,54,16351
9/27/2019,8,10836,608,3448,1453,83,55,16483
9/27/2019,9,10841,606,3415,1345,185,56,16448
9/27/2019,10,10847,606,3478,1375,290,58,16654
9/27/2019,11,10853,605,3522,1638,323,55,16996
9/27/2019,12,10854,608,3297,1869,348,55,17031
9/27/2019,13,10858,608,3254,2133,359,51,17263
9/27/2019,14,10852,608,3231,2201,347,48,17287
9/27/2019,15,10850,607,3425,2117,271,50,17320
9/27/2019,16,10842,611,3944,2006,168,52,17623
9/27/2019,17,10826,607,4083,2097,60,54,17727
9/27/2019,18,10824,606,3830,2540,12,53,17865
9/27/2019,19,10825,606,3611,2819,0,34,17895
9/27/2019,20,10820,605,3739,2646,0,36,17846
9/27/2019,21,10796,608,3473,2367,0,46,17290
9/27/2019,22,10752,603,3091,2339,0,43,16828
9/27/2019,23,10760,215,2935,1792,0,43,15745
9/27/2019,24,10759,113,2905,1054,0,33,14864
9/28/2019,1,10774,112,2559,1037,0,22,14504
9/28/2019,2,10773,111,2543,911,0,22,14360
9/28/2019,3,10773,112,2524,848,0,21,14278
9/28/2019,4,10780,112,2505,787,0,24,14208
9/28/2019,5,10787,111,2505,978,0,28,14409
9/28/2019,6,10785,124,2654,1248,0,28,14839
9/28/2019,7,10783,126,3133,920,2,27,14991
9/28/2019,8,10781,305,3442,1005,18,24,15575
9/28/2019,9,10781,434,3815,1142,41,22,16235
9/28/2019,10,10756,447,4034,1184,105,29,16555
9/28/2019,11,10747,506,3961,1118,169,28,16529
9/28/2019,12,10743,616,3829,1059,170,29,16446
9/28/2019,13,10738,807,4108,1117,131,30,16931
9/28/2019,14,10737,976,3903,986,89,27,16718
9/28/2019,15,10699,1139,3752,1133,65,26,16814
9/28/2019,16,10742,1152,3599,1203,70,29,16795
9/28/2019,17,10766,1150,3598,1338,37,27,16916
9/28/2019,18,10771,1149,3688,1230,8,29,16875
9/28/2019,19,10773,816,3962,1227,0,30,16808
9/28/2019,20,10777,727,3977,1273,0,30,16784
9/28/2019,21,10763,727,3213,1184,0,31,15918
9/28/2019,22,10756,561,3105,780,0,31,15233
9/28/2019,23,10787,344,2918,567,0,31,14647
9/28/2019,24,10781,130,2595,619,0,30,14155
9/29/2019,1,10784,104,2469,637,0,30,14024
9/29/2019,2,10783,104,2476,445,0,29,13837
9/29/2019,3,10561,105,2509,509,0,29,13713
9/29/2019,4,10257,102,2464,412,0,31,13266
9/29/2019,5,10173,105,2582,719,0,31,13610
9/29/2019,6,10164,104,2709,937,0,31,13945
9/29/2019,7,10285,103,2801,889,12,31,14121
9/29/2019,8,10458,108,2854,997,101,29,14547
9/29/2019,9,10627,105,2858,1014,175,32,14811
9/29/2019,10,10760,179,2852,949,271,30,15041
9/29/2019,11,10758,269,3139,701,280,30,15177
9/29/2019,12,10760,281,3195,589,264,30,15119
9/29/2019,13,10756,300,3243,699,291,31,15320
9/29/2019,14,10759,301,3306,711,254,32,15363
9/29/2019,15,10752,302,3522,783,215,33,15607
9/29/2019,16,10743,304,3564,1116,146,33,15906
9/29/2019,17,10722,301,3931,1496,39,35,16524
9/29/2019,18,10716,302,3816,1701,11,33,16579
9/29/2019,19,10705,313,4358,1413,0,35,16824
9/29/2019,20,10702,352,4319,1491,0,32,16896
9/29/2019,21,10710,162,3729,1599,0,30,16230
9/29/2019,22,10713,106,3171,1400,0,32,15422
9/29/2019,23,10719,105,2639,1446,0,32,14941
9/29/2019,24,10727,105,2557,822,0,36,14247
9/30/2019,1,10725,106,2499,493,0,46,13869
9/30/2019,2,10464,126,2524,528,0,47,13689
9/30/2019,3,10435,130,2533,495,0,47,13640
9/30/2019,4,10208,150,2741,603,0,47,13749
9/30/2019,5,10216,185,2866,928,0,50,14245
9/30/2019,6,10711,354,3024,949,2,54,15094
9/30/2019,7,10724,868,3477,1110,5,57,16241
9/30/2019,8,10721,1226,3549,1297,32,57,16882
9/30/2019,9,10721,1524,3502,980,74,56,16857
9/30/2019,10,10726,1644,3524,586,219,50,16749
9/30/2019,11,10718,1338,3525,380,235,51,16247
9/30/2019,12,10711,1336,3547,278,244,52,16168
9/30/2019,13,10693,1456,3518,382,276,57,16382
9/30/2019,14,10679,1599,3485,448,264,57,16532
9/30/2019,15,10686,1611,3654,442,221,56,16670
9/30/2019,16,10697,1611,3655,610,167,57,16797
9/30/2019,17,10699,1613,4013,816,82,57,17280
9/30/2019,18,10703,1334,4442,772,15,58,17324
9/30/2019,19,10701,1237,4497,1166,0,55,17656
9/30/2019,20,10698,692,4254,1320,0,54,17018
9/30/2019,21,10700,571,3988,1459,0,55,16773
9/30/2019,22,10692,274,3644,1490,0,55,16155
9/30/2019,23,10696,205,3076,1615,0,47,15639
9/30/2019,24,10690,203,2741,996,0,45,14675
10/1/2019,1,10694,203,2727,682,0,43,14349
10/1/2019,2,10693,202,2633,533,0,42,14103
10/1/2019,3,10675,207,2632,356,0,43,13913
10/1/2019,4,10663,209,2620,432,0,43,13967
10/1/2019,5,10646,221,2710,713,0,43,14333
10/1/2019,6,10639,246,2932,1215,1,45,15078
10/1/2019,7,10637,254,3188,2372,1,46,16498
10/1/2019,8,10634,336,3686,2160,49,47,16912
10/1/2019,9,10631,458,4281,1999,132,45,17546
10/1/2019,10,10634,895,4314,1936,226,45,18050
10/1/2019,11,10629,1073,3958,2065,294,47,18066
10/1/2019,12,10622,1238,4104,2115,342,47,18468
10/1/2019,13,10627,1840,4292,1997,297,47,19100
10/1/2019,14,10622,1755,4261,2157,200,47,19042
10/1/2019,15,10618,1907,4304,1865,99,41,18834
10/1/2019,16,10618,2144,4239,1890,59,27,18977
10/1/2019,17,10612,2020,4297,1759,10,27,18725
10/1/2019,18,10616,2027,4261,1708,2,27,18641
10/1/2019,19,10615,2036,4348,1275,0,27,18301
10/1/2019,20,10609,1798,4743,819,0,27,17996
10/1/2019,21,10609,1519,4375,721,0,27,17251
10/1/2019,22,10618,1113,3874,663,0,27,16295
10/1/2019,23,10616,762,3524,740,0,16,15658
10/1/2019,24,10645,543,2999,829,0,14,15030
10/2/2019,1,10630,400,2749,642,0,14,14435
10/2/2019,2,10631,302,2585,762,0,14,14294
10/2/2019,3,10637,300,2791,488,0,14,14230
10/2/2019,4,10642,388,2879,531,0,14,14454
10/2/2019,5,10654,540,2899,393,0,14,14500
10/2/2019,6,10664,764,3340,566,0,15,15349
10/2/2019,7,10664,1108,3727,842,1,26,16368
10/2/2019,8,10668,1148,3980,895,15,27,16733
10/2/2019,9,10674,1134,4205,974,37,27,17051
10/2/2019,10,10673,1184,4128,1275,43,27,17330
10/2/2019,11,10670,1212,4012,1216,71,27,17208
10/2/2019,12,10667,1153,3851,1337,86,27,17121
10/2/2019,13,10530,961,3664,1427,117,27,16726
10/2/2019,14,10637,917,3656,1419,141,27,16797
10/2/2019,15,10671,604,3732,1389,121,27,16544
10/2/2019,16,10695,353,4215,1653,97,27,17040
10/2/2019,17,10700,307,4576,1728,46,27,17384
10/2/2019,18,10700,330,4074,1894,4,27,17029
10/2/2019,19,10705,445,4082,2091,0,27,17350
10/2/2019,20,10719,454,3814,2048,0,27,17062
10/2/2019,21,10719,452,3923,1933,0,27,17054
10/2/2019,22,10721,404,3174,1769,0,27,16095
10/2/2019,23,10722,242,2981,1485,0,18,15448
10/2/2019,24,10724,205,2920,836,0,11,14696
10/3/2019,1,10589,204,2870,574,0,10,14247
10/3/2019,2,10421,200,2827,481,0,10,13939
10/3/2019,3,10429,199,2843,409,0,10,13890
10/3/2019,4,10431,201,2889,435,0,10,13966
10/3/2019,5,10442,201,2905,871,0,14,14433
10/3/2019,6,10456,210,3178,1223,0,19,15086
10/3/2019,7,10724,211,3232,1976,4,27,16174
10/3/2019,8,10742,210,3363,2183,19,27,16544
10/3/2019,9,10738,207,3950,1987,46,27,16955
10/3/2019,10,10735,287,4260,1682,67,27,17058
10/3/2019,11,10722,554,4335,1437,68,27,17143
10/3/2019,12,10710,554,3985,1112,104,27,16492
10/3/2019,13,10706,563,4201,856,106,27,16459
10/3/2019,14,10701,672,4611,526,87,27,16624
10/3/2019,15,10685,475,4294,412,68,27,15961
10/3/2019,16,10684,461,4640,554,63,27,16429
10/3/2019,17,10664,462,4164,1059,28,27,16404
10/3/2019,18,10658,463,4183,1199,4,27,16534
10/3/2019,19,10655,473,4567,1355,0,27,17077
10/3/2019,20,10657,490,4436,1649,0,27,17259
10/3/2019,21,10659,360,4032,1982,0,27,17060
10/3/2019,22,10663,264,3453,1717,0,27,16124
10/3/2019,23,10665,207,3165,1064,0,21,15122
10/3/2019,24,10665,198,2980,857,0,14,14714
10/4/2019,1,10667,188,2865,630,0,11,14361
10/4/2019,2,10459,203,2901,458,0,11,14032
10/4/2019,3,10371,203,2945,578,0,11,14108
10/4/2019,4,10377,202,2931,701,0,12,14223
10/4/2019,5,10394,251,2999,961,0,16,14621
10/4/2019,6,10474,305,3122,1380,1,17,15299
10/4/2019,7,10717,366,3886,1551,4,26,16550
10/4/2019,8,10712,372,3926,1460,53,27,16550
10/4/2019,9,10710,420,3913,1345,120,27,16535
10/4/2019,10,10695,449,3957,1346,167,26,16640
10/4/2019,11,10706,613,4120,1145,192,28,16804
10/4/2019,12,10718,651,4153,1050,154,28,16754
10/4/2019,13,10721,639,4104,843,168,26,16501
10/4/2019,14,10717,572,3928,715,182,26,16140
10/4/2019,15,10714,639,3987,406,177,27,15950
10/4/2019,16,10717,614,4045,573,146,27,16122
10/4/2019,17,10732,614,4314,472,96,27,16255
10/4/2019,18,10729,614,4376,335,16,27,16097
10/4/2019,19,10736,619,4564,502,0,27,16448
10/4/2019,20,10733,460,4658,668,0,27,16546
10/4/2019,21,10723,241,4349,857,0,27,16197
10/4/2019,22,10731,203,3810,1004,0,27,15775
10/4/2019,23,10732,131,3357,858,0,18,15096
10/4/2019,24,10736,119,2866,828,0,8,14557
10/5/2019,1,10742,120,2789,702,0,0,14353
10/5/2019,2,10743,124,2745,547,0,0,14159
10/5/2019,3,10742,121,2712,402,0,0,13977
10/5/2019,4,10746,117,2735,346,0,0,13944
10/5/2019,5,10747,116,2801,444,0,0,14108
10/5/2019,6,10744,119,2861,849,1,0,14574
10/5/2019,7,10747,130,3011,1345,15,0,15248
10/5/2019,8,10740,131,3112,1551,122,0,15656
10/5/2019,9,10740,131,3204,1396,255,0,15726
10/5/2019,10,10740,129,3092,1469,357,0,15787
10/5/2019,11,10740,120,3046,1406,394,0,15706
10/5/2019,12,10740,180,3033,1148,403,0,15504
10/5/2019,13,10737,244,3056,699,397,0,15133
10/5/2019,14,10730,333,3506,288,198,0,15055
10/5/2019,15,10685,342,3576,396,253,0,15252
10/5/2019,16,10669,340,3582,1035,215,0,15841
10/5/2019,17,10678,340,3379,1853,99,0,16349
10/5/2019,18,10682,340,3407,1844,17,0,16290
10/5/2019,19,10679,341,3439,2130,0,0,16589
10/5/2019,20,10676,341,3332,2076,0,0,16425
10/5/2019,21,10680,341,3189,2206,0,0,16416
10/5/2019,22,10659,234,3075,1968,0,0,15936
10/5/2019,23,10668,155,2789,1661,0,0,15273
10/5/2019,24,10683,120,2667,1222,0,0,14692
10/6/2019,1,10693,143,2665,677,0,0,14178
10/6/2019,2,10479,165,2678,591,0,0,13913
10/6/2019,3,10389,122,2700,506,0,0,13717
10/6/2019,4,10166,116,2719,627,0,0,13628
10/6/2019,5,10082,116,2718,614,0,0,13530
10/6/2019,6,10134,115,2801,885,0,0,13935
10/6/2019,7,10423,154,2994,832,1,0,14404
10/6/2019,8,10733,243,3160,1111,17,0,15264
10/6/2019,9,10723,326,3200,1577,49,1,15876
10/6/2019,10,10723,334,3290,1855,80,1,16283
10/6/2019,11,10724,336,3254,2006,121,0,16441
10/6/2019,12,10724,336,3218,2004,135,0,16417
10/6/2019,13,10718,335,3237,1744,163,0,16197
10/6/2019,14,10712,334,3283,1528,149,0,16006
10/6/2019,15,10708,336,3357,1381,125,0,15907
10/6/2019,16,10727,288,3358,1931,96,0,16400
10/6/2019,17,10745,290,3712,1783,62,0,16592
10/6/2019,18,10749,388,4120,1348,10,0,16615
10/6/2019,19,10745,594,4336,1138,0,0,16813
10/6/2019,20,10731,480,3913,1292,0,0,16416
10/6/2019,21,10685,425,3564,1224,0,0,15898
10/6/2019,22,10693,334,3178,1084,0,0,15289
10/6/2019,23,10694,334,3015,670,0,0,14713
10/6/2019,24,10703,204,2850,241,0,0,13998
10/7/2019,1,10480,113,2683,428,0,3,13707
10/7/2019,2,10404,113,2709,346,0,19,13591
10/7/2019,3,10409,112,2678,324,0,19,13542
10/7/2019,4,10410,116,2731,397,0,21,13675
10/7/2019,5,10406,222,2827,594,0,23,14072
10/7/2019,6,10423,347,3067,876,1,27,14741
10/7/2019,7,10672,461,3668,1077,2,35,15915
10/7/2019,8,10657,522,3790,1046,22,35,16072
10/7/2019,9,10666,569,3973,999,78,35,16320
10/7/2019,10,10673,628,3502,1138,148,35,16124
10/7/2019,11,10688,784,3489,1169,184,35,16349
10/7/2019,12,10701,871,3515,1200,205,35,16527
10/7/2019,13,10702,939,3787,1126,211,35,16800
10/7/2019,14,10695,1108,3828,996,200,35,16862
10/7/2019,15,10692,1289,3812,899,161,34,16887
10/7/2019,16,10688,1277,3901,944,107,34,16951
10/7/2019,17,10688,1274,4031,899,51,35,16978
10/7/2019,18,10688,1268,4042,656,14,34,16702
10/7/2019,19,10693,1270,4260,695,0,34,16952
10/7/2019,20,10697,1269,4143,644,0,34,16787
10/7/2019,21,10695,1265,3768,599,0,34,16361
10/7/2019,22,10691,833,3572,570,0,34,15700
10/7/2019,23,10695,262,3261,378,0,25,14621
10/7/2019,24,10701,196,3113,270,0,19,14299
10/8/2019,1,10704,247,2750,302,0,18,14021
10/8/2019,2,10704,216,2648,337,0,18,13923
10/8/2019,3,10710,206,2644,411,0,18,13989
10/8/2019,4,10710,288,2689,459,0,18,14164
10/8/2019,5,10717,514,2726,632,0,21,14610
10/8/2019,6,10710,751,3093,497,1,35,15087
10/8/2019,7,10708,822,3358,1036,6,42,15972
10/8/2019,8,10710,823,3437,700,82,43,15795
10/8/2019,9,10711,824,3396,637,193,37,15798
10/8/2019,10,10711,830,3418,452,276,35,15722
10/8/2019,11,10713,941,3474,274,312,35,15749
10/8/2019,12,10707,1013,3366,93,318,36,15533
10/8/2019,13,10709,1079,3376,203,283,35,15685
10/8/2019,14,10713,1128,3626,235,293,35,16030
10/8/2019,15,10693,843,3759,220,284,36,15835
10/8/2019,16,10673,828,4180,254,206,36,16177
10/8/2019,17,10669,985,4246,334,103,37,16374
10/8/2019,18,10668,885,4242,471,17,36,16319
10/8/2019,19,10684,706,4058,820,0,35,16303
10/8/2019,20,10689,657,3673,1043,0,35,16097
10/8/2019,21,10688,524,3607,1302,0,35,16156
10/8/2019,22,10697,395,3324,1421,0,35,15872
10/8/2019,23,10713,235,2996,1322,0,26,15292
10/8/2019,24,10716,199,2631,1467,0,20,15033
10/9/2019,1,10723,201,2612,1044,0,18,14598
10/9/2019,2,10722,207,2618,1022,0,18,14587
10/9/2019,3,10723,206,2676,782,0,18,14405
10/9/2019,4,10722,253,2667,950,0,18,14610
10/9/2019,5,10727,387,2732,1171,0,20,15037
10/9/2019,6,10726,388,3090,1258,1,30,15493
10/9/2019,7,10718,422,3733,1404,4,36,16317
10/9/2019,8,10720,443,3843,1212,73,36,16327
10/9/2019,9,10708,265,4207,821,175,36,16212
10/9/2019,10,10713,367,4218,511,272,36,16117
10/9/2019,11,10717,521,3740,467,311,36,15792
10/9/2019,12,10560,662,3529,485,306,36,15578
10/9/2019,13,10525,742,3580,443,314,36,15640
10/9/2019,14,10694,766,3568,240,303,36,15607
10/9/2019,15,10711,792,3763,514,284,37,16101
10/9/2019,16,10708,825,3715,996,214,37,16495
10/9/2019,17,10709,973,3691,1231,110,36,16750
10/9/2019,18,10706,975,3756,1338,17,36,16828
10/9/2019,19,10701,978,3664,1867,0,36,17246
10/9/2019,20,10712,976,3471,2092,0,36,17287
10/9/2019,21,10711,723,3276,2055,0,36,16801
10/9/2019,22,10713,534,2817,2122,0,36,16222
10/9/2019,23,10715,286,2573,2102,0,24,15700
10/9/2019,24,10718,211,2605,1239,0,18,14791
10/10/2019,1,10724,200,2637,704,0,18,14283
10/10/2019,2,10721,199,2578,502,0,19,14019
10/10/2019,3,10722,199,2603,565,0,18,14107
10/10/2019,4,10725,202,2705,576,0,18,14226
10/10/2019,5,10723,201,2720,889,0,20,14553
10/10/2019,6,10726,202,2955,1297,1,33,15214
10/10/2019,7,10720,202,3567,1354,5,37,15885
10/10/2019,8,10716,202,3586,1353,74,37,15968
10/10/2019,9,10710,198,3632,1109,191,37,15877
10/10/2019,10,10709,201,3525,861,275,37,15608
10/10/2019,11,10710,236,3614,572,271,37,15440
10/10/2019,12,10711,297,3571,547,267,37,15430
10/10/2019,13,10714,384,3627,421,248,37,15431
10/10/2019,14,10717,429,3545,567,263,36,15557
10/10/2019,15,10703,476,3528,1178,238,36,16159
10/10/2019,16,10710,475,3505,1253,176,38,16157
10/10/2019,17,10718,458,3900,1593,104,29,16802
10/10/2019,18,10717,547,4164,1685,12,32,17157
10/10/2019,19,10717,653,4219,2021,0,32,17642
10/10/2019,20,10711,650,3780,2426,0,28,17595
10/10/2019,21,10713,434,3291,2411,0,30,16879
10/10/2019,22,10706,241,2869,2237,0,28,16081
10/10/2019,23,10719,198,2637,2048,0,18,15620
10/10/2019,24,10724,196,2630,1477,0,14,15041
10/11/2019,1,10721,196,2622,1054,0,14,14607
10/11/2019,2,10722,197,2646,817,0,13,14395
10/11/2019,3,10722,198,2599,763,0,11,14293
10/11/2019,4,10725,199,2647,839,0,11,14421
10/11/2019,5,10730,198,2620,1165,0,13,14726
10/11/2019,6,10731,305,2789,1457,2,20,15304
10/11/2019,7,10708,360,3257,2023,5,27,16380
10/11/2019,8,10721,358,3343,2009,67,27,16525
10/11/2019,9,10726,359,3332,1818,161,27,16423
10/11/2019,10,10724,359,3319,1783,259,28,16472
10/11/2019,11,10720,356,3289,1634,280,28,16307
10/11/2019,12,10732,361,3324,1764,289,27,16497
10/11/2019,13,10709,262,3377,1793,283,27,16451
10/11/2019,14,10726,193,3294,2032,275,27,16547
10/11/2019,15,10724,193,3206,2134,255,27,16539
10/11/2019,16,10718,191,3079,2600,150,27,16765
10/11/2019,17,10716,192,3448,2590,47,27,17020
10/11/2019,18,10717,194,3425,2734,5,27,17102
10/11/2019,19,10714,196,3480,3219,0,27,17636
10/11/2019,20,10711,197,3348,3188,0,27,17471
10/11/2019,21,10703,197,2937,3124,0,27,16988
10/11/2019,22,10704,195,2588,2559,0,27,16073
10/11/2019,23,10704,129,2739,1638,0,20,15230
10/11/2019,24,10702,116,2571,979,0,10,14378
10/12/2019,1,10704,117,2553,756,0,0,14130
10/12/2019,2,10696,116,2517,517,0,0,13846
10/12/2019,3,10695,115,2536,589,0,0,13935
10/12/2019,4,10687,115,2601,515,0,0,13918
10/12/2019,5,10682,114,2655,564,0,0,14015
10/12/2019,6,10682,113,2593,758,1,0,14147
10/12/2019,7,10689,115,2957,1166,2,0,14929
10/12/2019,8,10690,113,3186,1657,12,0,15658
10/12/2019,9,10682,112,3325,2104,41,0,16264
10/12/2019,10,10676,113,3181,1939,123,0,16032
10/12/2019,11,10672,116,3216,2074,184,0,16262
10/12/2019,12,10670,128,3415,1799,188,0,16200
10/12/2019,13,10668,129,3662,1239,200,0,15898
10/12/2019,14,10667,131,3375,1621,187,0,15981
10/12/2019,15,10663,131,3446,1592,121,0,15953
10/12/2019,16,10660,130,3399,2018,90,0,16297
10/12/2019,17,10666,127,3470,2250,59,0,16572
10/12/2019,18,10677,126,3973,1664,6,0,16446
10/12/2019,19,10674,126,3865,2080,0,0,16745
10/12/2019,20,10669,127,3732,2019,0,0,16547
10/12/2019,21,10669,127,3003,2186,0,0,15985
10/12/2019,22,10672,127,2847,1949,0,0,15595
10/12/2019,23,10666,125,2577,1511,0,0,14879
10/12/2019,24,10702,125,2565,659,0,0,14051
10/13/2019,1,10635,126,2547,672,0,0,13980
10/13/2019,2,10411,127,2533,625,0,0,13696
10/13/2019,3,10421,127,2537,555,0,5,13645
10/13/2019,4,10428,127,2572,480,0,9,13616
10/13/2019,5,10422,126,2613,447,0,15,13623
10/13/2019,6,10430,128,2642,825,2,15,14042
10/13/2019,7,10432,126,2934,1083,4,14,14593
10/13/2019,8,10573,128,2991,991,59,1,14743
10/13/2019,9,10723,124,2991,1004,181,0,15023
10/13/2019,10,10723,120,2995,919,225,0,14982
10/13/2019,11,10722,122,3210,800,176,0,15030
10/13/2019,12,10726,122,3159,766,207,0,14980
10/13/2019,13,10728,122,3156,695,90,0,14791
10/13/2019,14,10727,122,3173,516,71,0,14609
10/13/2019,15,10687,122,3260,723,125,0,14917
10/13/2019,16,10720,123,3294,1033,141,0,15311
10/13/2019,17,10717,123,3274,1454,93,0,15661
10/13/2019,18,10722,121,3485,1502,10,0,15840
10/13/2019,19,10714,123,3472,1870,0,0,16179
10/13/2019,20,10704,122,3373,1811,0,0,16010
10/13/2019,21,10701,122,3195,1579,0,0,15597
10/13/2019,22,10708,121,3193,1414,0,0,15436
10/13/2019,23,10707,117,2880,1227,0,0,14931
10/13/2019,24,10697,116,2653,801,0,0,14267
10/14/2019,1,10706,116,2644,637,0,0,14103
10/14/2019,2,10499,116,2648,551,0,0,13814
10/14/2019,3,10416,116,2679,581,0,0,13792
10/14/2019,4,10469,114,2663,593,0,0,13839
10/14/2019,5,10473,115,2741,683,0,0,14012
10/14/2019,6,10472,116,2728,993,0,0,14309
10/14/2019,7,10698,115,2941,1196,2,0,14952
10/14/2019,8,10766,116,2995,1290,17,0,15184
10/14/2019,9,10769,116,3142,1624,54,0,15705
10/14/2019,10,10771,115,3147,1691,98,0,15822
10/14/2019,11,10769,146,3338,1487,126,0,15866
10/14/2019,12,10765,229,3318,1522,167,0,16001
10/14/2019,13,10766,235,3236,1763,163,0,16163
10/14/2019,14,10762,235,3359,1487,185,0,16028
10/14/2019,15,10764,240,3314,1631,164,0,16113
10/14/2019,16,10762,278,3431,1720,117,0,16308
10/14/2019,17,10747,340,3539,1391,37,0,16054
10/14/2019,18,10742,348,4013,1347,5,0,16455
10/14/2019,19,10755,405,4343,1300,0,0,16803
10/14/2019,20,10766,423,4187,1190,0,0,16566
10/14/2019,21,10746,365,3904,1143,0,0,16158
10/14/2019,22,10746,345,3160,983,0,0,15234
10/14/2019,23,10754,207,2910,900,0,0,14771
10/14/2019,24,10752,122,2827,839,0,0,14540
10/15/2019,1,10751,131,2877,724,0,8,14491
10/15/2019,2,10754,141,2937,559,0,11,14402
10/15/2019,3,10745,173,2740,422,0,11,14091
10/15/2019,4,10753,172,2940,259,0,11,14135
10/15/2019,5,10750,236,3191,165,0,11,14353
10/15/2019,6,10751,420,3913,151,2,31,15268
10/15/2019,7,10726,721,4261,144,7,45,15904
10/15/2019,8,10683,741,3980,218,87,55,15764
10/15/2019,9,10533,744,3737,299,195,55,15563
10/15/2019,10,10529,719,3827,511,257,56,15899
10/15/2019,11,10706,767,3790,430,180,58,15931
10/15/2019,12,10774,850,3509,578,284,65,16060
10/15/2019,13,10773,708,3525,711,300,66,16083
10/15/2019,14,10759,758,3486,898,312,65,16278
10/15/2019,15,10746,768,4111,558,280,69,16532
10/15/2019,16,10745,818,4501,376,178,63,16681
10/15/2019,17,10744,979,4282,571,74,62,16712
10/15/2019,18,10744,920,4088,993,4,60,16809
10/15/2019,19,10740,893,3884,1447,0,55,17019
10/15/2019,20,10743,702,3779,2108,0,41,17373
10/15/2019,21,10742,374,3363,2354,0,39,16872
10/15/2019,22,10739,267,2916,2114,0,35,16071
10/15/2019,23,10732,266,2904,1170,0,22,15094
10/15/2019,24,10733,266,2757,818,0,15,14589
10/16/2019,1,10733,265,2723,951,0,14,14686
10/16/2019,2,10731,266,2771,591,0,14,14373
10/16/2019,3,10733,266,2706,722,0,14,14441
10/16/2019,4,10735,265,2707,795,0,16,14518
10/16/2019,5,10743,266,2869,1132,0,20,15030
10/16/2019,6,10734,269,3048,1598,0,25,15674
10/16/2019,7,10738,270,3745,2094,1,35,16883
10/16/2019,8,10736,293,4337,2104,6,36,17512
10/16/2019,9,10737,367,4338,2071,18,36,17567
10/16/2019,10,10726,335,3931,2008,21,37,17058
10/16/2019,11,10721,445,3912,2231,24,38,17371
10/16/2019,12,10607,417,4066,2315,29,37,17471
10/16/2019,13,10559,439,4185,2246,26,36,17491
10/16/2019,14,10561,600,4171,2159,40,37,17568
10/16/2019,15,10663,531,4073,2023,60,37,17387
10/16/2019,16,10732,554,3978,2210,36,37,17547
10/16/2019,17,10736,686,3905,2422,14,37,17800
10/16/2019,18,10734,700,3827,2599,1,36,17897
10/16/2019,19,10733,637,3807,2817,1,35,18030
10/16/2019,20,10731,444,3483,2996,0,35,17689
10/16/2019,21,10728,421,3334,2834,0,35,17352
10/16/2019,22,10733,269,2884,2928,0,35,16849
10/16/2019,23,10728,234,2778,2430,0,25,16195
10/16/2019,24,10729,247,2710,1800,0,20,15506
10/17/2019,1,10734,246,2684,1403,0,19,15086
10/17/2019,2,10737,246,2686,1206,0,15,14890
10/17/2019,3,10755,246,2707,1040,0,15,14763
10/17/2019,4,10745,246,2728,975,0,14,14708
10/17/2019,5,10738,246,2804,1428,0,17,15233
10/17/2019,6,10734,246,2907,2143,0,25,16055
10/17/2019,7,10683,250,3443,2948,2,34,17360
10/17/2019,8,10627,253,3486,3188,11,35,17600
10/17/2019,9,10619,253,3586,2884,44,34,17420
10/17/2019,10,10618,253,3603,2932,71,32,17509
10/17/2019,11,10629,254,3917,3043,90,33,17966
10/17/2019,12,10691,255,3936,2970,128,34,18014
10/17/2019,13,10708,254,3764,2929,126,34,17815
10/17/2019,14,10636,269,3798,2741,114,34,17592
10/17/2019,15,10642,274,4103,2702,88,35,17844
10/17/2019,16,10646,273,4054,2590,60,36,17659
10/17/2019,17,10648,258,4038,2788,30,46,17808
10/17/2019,18,10653,278,4457,2779,1,48,18216
10/17/2019,19,10654,387,4479,2697,0,53,18270
10/17/2019,20,10649,382,4510,2432,0,49,18022
10/17/2019,21,10648,382,4209,2247,0,36,17522
10/17/2019,22,10651,382,4007,1945,0,36,17021
10/17/2019,23,10656,381,3418,1498,0,28,15981
10/17/2019,24,10656,371,3126,1013,0,22,15188
10/18/2019,1,10665,213,3029,883,0,19,14809
10/18/2019,2,10664,186,2951,835,0,18,14654
10/18/2019,3,10669,197,2887,884,0,17,14654
10/18/2019,4,10671,199,2959,888,0,16,14733
10/18/2019,5,10670,201,3153,1045,0,17,15086
10/18/2019,6,10664,204,3662,1089,1,29,15649
10/18/2019,7,10671,298,4361,1146,1,36,16513
10/18/2019,8,10664,319,4414,1058,52,37,16544
10/18/2019,9,10663,459,4695,857,153,36,16863
10/18/2019,10,10667,708,4321,901,236,36,16869
10/18/2019,11,10655,870,4117,551,292,36,16521
10/18/2019,12,10656,927,4265,165,365,36,16414
10/18/2019,13,10655,979,4258,137,362,29,16420
10/18/2019,14,10664,1139,3963,82,348,27,16223
10/18/2019,15,10679,1270,3763,80,314,27,16133
10/18/2019,16,10678,1530,3993,130,168,27,16526
10/18/2019,17,10680,1536,4142,155,76,27,16616
10/18/2019,18,10695,1440,4707,208,7,27,17084
10/18/2019,19,10700,1356,4974,261,0,27,17318
10/18/2019,20,10698,1000,4898,272,0,27,16895
10/18/2019,21,10689,748,4609,347,0,27,16420
10/18/2019,22,10675,462,4184,369,0,27,15717
10/18/2019,23,10652,226,3884,391,0,15,15168
10/18/2019,24,10647,132,3156,419,0,0,14354
10/19/2019,1,10496,133,3086,438,0,0,14153
10/19/2019,2,10373,133,3126,465,0,0,14097
10/19/2019,3,10374,132,3132,505,0,0,14143
10/19/2019,4,10393,132,3192,553,0,0,14270
10/19/2019,5,10397,132,3331,619,0,0,14479
10/19/2019,6,10546,133,3489,718,0,0,14886
10/19/2019,7,10702,224,3739,817,5,0,15487
10/19/2019,8,10699,193,3968,865,98,0,15823
10/19/2019,9,10701,135,3708,769,249,0,15562
10/19/2019,10,10701,132,3766,406,362,0,15367
10/19/2019,11,10701,133,3787,333,392,0,15346
10/19/2019,12,10695,215,3346,349,381,0,14986
10/19/2019,13,10698,279,3284,382,380,0,15023
10/19/2019,14,10705,395,3337,430,389,0,15256
10/19/2019,15,10685,472,3318,380,323,0,15178
10/19/2019,16,10675,475,3722,428,161,0,15461
10/19/2019,17,10681,475,4145,902,67,0,16270
10/19/2019,18,10676,476,4503,1067,5,0,16727
10/19/2019,19,10678,475,4401,1357,0,0,16911
10/19/2019,20,10674,474,3986,1490,0,0,16624
10/19/2019,21,10660,275,3592,1632,0,0,16159
10/19/2019,22,10659,132,3216,1597,0,5,15609
10/19/2019,23,10666,135,3004,1448,0,8,15261
10/19/2019,24,10668,134,2900,903,0,8,14613
10/20/2019,1,10434,163,2958,746,0,0,14301
10/20/2019,2,10317,173,2941,579,0,0,14010
10/20/2019,3,10085,173,2935,647,0,0,13840
10/20/2019,4,10087,197,2952,605,0,0,13841
10/20/2019,5,10084,203,2970,717,0,0,13974
10/20/2019,6,10085,203,3114,609,1,0,14012
10/20/2019,7,10150,247,3590,671,2,0,14660
10/20/2019,8,10433,276,3791,691,69,0,15260
10/20/2019,9,10665,293,3757,404,135,0,15254
10/20/2019,10,10671,343,4052,100,202,0,15368
10/20/2019,11,10671,398,3805,65,289,0,15228
10/20/2019,12,10675,428,3570,56,281,0,15010
10/20/2019,13,10669,455,3494,50,285,0,14953
10/20/2019,14,10629,483,3523,85,308,0,15028
10/20/2019,15,10666,711,3485,64,263,0,15189
10/20/2019,16,10666,906,3988,47,148,0,15755
10/20/2019,17,10665,951,4749,30,69,0,16464
10/20/2019,18,10660,970,5020,53,4,0,16707
10/20/2019,19,10657,967,5014,62,0,0,16700
10/20/2019,20,10654,1098,4872,127,0,0,16751
10/20/2019,21,10648,922,4721,228,0,0,16519
10/20/2019,22,10637,770,3889,258,0,0,15554
10/20/2019,23,10565,800,3397,174,0,0,14936
10/20/2019,24,10343,435,3196,200,0,0,14174
10/21/2019,1,10346,166,3132,571,0,0,14215
10/21/2019,2,10332,132,2961,676,0,0,14101
10/21/2019,3,10369,130,2857,672,0,0,14028
10/21/2019,4,10370,147,2834,610,0,1,13962
10/21/2019,5,10375,185,2965,569,0,14,14108
10/21/2019,6,10379,188,3375,1175,0,21,15138
10/21/2019,7,10599,185,3929,1724,0,27,16464
10/21/2019,8,10676,186,3965,1927,40,26,16820
10/21/2019,9,10673,187,3748,1639,169,26,16442
10/21/2019,10,10671,193,3452,1742,273,26,16357
10/21/2019,11,10671,277,3405,1186,332,27,15898
10/21/2019,12,10670,305,3614,978,333,26,15926
10/21/2019,13,10667,344,3706,905,198,26,15846
10/21/2019,14,10667,482,3690,896,64,26,15825
10/21/2019,15,10685,536,3354,1276,184,26,16061
10/21/2019,16,10687,542,3313,1985,126,26,16679
10/21/2019,17,10686,545,3512,2370,40,27,17180
10/21/2019,18,10705,547,3656,2894,0,27,17829
10/21/2019,19,10701,545,3665,3074,0,28,18013
10/21/2019,20,10700,537,3686,2674,0,28,17625
10/21/2019,21,10680,351,3341,2495,0,27,16894
10/21/2019,22,10653,196,3182,1778,0,27,15836
10/21/2019,23,10642,199,2920,1040,0,22,14823
10/21/2019,24,10652,198,2735,705,0,14,14304
10/22/2019,1,10656,199,2722,661,0,12,14250
10/22/2019,2,10658,199,2714,552,0,11,14134
10/22/2019,3,10456,199,2812,775,0,11,14253
10/22/2019,4,10384,198,2815,790,0,11,14198
10/22/2019,5,10385,283,2961,616,0,14,14259
10/22/2019,6,10384,411,3147,1319,0,19,15280
10/22/2019,7,10628,537,3440,1963,2,26,16596
10/22/2019,8,10683,540,3620,2191,6,26,17066
10/22/2019,9,10682,541,3544,2337,22,26,17152
10/22/2019,10,10683,540,3478,2402,47,26,17176
10/22/2019,11,10678,535,3507,2215,81,26,17042
10/22/2019,12,10678,533,3491,2098,90,26,16916
10/22/2019,13,10683,355,3498,2075,140,26,16777
10/22/2019,14,10688,200,3608,2014,117,26,16653
10/22/2019,15,10687,307,3660,1927,86,26,16693
10/22/2019,16,10684,413,3650,2198,72,27,17044
10/22/2019,17,10687,535,3847,2198,28,26,17321
10/22/2019,18,10682,541,4156,2054,0,26,17459
10/22/2019,19,10681,545,4037,2368,0,27,17658
10/22/2019,20,10676,544,3635,2496,0,27,17378
10/22/2019,21,10674,542,3486,1707,0,27,16436
10/22/2019,22,10669,541,3123,1322,0,27,15682
10/22/2019,23,10691,353,2889,1103,0,22,15058
10/22/2019,24,10701,202,2770,1092,0,13,14778
10/23/2019,1,10710,199,2770,899,0,11,14589
10/23/2019,2,10570,198,2787,823,0,11,14389
10/23/2019,3,10409,197,2794,751,0,11,14162
10/23/2019,4,10416,195,2792,723,0,11,14137
10/23/2019,5,10194,199,2874,805,0,14,14086
10/23/2019,6,10109,265,2999,1640,1,19,15033
10/23/2019,7,10397,351,3513,2044,3,26,16334
10/23/2019,8,10692,419,3602,1841,52,26,16632
10/23/2019,9,10700,421,3660,1223,111,26,16141
10/23/2019,10,10705,470,3740,1079,77,27,16098
10/23/2019,11,10676,542,3760,921,71,26,15996
10/23/2019,12,10667,546,3805,887,49,26,15980
10/23/2019,13,10671,545,3720,1003,54,26,16019
10/23/2019,14,10705,544,3666,1128,88,26,16157
10/23/2019,15,10711,545,3731,1164,132,26,16309
10/23/2019,16,10703,546,3852,1313,116,27,16557
10/23/2019,17,10708,546,3946,1575,50,27,16852
10/23/2019,18,10712,546,4149,1743,3,27,17180
10/23/2019,19,10716,547,4066,2328,0,27,17684
10/23/2019,20,10714,546,3663,2457,0,27,17407
10/23/2019,21,10715,543,3533,1660,0,27,16478
10/23/2019,22,10716,345,3361,1017,0,27,15466
10/23/2019,23,10716,200,3169,613,0,23,14721
10/23/2019,24,10597,201,3181,756,0,12,14747
10/24/2019,1,10430,203,3146,803,0,13,14595
10/24/2019,2,10432,203,3160,581,0,12,14388
10/24/2019,3,10437,202,3137,430,0,11,14217
10/24/2019,4,10430,202,3138,501,0,11,14282
10/24/2019,5,10437,201,3175,598,0,14,14425
10/24/2019,6,10505,207,3318,1174,0,20,15224
10/24/2019,7,10724,328,3768,1796,1,27,16644
10/24/2019,8,10726,520,4074,1606,15,27,16968
10/24/2019,9,10726,667,3864,1514,36,27,16834
10/24/2019,10,10726,677,3798,1459,69,27,16756
10/24/2019,11,10725,756,3756,966,142,27,16372
10/24/2019,12,10719,812,3744,694,172,26,16167
10/24/2019,13,10722,903,4005,559,65,27,16281
10/24/2019,14,10722,967,4095,634,87,26,16531
10/24/2019,15,10597,891,3872,581,106,27,16074
10/24/2019,16,10419,846,4206,823,131,27,16452
10/24/2019,17,10563,807,4716,822,38,27,16973
10/24/2019,18,10763,727,5096,678,1,27,17292
10/24/2019,19,10763,701,5198,621,0,27,17310
10/24/2019,20,10765,668,5180,642,0,27,17282
10/24/2019,21,10769,679,4702,635,0,27,16812
10/24/2019,22,10724,353,4218,550,0,26,15871
10/24/2019,23,10727,263,3566,329,0,22,14907
10/24/2019,24,10636,263,3215,269,0,17,14400
10/25/2019,1,10432,265,3302,349,0,11,14359
10/25/2019,2,10432,264,3284,305,0,11,14296
10/25/2019,3,10431,264,3176,291,0,12,14174
10/25/2019,4,10437,265,3254,264,0,12,14232
10/25/2019,5,10438,338,3404,282,0,14,14476
10/25/2019,6,10512,423,3873,367,0,22,15197
10/25/2019,7,10728,497,4450,302,2,27,16006
10/25/2019,8,10732,586,4606,310,8,27,16269
10/25/2019,9,10731,781,4807,247,28,26,16620
10/25/2019,10,10731,851,4541,186,72,26,16407
10/25/2019,11,10736,801,4406,208,126,27,16304
10/25/2019,12,10729,911,4063,192,147,27,16069
10/25/2019,13,10730,935,3995,192,178,26,16056
10/25/2019,14,10729,1047,3969,292,138,27,16202
10/25/2019,15,10729,915,3992,339,79,27,16081
10/25/2019,16,10730,917,4050,389,42,27,16155
10/25/2019,17,10729,918,4494,282,12,27,16462
10/25/2019,18,10731,837,5004,251,0,27,16850
10/25/2019,19,10727,913,4957,240,0,27,16864
10/25/2019,20,10727,760,4973,301,0,31,16792
10/25/2019,21,10731,392,4431,377,0,31,15962
10/25/2019,22,10729,269,3660,432,1,27,15118
10/25/2019,23,10709,270,3220,355,0,16,14570
10/25/2019,24,10381,269,3123,357,0,0,14130
10/26/2019,1,10146,270,3192,412,0,0,14020
10/26/2019,2,10153,270,3178,392,0,0,13993
10/26/2019,3,10153,270,3318,306,0,0,14047
10/26/2019,4,10152,269,3349,360,0,0,14130
10/26/2019,5,10156,268,3332,348,0,0,14104
10/26/2019,6,10155,270,3365,375,1,0,14166
10/26/2019,7,10227,269,3743,541,2,0,14782
10/26/2019,8,10644,270,3584,691,49,0,15238
10/26/2019,9,10744,268,3432,465,187,0,15096
10/26/2019,10,10721,269,3268,351,232,0,14841
10/26/2019,11,10737,268,3258,341,127,0,14731
10/26/2019,12,10535,266,3249,422,126,0,14598
10/26/2019,13,10452,265,3221,465,140,0,14543
10/26/2019,14,10451,266,3294,519,188,0,14718
10/26/2019,15,10420,267,3337,611,176,0,14811
10/26/2019,16,10483,269,3445,931,88,0,15216
10/26/2019,17,10723,270,3431,1341,17,0,15782
10/26/2019,18,10713,197,3572,1718,0,0,16200
10/26/2019,19,10728,191,3568,1447,0,0,15934
10/26/2019,20,10727,149,3464,1383,0,0,15723
10/26/2019,21,10727,111,3419,994,0,0,15251
10/26/2019,22,10727,111,3208,778,0,0,14824
10/26/2019,23,10723,111,3205,548,0,0,14587
10/26/2019,24,10381,111,3172,489,0,0,14153
10/27/2019,1,10126,110,3140,663,0,0,14039
10/27/2019,2,10131,111,2997,761,0,0,14000
10/27/2019,3,9920,111,2998,737,0,0,13766
10/27/2019,4,9887,110,3042,782,0,0,13821
10/27/2019,5,9882,110,3142,789,0,0,13923
10/27/2019,6,9885,111,3209,931,0,0,14136
10/27/2019,7,9955,111,3224,1410,0,0,14700
10/27/2019,8,10184,111,3575,967,2,0,14839
10/27/2019,9,10192,112,3643,1490,13,0,15450
10/27/2019,10,10458,111,3634,1724,20,0,15947
10/27/2019,11,10668,111,3600,1610,25,0,16014
10/27/2019,12,10699,113,3718,1885,45,0,16460
10/27/2019,13,10702,113,3676,1708,34,0,16233
10/27/2019,14,10719,112,3671,1659,30,0,16191
10/27/2019,15,10717,113,3770,1816,39,0,16455
10/27/2019,16,10711,112,3819,2214,29,0,16885
10/27/2019,17,10705,113,4091,2162,14,0,17085
10/27/2019,18,10707,115,4291,2030,1,0,17144
10/27/2019,19,10702,116,4159,1966,0,0,16943
10/27/2019,20,10693,115,3732,1900,0,0,16440
10/27/2019,21,10697,115,3638,1385,0,0,15835
10/27/2019,22,10707,111,3405,980,0,0,15203
10/27/2019,23,10705,114,3246,560,0,0,14625
10/27/2019,24,10502,115,3362,406,0,0,14385
10/28/2019,1,10129,116,3373,614,0,0,14232
10/28/2019,2,10117,115,3273,577,0,0,14082
10/28/2019,3,10110,115,3317,411,0,0,13953
10/28/2019,4,10125,116,3580,379,0,0,14200
10/28/2019,5,10125,129,3596,430,0,0,14280
10/28/2019,6,10421,145,4012,581,0,0,15159
10/28/2019,7,10715,184,4508,834,2,0,16243
10/28/2019,8,10703,198,4402,1015,57,0,16375
10/28/2019,9,10697,199,3966,815,192,0,15869
10/28/2019,10,10712,199,4143,423,284,0,15761
10/28/2019,11,10718,256,3902,571,320,0,15767
10/28/2019,12,10717,305,3913,324,133,0,15392
10/28/2019,13,10716,305,3962,311,256,0,15550
10/28/2019,14,10715,308,4010,409,300,0,15742
10/28/2019,15,10718,351,4185,382,231,0,15867
10/28/2019,16,10715,460,4195,508,163,0,16041
10/28/2019,17,10713,540,4524,516,58,1,16352
10/28/2019,18,10724,544,4697,632,2,0,16599
10/28/2019,19,10763,549,5054,534,0,0,16900
10/28/2019,20,10747,547,4734,493,0,0,16521
10/28/2019,21,10228,555,4722,560,0,0,16065
10/28/2019,22,9995,444,4510,773,0,0,15722
10/28/2019,23,10001,253,3707,706,0,0,14667
10/28/2019,24,10005,215,3349,451,0,0,14020
10/29/2019,1,10007,228,3249,530,0,0,14014
10/29/2019,2,9774,228,3188,466,0,0,13656
10/29/2019,3,9716,228,3214,574,0,0,13732
10/29/2019,4,9723,232,3227,741,0,0,13923
10/29/2019,5,9723,232,3263,1070,0,0,14288
10/29/2019,6,9943,266,3619,1428,1,0,15257
10/29/2019,7,10022,324,4077,1800,1,0,16224
10/29/2019,8,10022,384,4197,1864,48,0,16515
10/29/2019,9,10021,473,4089,1709,148,0,16440
10/29/2019,10,10012,511,4149,1334,190,0,16196
10/29/2019,11,10013,540,3985,1287,207,0,16032
10/29/2019,12,10030,648,3906,1173,223,0,15980
10/29/2019,13,10031,745,4043,1152,275,0,16246
10/29/2019,14,10028,739,4136,1080,253,0,16236
10/29/2019,15,10031,726,4282,1327,138,0,16504
10/29/2019,16,10025,684,4445,1367,83,0,16604
10/29/2019,17,10022,684,4808,1017,24,0,16555
10/29/2019,18,10020,661,5171,1004,0,9,16865
10/29/2019,19,10020,656,5014,943,0,25,16658
10/29/2019,20,10010,663,5374,671,0,26,16744
10/29/2019,21,10005,455,5228,566,0,26,16280
10/29/2019,22,10007,256,4636,564,0,27,15490
10/29/2019,23,10011,195,3867,419,0,17,14509
10/29/2019,24,10015,195,3317,402,0,12,13941
10/30/2019,1,10015,199,3190,348,0,11,13763
10/30/2019,2,10008,199,3188,327,0,11,13733
10/30/2019,3,10017,213,3236,406,0,11,13883
10/30/2019,4,10026,298,3104,210,0,11,13649
10/30/2019,5,10027,485,3270,380,0,11,14173
10/30/2019,6,10027,741,3846,370,0,20,15004
10/30/2019,7,10024,864,4555,445,2,26,15916
10/30/2019,8,10028,886,4698,405,7,27,16051
10/30/2019,9,10025,955,4680,370,78,27,16135
10/30/2019,10,10021,909,4652,346,108,26,16062
10/30/2019,11,10026,955,4499,318,120,26,15944
10/30/2019,12,10023,1127,4509,358,121,26,16164
10/30/2019,13,9869,1105,4091,376,140,26,15607
10/30/2019,14,9846,1143,4424,485,77,26,16001
10/30/2019,15,10008,989,3888,749,46,26,15706
10/30/2019,16,10023,609,4262,1035,22,27,15978
10/30/2019,17,10028,640,4565,1299,3,26,16561
10/30/2019,18,10030,642,4410,1304,0,27,16413
10/30/2019,19,10027,533,4304,1495,0,27,16386
10/30/2019,20,10029,445,4238,1555,0,27,16294
10/30/2019,21,10021,285,4256,1652,0,27,16241
10/30/2019,22,10027,257,4130,1407,0,27,15848
10/30/2019,23,10025,258,3552,931,0,17,14783
10/30/2019,24,10028,256,3293,833,0,12,14422
10/31/2019,1,10028,260,3153,662,0,11,14114
10/31/2019,2,10031,262,3111,418,0,9,13831
10/31/2019,3,10028,347,3104,403,0,9,13891
10/31/2019,4,10024,360,3163,408,0,11,13966
10/31/2019,5,10031,524,3258,591,0,15,14419
10/31/2019,6,10033,694,3909,717,0,22,15375
10/31/2019,7,10034,961,4703,827,1,26,16552
10/31/2019,8,10031,1070,4986,864,3,26,16980
10/31/2019,9,10032,1073,4656,1123,12,26,16922
10/31/2019,10,10030,1077,4090,1448,27,26,16698
10/31/2019,11,10029,1098,4303,1291,51,26,16798
10/31/2019,12,10010,1318,4619,1610,50,26,17633
10/31/2019,13,10003,1018,4223,1553,40,26,16863
10/31/2019,14,10008,880,4107,1991,40,26,17052
10/31/2019,15,10030,549,4051,1857,18,26,16531
10/31/2019,16,10039,451,4967,1943,10,26,17436
10/31/2019,17,10043,451,4799,2286,2,26,17607
10/31/2019,18,10042,448,4586,2200,0,27,17303
10/31/2019,19,10046,287,4561,2320,0,27,17241
10/31/2019,20,10044,257,4221,2920,0,27,17469
10/31/2019,21,10039,258,4020,2391,0,27,16735
10/31/2019,22,10026,256,3521,2270,0,27,16100
10/31/2019,23,10025,256,3494,1569,0,17,15361
10/31/2019,24,10031,256,3270,1362,0,10,14929
11/1/2019,1,10028,256,3803,699,0,10,14796
11/1/2019,2,10023,256,3758,916,0,11,14964
11/1/2019,3,10020,256,3687,743,0,10,14716
11/1/2019,4,10024,256,3683,1060,0,11,15034
11/1/2019,5,10025,256,3707,1054,0,14,15056
11/1/2019,6,10018,257,3850,1910,0,21,16056
11/1/2019,7,10017,257,4047,2773,1,30,17125
11/1/2019,8,10012,264,4137,2993,15,35,17456
11/1/2019,9,10015,403,4344,2955,63,41,17821
11/1/2019,10,10015,480,4442,2801,83,37,17858
11/1/2019,11,10017,522,4282,2762,101,39,17723
11/1/2019,12,10019,651,4102,2602,118,38,17530
11/1/2019,13,10021,812,3875,2499,91,40,17338
11/1/2019,14,10019,916,4192,1971,99,40,17237
11/1/2019,15,10014,1013,4290,1633,143,33,17126
11/1/2019,16,10021,1011,4814,1502,137,28,17513
11/1/2019,17,10017,1073,5459,1154,26,29,17758
11/1/2019,18,10018,1089,5464,919,0,27,17517
11/1/2019,19,10021,1022,5389,838,0,27,17297
11/1/2019,20,10015,1022,5185,818,0,26,17066
11/1/2019,21,10008,908,4956,845,0,26,16743
11/1/2019,22,10012,393,4311,989,0,26,15731
11/1/2019,23,10023,200,4014,928,0,14,15179
11/1/2019,24,10028,192,3556,924,0,3,14703
11/2/2019,1,10028,192,3267,1077,0,0,14564
11/2/2019,2,10032,191,3165,971,0,0,14359
11/2/2019,3,10023,191,3140,1155,0,0,14509
11/2/2019,4,10034,191,3098,1028,0,0,14351
11/2/2019,5,10036,190,3129,1096,0,0,14451
11/2/2019,6,10033,191,3142,1444,0,0,14810
11/2/2019,7,10037,188,3257,1830,0,0,15312
11/2/2019,8,10038,188,3471,2321,4,0,16022
11/2/2019,9,10036,188,3917,2487,17,0,16645
11/2/2019,10,10039,187,4188,2438,50,0,16902
11/2/2019,11,10035,187,4602,2241,61,0,17126
11/2/2019,12,10035,191,4623,2203,74,1,17127
11/2/2019,13,10035,188,4259,2148,70,0,16700
11/2/2019,14,10037,188,4123,1933,66,0,16347
11/2/2019,15,10035,190,4485,1728,57,0,16495
11/2/2019,16,10024,192,4803,1817,32,0,16868
11/2/2019,17,10026,192,4844,1839,18,0,16919
11/2/2019,18,10028,196,4894,1946,0,0,17064
11/2/2019,19,10026,192,4808,2170,0,0,17196
11/2/2019,20,10024,191,4504,2396,0,0,17115
11/2/2019,21,10025,193,4029,2333,0,0,16580
11/2/2019,22,10024,192,3507,2159,0,0,15882
11/2/2019,23,10026,199,3246,2037,0,0,15508
11/2/2019,24,10025,200,3046,953,0,0,14224
11/3/2019,1,10024,194,3079,804,0,0,14101
11/3/2019,2,10030,194,3056,696,0,0,13976
11/3/2019,3,10019,194,3065,709,0,0,13987
11/3/2019,4,10021,194,3048,883,0,0,14146
11/3/2019,5,10022,194,3108,749,0,0,14073
11/3/2019,6,10025,194,3075,704,0,0,13998
11/3/2019,7,10028,197,3220,1541,1,2,14989
11/3/2019,8,10028,197,3311,1922,28,0,15486
11/3/2019,9,10021,245,3262,2256,111,0,15895
11/3/2019,10,10018,289,3456,1922,157,0,15842
11/3/2019,11,10016,429,3468,1767,185,0,15865
11/3/2019,12,10018,716,3457,1875,200,0,16266
11/3/2019,13,10022,823,3470,2048,165,0,16528
11/3/2019,14,10021,825,3770,1673,167,1,16457
11/3/2019,15,10014,825,3948,1340,148,1,16276
11/3/2019,16,10017,825,4266,1433,63,0,16604
11/3/2019,17,10016,841,4775,1233,20,0,16885
11/3/2019,18,10008,1018,5400,1030,0,0,17456
11/3/2019,19,10015,1184,5271,910,0,0,17380
11/3/2019,20,10014,872,4950,1010,0,0,16846
11/3/2019,21,10004,365,4727,1086,0,0,16182
11/3/2019,22,10000,203,4592,1259,0,1,16055
11/3/2019,23,9988,194,3991,1542,0,0,15715
11/3/2019,24,9992,191,3455,1406,0,0,15044
11/4/2019,1,9994,191,3164,1719,0,8,15076
11/4/2019,2,9994,192,3214,1290,0,12,14702
11/4/2019,3,10001,192,3144,1332,0,12,14681
11/4/2019,4,9996,192,3062,1427,0,12,14689
11/4/2019,5,9996,192,3071,1524,0,12,14795
11/4/2019,6,10013,214,3055,2065,0,13,15360
11/4/2019,7,10016,253,3405,2569,2,17,16262
11/4/2019,8,10007,236,3841,3078,6,27,17195
11/4/2019,9,9983,228,3855,3284,26,26,17402
11/4/2019,10,9989,229,3869,3328,68,28,17511
11/4/2019,11,9999,248,3778,3386,103,30,17544
11/4/2019,12,10007,248,3481,3661,130,42,17569
11/4/2019,13,10003,253,3427,3372,155,43,17253
11/4/2019,14,10004,255,3458,3368,117,34,17236
11/4/2019,15,9996,254,3367,3523,100,27,17267
11/4/2019,16,9980,242,3802,3151,41,27,17243
11/4/2019,17,9974,256,4111,3250,9,27,17627
11/4/2019,18,9974,259,4410,3529,0,27,18199
11/4/2019,19,9975,259,4615,3285,0,27,18161
11/4/2019,20,9972,258,4795,3217,0,27,18269
11/4/2019,21,9955,258,4765,3157,0,27,18162
11/4/2019,22,9963,257,4154,2947,0,27,17348
11/4/2019,23,9981,260,3557,2612,0,27,16437
11/4/2019,24,9981,264,3339,1884,0,18,15486
11/5/2019,1,9978,222,3007,1562,0,17,14786
11/5/2019,2,9980,188,2928,1525,0,15,14636
11/5/2019,3,9979,187,2935,1138,0,15,14254
11/5/2019,4,9979,187,2914,1378,0,14,14472
11/5/2019,5,9982,188,3029,1374,0,14,14587
11/5/2019,6,9981,188,3109,1542,0,13,14833
11/5/2019,7,9976,188,3710,2275,1,22,16172
11/5/2019,8,9976,189,4391,2258,4,27,16845
11/5/2019,9,9812,324,4657,2228,37,27,17085
11/5/2019,10,9796,381,4610,2613,64,27,17491
11/5/2019,11,9796,482,3854,3075,89,27,17323
11/5/2019,12,9904,769,3646,2723,143,27,17212
11/5/2019,13,9964,911,3773,2488,187,27,17350
11/5/2019,14,9963,936,3703,2738,125,27,17492
11/5/2019,15,9960,1172,3634,2457,155,27,17405
11/5/2019,16,9961,1194,3929,2361,92,27,17564
11/5/2019,17,9957,1175,4197,2207,19,27,17582
11/5/2019,18,9958,1270,5087,2150,0,27,18492
11/5/2019,19,9953,1279,5045,2232,0,27,18536
11/5/2019,20,9951,1209,4840,2367,0,27,18394
11/5/2019,21,9943,530,4278,2655,0,27,17433
11/5/2019,22,9939,206,4204,2691,0,27,17067
11/5/2019,23,9941,199,3718,2760,0,27,16645
11/5/2019,24,9945,200,3270,2570,0,16,16001
11/6/2019,1,9948,200,3070,2130,0,15,15363
11/6/2019,2,9949,202,3099,2003,0,15,15268
11/6/2019,3,9946,205,3473,1739,0,15,15378
11/6/2019,4,9952,210,3258,1552,0,15,14987
11/6/2019,5,9950,297,3193,1448,0,13,14901
11/6/2019,6,9946,387,3249,1229,0,14,14825
11/6/2019,7,9941,573,4145,1285,2,21,15967
11/6/2019,8,9939,1112,4442,1393,38,29,16953
11/6/2019,9,9935,1175,3954,1218,144,30,16456
11/6/2019,10,9903,1210,4037,1272,247,28,16697
11/6/2019,11,9939,1241,3928,1473,255,29,16865
11/6/2019,12,9949,1272,3777,1818,239,27,17082
11/6/2019,13,9947,1392,3641,1997,210,27,17214
11/6/2019,14,9806,1723,3677,1992,163,29,17390
11/6/2019,15,9771,1876,4274,1823,117,49,17910
11/6/2019,16,9767,1917,4452,1567,24,80,17807
11/6/2019,17,9880,2080,4430,1413,5,97,17905
11/6/2019,18,9933,1824,4814,1372,0,134,18077
11/6/2019,19,9935,1753,4879,1274,0,162,18003
11/6/2019,20,9933,1258,5059,1288,0,188,17726
11/6/2019,21,9936,828,4681,1836,0,146,17427
11/6/2019,22,9932,428,3863,2115,0,108,16446
11/6/2019,23,9923,311,3664,2008,0,83,15989
11/6/2019,24,9933,234,3820,1554,0,76,15617
11/7/2019,1,9932,242,3630,1241,0,26,15071
11/7/2019,2,9934,198,3245,1377,0,11,14765
11/7/2019,3,9929,201,3225,1187,0,11,14553
11/7/2019,4,9930,212,3286,1142,0,11,14581
11/7/2019,5,9922,325,3529,1083,0,11,14870
11/7/2019,6,9929,594,3601,1296,0,13,15433
11/7/2019,7,9928,980,4101,1250,0,19,16278
11/7/2019,8,9925,1288,4459,1220,0,37,16929
11/7/2019,9,9923,1364,4547,1213,3,75,17125
11/7/2019,10,9921,1631,4539,994,8,131,17224
11/7/2019,11,9919,1858,4436,870,18,133,17234
11/7/2019,12,9917,1563,4392,942,45,137,16996
11/7/2019,13,9912,1654,4370,1080,52,170,17238
11/7/2019,14,9920,1399,4436,1130,80,137,17102
11/7/2019,15,9912,1331,4457,1104,79,89,16972
11/7/2019,16,9914,1354,4613,995,52,86,17014
11/7/2019,17,9917,1415,4632,960,18,88,17030
11/7/2019,18,9916,1595,5353,902,0,134,17900
11/7/2019,19,9927,1899,5305,974,0,147,18252
11/7/2019,20,9930,1790,5174,1027,0,156,18077
11/7/2019,21,9929,1848,5140,1181,0,148,18246
11/7/2019,22,9921,1776,4413,1342,0,122,17574
11/7/2019,23,9928,1089,3659,1391,0,90,16157
11/7/2019,24,9927,558,3589,1167,0,37,15278
11/8/2019,1,9924,358,3455,1409,0,12,15158
11/8/2019,2,9923,226,3861,1397,0,11,15418
11/8/2019,3,9929,226,3720,1300,0,10,15185
11/8/2019,4,9938,404,3582,1177,0,10,15111
11/8/2019,5,9934,674,3492,1098,0,12,15210
11/8/2019,6,9940,998,3745,675,0,40,15398
11/8/2019,7,9942,1302,4162,906,1,77,16390
11/8/2019,8,9947,2190,4809,858,10,125,17939
11/8/2019,9,9941,2174,4934,717,64,135,17965
11/8/2019,10,9939,1707,4695,667,166,110,17284
11/8/2019,11,9935,1753,4619,472,232,82,17093
11/8/2019,12,9945,1610,4593,332,255,91,16826
11/8/2019,13,9951,1318,4448,231,279,84,16311
11/8/2019,14,9962,1196,4454,157,320,84,16173
11/8/2019,15,9975,801,4573,129,270,84,15832
11/8/2019,16,9973,694,4954,148,148,103,16020
11/8/2019,17,9969,999,5267,147,32,106,16520
11/8/2019,18,9970,1252,5762,148,0,142,17274
11/8/2019,19,9969,1273,5684,221,0,95,17242
11/8/2019,20,9970,1285,5515,345,0,114,17229
11/8/2019,21,9976,1171,5040,468,0,155,16810
11/8/2019,22,9974,988,4775,622,0,148,16507
11/8/2019,23,9972,613,4170,780,1,107,15643
11/8/2019,24,9969,282,3892,804,0,78,15025
11/9/2019,1,9965,222,3655,855,0,60,14757
11/9/2019,2,9972,194,3778,987,0,14,14945
11/9/2019,3,9979,194,3206,1204,0,0,14583
11/9/2019,4,9973,194,3192,1474,0,0,14833
11/9/2019,5,9983,193,3221,1311,0,0,14708
11/9/2019,6,9985,193,3183,1517,0,0,14878
11/9/2019,7,10005,176,3581,1909,1,0,15672
11/9/2019,8,10004,160,3803,2375,7,0,16349
11/9/2019,9,9995,292,4039,2679,32,0,17037
11/9/2019,10,9995,376,3850,3024,60,0,17305
11/9/2019,11,10000,394,3763,3309,86,0,17552
11/9/2019,12,10001,320,3755,3406,115,0,17597
11/9/2019,13,9999,459,3628,3468,132,0,17686
11/9/2019,14,10004,435,3600,3561,88,0,17688
11/9/2019,15,10001,686,3494,3286,82,0,17549
11/9/2019,16,10002,592,3602,3359,39,0,17594
11/9/2019,17,10004,585,4317,3376,9,0,18291
11/9/2019,18,10005,583,4629,3340,0,0,18557
11/9/2019,19,10010,583,4343,3371,0,0,18307
11/9/2019,20,10029,581,4036,3104,0,0,17750
11/9/2019,21,10024,593,3929,2887,0,0,17433
11/9/2019,22,9995,492,3612,2855,0,0,16954
11/9/2019,23,9997,389,3178,2655,0,0,16219
11/9/2019,24,10014,233,3163,2051,0,0,15461
11/10/2019,1,10010,195,3015,1570,0,0,14790
11/10/2019,2,10008,192,3050,1303,0,0,14553
11/10/2019,3,9993,191,3059,1109,0,0,14352
11/10/2019,4,10012,197,3026,1014,0,0,14249
11/10/2019,5,10022,196,3134,1244,0,0,14596
11/10/2019,6,10024,192,3106,1474,0,0,14796
11/10/2019,7,10027,193,3220,1623,2,2,15067
11/10/2019,8,10025,194,3540,1317,6,3,15085
11/10/2019,9,10022,323,3703,1586,34,0,15668
11/10/2019,10,10021,406,3810,1751,71,0,16059
11/10/2019,11,10021,517,4142,1446,99,0,16225
11/10/2019,12,10022,565,4380,1439,68,1,16475
11/10/2019,13,10024,784,4210,1441,89,1,16549
11/10/2019,14,10023,761,4178,1446,86,0,16494
11/10/2019,15,10018,836,4598,1292,51,0,16795
11/10/2019,16,9980,782,4906,1158,24,0,16850
11/10/2019,17,10012,851,5039,1127,1,0,17030
11/10/2019,18,10017,751,5384,1263,0,0,17415
11/10/2019,19,10020,611,5217,1088,0,0,16936
11/10/2019,20,10014,613,5401,702,0,0,16730
11/10/2019,21,10017,821,5315,641,0,0,16794
11/10/2019,22,10014,291,4581,680,0,0,15566
11/10/2019,23,10014,194,4314,746,0,0,15268
11/10/2019,24,10011,195,3989,823,0,0,15018
11/11/2019,1,10013,196,3652,858,0,0,14719
11/11/2019,2,10012,204,3650,858,0,0,14724
11/11/2019,3,10005,222,3613,781,0,0,14621
11/11/2019,4,10009,237,3730,721,0,8,14705
11/11/2019,5,10010,276,3171,856,0,9,14322
11/11/2019,6,10009,312,3351,619,0,30,14321
11/11/2019,7,10010,479,4096,725,0,71,15381
11/11/2019,8,10010,765,4844,933,0,87,16639
11/11/2019,9,10009,1097,5025,1031,4,128,17294
11/11/2019,10,10011,1192,4939,1226,14,134,17516
11/11/2019,11,10023,1166,4833,1525,24,128,17699
11/11/2019,12,10029,1222,4807,1654,32,117,17861
11/11/2019,13,10032,1379,4722,1824,36,135,18128
11/11/2019,14,10013,1205,4779,1892,36,114,18039
11/11/2019,15,10006,1224,4842,2010,29,70,18181
11/11/2019,16,10009,1335,4840,2287,16,34,18521
11/11/2019,17,10012,1315,5207,2345,2,39,18920
11/11/2019,18,10017,1838,5797,2281,0,47,19980
11/11/2019,19,10030,2042,5785,2280,0,47,20184
11/11/2019,20,10032,1606,5526,2304,0,49,19517
11/11/2019,21,10026,1097,5092,2424,0,48,18687
11/11/2019,22,10021,491,4552,2265,0,45,17374
11/11/2019,23,10024,297,4546,2044,0,47,16958
11/11/2019,24,10033,304,4308,1839,0,45,16529
11/12/2019,1,10031,314,3902,1697,0,42,15986
11/12/2019,2,10033,410,3939,1390,0,40,15812
11/12/2019,3,10037,435,3953,1256,0,39,15720
11/12/2019,4,10038,636,4134,1333,0,38,16179
11/12/2019,5,10042,791,4082,1259,0,41,16215
11/12/2019,6,10039,1165,3773,1055,0,48,16080
11/12/2019,7,10046,2004,4319,1427,0,74,17870
11/12/2019,8,9977,2681,4324,1365,1,116,18464
11/12/2019,9,9968,2516,4200,1256,2,162,18104
11/12/2019,10,9955,2518,4280,1343,9,159,18264
11/12/2019,11,9955,2798,4150,1457,17,161,18538
11/12/2019,12,9938,2452,4015,1542,24,161,18132
11/12/2019,13,9950,2136,4061,1724,29,162,18062
11/12/2019,14,9950,2417,4096,1797,28,163,18451
11/12/2019,15,9772,2282,4086,1923,23,157,18243
11/12/2019,16,9590,2407,4147,2029,12,155,18340
11/12/2019,17,9597,2847,4869,2079,2,156,19550
11/12/2019,18,9596,3018,5283,2143,0,155,20195
11/12/2019,19,9596,3124,5188,2116,0,211,20235
11/12/2019,20,9594,3012,4834,2092,0,221,19753
11/12/2019,21,9591,3154,4743,2073,0,201,19762
11/12/2019,22,9592,2596,4230,2066,0,175,18659
11/12/2019,23,9580,2168,3981,1762,0,106,17597
11/12/2019,24,9584,1949,3750,1529,0,44,16856
11/13/2019,1,9590,1836,3520,1545,0,29,16520
11/13/2019,2,9594,1854,3473,1509,0,27,16457
11/13/2019,3,9599,1726,3393,1334,0,34,16086
11/13/2019,4,9601,1767,3415,1235,0,34,16052
11/13/2019,5,9593,1823,3619,958,0,32,16025
11/13/2019,6,9593,1999,3909,899,0,55,16455
11/13/2019,7,9598,3034,4709,882,1,93,18317
11/13/2019,8,9599,3798,4849,746,3,132,19127
11/13/2019,9,9596,4330,4831,701,17,141,19616
11/13/2019,10,9580,4474,4553,652,34,140,19433
11/13/2019,11,9567,4266,4378,600,49,140,19000
11/13/2019,12,9562,4164,4161,573,52,142,18654
11/13/2019,13,9567,3314,4115,928,54,139,18117
11/13/2019,14,9431,3271,4114,1149,53,140,18158
11/13/2019,15,9423,3290,4111,1176,54,137,18191
11/13/2019,16,9423,3290,4111,1176,54,137,18191
11/13/2019,17,9125,3535,4663,1330,6,137,18796
11/13/2019,18,9123,3572,5096,1751,0,137,19679
11/13/2019,19,9122,3431,5311,2053,0,137,20054
11/13/2019,20,9119,3870,5120,2196,0,177,20482
11/13/2019,21,9114,3516,4756,2506,0,185,20077
11/13/2019,22,9106,3380,3958,2622,0,159,19225
11/13/2019,23,9104,2015,3506,2482,0,96,17203
11/13/2019,24,9108,1477,3694,2579,0,31,16889
11/14/2019,1,9105,1576,3624,2541,0,12,16858
11/14/2019,2,9097,1311,3424,2601,0,12,16445
11/14/2019,3,9113,1168,3362,2397,0,12,16052
11/14/2019,4,9116,1144,3540,2145,0,12,15957
11/14/2019,5,9117,1692,3717,1958,0,11,16495
11/14/2019,6,9108,2092,3790,1737,0,12,16739
11/14/2019,7,9112,3092,4468,1742,0,15,18429
11/14/2019,8,9048,4043,4743,1449,1,48,19332
11/14/2019,9,9043,4154,5013,1149,1,81,19441
11/14/2019,10,9031,4040,4784,1158,3,110,19126
11/14/2019,11,9027,3129,4530,1274,3,201,18164
11/14/2019,12,9053,2775,4210,1346,7,207,17598
11/14/2019,13,9101,2867,4323,1399,7,205,17902
11/14/2019,14,9104,2924,4133,1368,6,207,17742
11/14/2019,15,9104,3286,4168,1325,4,205,18092
11/14/2019,16,9110,3354,4256,1242,3,160,18125
11/14/2019,17,9112,3323,4525,1415,0,157,18532
11/14/2019,18,9111,3474,4813,1652,0,180,19230
11/14/2019,19,9112,3176,4757,1932,0,138,19115
11/14/2019,20,9107,2829,4644,2410,0,110,19100
11/14/2019,21,9100,2287,4423,2584,0,86,18480
11/14/2019,22,9100,1951,3787,2700,0,85,17623
11/14/2019,23,9091,1057,3363,2824,0,40,16375
11/14/2019,24,9091,365,3271,2781,0,21,15529
11/15/2019,1,9092,265,3044,3114,0,14,15529
11/15/2019,2,9101,266,2963,3214,0,10,15554
11/15/2019,3,9096,266,2984,3048,0,10,15404
11/15/2019,4,9097,275,2999,2947,0,10,15328
11/15/2019,5,9104,349,3063,2980,0,10,15506
11/15/2019,6,9102,552,3386,2847,0,14,15901
11/15/2019,7,9100,810,3698,3138,2,19,16767
11/15/2019,8,9104,1197,4100,3490,2,45,17938
11/15/2019,9,9101,1341,4582,3433,19,79,18555
11/15/2019,10,9096,1889,4928,2986,33,95,19027
11/15/2019,11,9090,2072,4443,2736,85,88,18514
11/15/2019,12,9073,1929,4337,2584,67,85,18075
11/15/2019,13,9081,1721,4307,2329,62,84,17584
11/15/2019,14,9100,1952,4356,2218,57,86,17769
11/15/2019,15,9105,2481,4434,2159,69,86,18334
11/15/2019,16,9104,2118,4581,2097,36,84,18020
11/15/2019,17,9106,2672,4753,2006,4,85,18626
11/15/2019,18,9106,3204,5106,1751,0,83,19250
11/15/2019,19,9106,3013,4953,1693,0,84,18849
11/15/2019,20,9106,2914,4977,1747,0,83,18827
11/15/2019,21,9107,2504,4744,1737,0,82,18174
11/15/2019,22,9088,1957,4703,1547,0,85,17380
11/15/2019,23,9094,1712,4126,1612,0,42,16586
11/15/2019,24,9096,1048,3926,1704,0,22,15796
11/16/2019,1,9104,557,3583,1849,0,10,15103
11/16/2019,2,9098,596,3530,1878,0,0,15102
11/16/2019,3,9103,767,3502,1750,0,0,15122
11/16/2019,4,9092,969,3459,1830,0,0,15350
11/16/2019,5,9086,970,3266,2055,0,0,15377
11/16/2019,6,9100,971,3437,2063,0,0,15571
11/16/2019,7,9104,951,3541,2095,2,0,15693
11/16/2019,8,9106,915,3816,2055,18,15,15925
11/16/2019,9,9106,1044,4139,2052,119,58,16518
11/16/2019,10,9105,1337,4212,1761,230,79,16724
11/16/2019,11,9105,1554,4119,1703,288,111,16880
11/16/2019,12,9100,1520,4135,1520,311,117,16703
11/16/2019,13,9100,1638,4052,1291,316,118,16515
11/16/2019,14,9096,1284,4022,1384,307,80,16173
11/16/2019,15,9097,1216,4003,1534,239,58,16147
11/16/2019,16,9098,1334,4005,1665,124,58,16284
11/16/2019,17,9098,1325,4579,1784,22,58,16866
11/16/2019,18,9101,1776,5062,2064,0,58,18061
11/16/2019,19,9106,1730,4946,2438,0,66,18286
11/16/2019,20,9110,1210,4877,2728,0,56,17981
11/16/2019,21,9107,1128,4508,2930,0,56,17729
11/16/2019,22,9104,654,4217,3024,0,57,17056
11/16/2019,23,9098,478,4144,2872,0,10,16602
11/16/2019,24,9101,401,3849,2739,0,0,16090
11/17/2019,1,9100,335,3746,2616,0,0,15797
11/17/2019,2,9100,406,3649,2538,0,0,15693
11/17/2019,3,9096,394,3463,2261,0,0,15214
11/17/2019,4,9097,600,3773,1960,0,0,15430
11/17/2019,5,9107,876,3698,1858,0,0,15539
11/17/2019,6,9104,969,3613,1869,0,1,15556
11/17/2019,7,9095,990,3916,1801,1,0,15803
11/17/2019,8,9099,1069,4123,1920,20,17,16248
11/17/2019,9,9094,1230,4009,1749,131,53,16266
11/17/2019,10,9095,1393,4230,1126,246,59,16149
11/17/2019,11,9090,1605,4199,760,306,73,16033
11/17/2019,12,9088,1667,4196,585,344,60,15940
11/17/2019,13,9092,1877,4095,596,355,60,16075
11/17/2019,14,9094,2257,4025,483,339,56,16254
11/17/2019,15,9064,2437,3883,282,234,56,15956
11/17/2019,16,9102,2585,4295,532,94,56,16664
11/17/2019,17,9102,2878,4538,724,17,61,17320
11/17/2019,18,9109,3260,5066,977,0,125,18537
11/17/2019,19,9108,3379,5005,1216,0,93,18801
11/17/2019,20,9108,3160,4907,1366,0,11,18552
11/17/2019,21,9119,2618,4803,1384,0,1,17925
11/17/2019,22,9119,1824,4763,1297,0,0,17003
11/17/2019,23,9116,1603,4386,1067,0,0,16172
11/17/2019,24,9122,1672,4007,948,0,0,15749
11/18/2019,1,9116,1300,3826,737,0,0,14979
11/18/2019,2,9119,1383,3639,645,0,10,14796
11/18/2019,3,9116,1787,3684,587,0,10,15184
11/18/2019,4,9112,1778,3578,571,0,10,15049
11/18/2019,5,9118,2020,3531,375,0,13,15057
11/18/2019,6,9118,2381,3703,353,0,19,15574
11/18/2019,7,9127,3263,4352,391,0,37,17170
11/18/2019,8,9131,4106,4662,467,2,86,18454
11/18/2019,9,9119,3698,4644,639,32,149,18281
11/18/2019,10,9111,3776,4713,706,86,161,18553
11/18/2019,11,9109,4224,4406,529,115,159,18542
11/18/2019,12,9124,4449,4233,478,131,155,18570
11/18/2019,13,9124,4276,4166,460,149,155,18330
11/18/2019,14,9126,4601,4227,325,149,157,18585
11/18/2019,15,9126,4907,4246,237,90,189,18795
11/18/2019,16,9117,4955,4244,254,56,189,18815
11/18/2019,17,9117,4839,4518,337,13,170,18994
11/18/2019,18,9017,4766,4946,422,0,181,19332
11/18/2019,19,9176,4533,4913,407,0,187,19216
11/18/2019,20,9298,4367,4766,463,1,160,19055
11/18/2019,21,9357,4281,4728,493,0,154,19013
11/18/2019,22,9355,4075,4367,409,0,132,18338
11/18/2019,23,9349,3371,4033,378,0,49,17180
11/18/2019,24,9524,2356,3729,309,0,12,15930
11/19/2019,1,9758,2114,3626,293,0,4,15795
11/19/2019,2,9782,2006,3697,280,0,4,15769
11/19/2019,3,9782,1949,3423,222,0,3,15379
11/19/2019,4,9785,1935,3593,214,0,3,15530
11/19/2019,5,9794,1897,3633,177,0,4,15505
11/19/2019,6,9784,2091,3924,170,0,7,15976
11/19/2019,7,9785,2690,4448,118,1,22,17064
11/19/2019,8,9757,3749,4567,147,4,37,18261
11/19/2019,9,9709,3808,4470,167,23,76,18253
11/19/2019,10,9702,3677,4470,88,74,98,18109
11/19/2019,11,9701,3562,4348,43,144,101,17899
11/19/2019,12,9707,3707,4077,23,223,98,17835
11/19/2019,13,9705,3698,4028,13,179,100,17723
11/19/2019,14,9707,3725,4101,8,124,101,17766
11/19/2019,15,9738,3744,4166,5,73,101,17827
11/19/2019,16,9783,3936,4260,4,38,102,18123
11/19/2019,17,9783,4087,4818,7,7,100,18802
11/19/2019,18,9785,4435,5030,9,0,111,19370
11/19/2019,19,9789,4152,4996,26,0,142,19105
11/19/2019,20,9789,3873,4733,27,0,156,18578
11/19/2019,21,9786,3789,4722,40,0,149,18486
11/19/2019,22,9783,3262,4353,36,0,139,17573
11/19/2019,23,9784,2577,4027,32,0,99,16519
11/19/2019,24,9779,1744,3863,52,0,29,15467
11/20/2019,1,9784,1252,3602,85,0,11,14734
11/20/2019,2,9783,1120,3458,130,0,10,14501
11/20/2019,3,9787,1355,3498,171,0,9,14820
11/20/2019,4,9786,1214,3355,167,0,9,14531
11/20/2019,5,9799,1556,3423,219,0,10,15007
11/20/2019,6,9811,1988,3425,199,0,22,15445
11/20/2019,7,9807,2223,4088,368,1,61,16548
11/20/2019,8,9807,2711,4470,414,5,106,17513
11/20/2019,9,9805,2874,4582,433,21,137,17852
11/20/2019,10,9851,2788,4595,416,56,163,17869
11/20/2019,11,9834,2930,4334,384,109,169,17760
11/20/2019,12,9802,2514,4252,391,136,174,17269
11/20/2019,13,9806,2371,4207,384,192,177,17137
11/20/2019,14,9804,2345,4099,360,199,182,16989
11/20/2019,15,9806,2600,4191,246,85,52,16980
11/20/2019,16,9802,2738,4369,177,39,27,17152
11/20/2019,17,9804,3059,4673,151,7,41,17735
11/20/2019,18,9802,3513,4975,168,0,81,18539
11/20/2019,19,9806,3347,4940,189,0,133,18415
11/20/2019,20,9805,3465,4656,265,0,166,18357
11/20/2019,21,9797,3117,4676,312,0,163,18065
11/20/2019,22,9796,2877,4445,309,0,164,17591
11/20/2019,23,9796,2303,3934,389,0,149,16571
11/20/2019,24,9792,1688,3388,453,0,62,15383
11/21/2019,1,9809,1170,3457,521,0,12,14969
11/21/2019,2,9818,789,3293,542,0,12,14454
11/21/2019,3,9803,430,3319,603,0,13,14168
11/21/2019,4,9790,349,3350,817,0,16,14322
11/21/2019,5,9809,428,3121,1088,0,20,14466
11/21/2019,6,9810,706,3175,1157,0,55,14903
11/21/2019,7,9819,708,3652,1647,1,75,15902
11/21/2019,8,9826,815,3904,2332,13,83,16973
11/21/2019,9,9826,960,3847,2974,36,80,17723
11/21/2019,10,9824,896,4130,3118,60,82,18110
11/21/2019,11,9826,945,4107,3284,58,83,18303
11/21/2019,12,9824,952,3984,3388,59,41,18248
11/21/2019,13,9824,972,3876,3619,39,27,18357
11/21/2019,14,9823,969,3930,3728,41,27,18518
11/21/2019,15,9819,808,4138,3734,32,26,18557
11/21/2019,16,9823,896,4203,3705,16,26,18669
11/21/2019,17,9809,1127,4264,3645,2,27,18874
11/21/2019,18,9804,1010,3968,4122,0,26,18930
11/21/2019,19,9802,841,3878,3997,0,26,18544
11/21/2019,20,9803,828,3829,4208,0,26,18694
11/21/2019,21,9798,505,3924,4345,0,26,18598
11/21/2019,22,9799,437,3716,4345,0,26,18323
11/21/2019,23,9800,439,3384,3993,0,26,17642
11/21/2019,24,9804,438,3545,2944,0,14,16745
11/22/2019,1,9800,341,3171,2616,0,12,15940
11/22/2019,2,9806,332,3120,2035,0,12,15305
11/22/2019,3,9805,335,3325,1600,0,11,15076
11/22/2019,4,9797,335,3323,1608,0,11,15074
11/22/2019,5,9805,336,3304,1907,0,13,15365
11/22/2019,6,9820,338,3338,2685,0,12,16193
11/22/2019,7,9828,349,3530,3391,0,16,17114
11/22/2019,8,9821,527,3823,3980,2,26,18179
11/22/2019,9,9818,725,3964,4031,29,27,18594
11/22/2019,10,9825,1000,3767,3904,95,27,18618
11/22/2019,11,9824,1182,3879,3533,141,26,18585
11/22/2019,12,9824,1460,3815,3392,132,26,18649
11/22/2019,13,9949,1618,3741,2966,142,26,18442
11/22/2019,14,9977,1671,3802,2740,115,26,18331
11/22/2019,15,9981,1621,3840,2842,69,26,18379
11/22/2019,16,9920,1725,3997,2374,41,26,18083
11/22/2019,17,9953,2385,4390,1966,10,26,18730
11/22/2019,18,9969,2817,4505,1668,0,26,18985
11/22/2019,19,9965,2306,4372,1488,0,26,18157
11/22/2019,20,9963,2060,4317,1370,0,27,17737
11/22/2019,21,9960,2310,4184,1146,0,26,17626
11/22/2019,22,9961,2056,3986,905,0,26,16934
11/22/2019,23,9960,1749,3813,822,0,27,16371
11/22/2019,24,9969,878,3809,939,0,13,15608
11/23/2019,1,10008,587,3495,1146,0,0,15236
11/23/2019,2,10032,427,3489,1257,0,0,15205
11/23/2019,3,10035,416,3512,1388,0,0,15351
11/23/2019,4,10035,406,3419,1537,0,0,15397
11/23/2019,5,10035,435,3306,1355,0,0,15131
11/23/2019,6,10037,655,3427,1583,0,0,15702
11/23/2019,7,10033,1058,3521,1486,0,0,16098
11/23/2019,8,10030,1123,3734,1549,4,0,16440
11/23/2019,9,10008,1125,3662,1669,35,0,16499
11/23/2019,10,9979,1133,3800,1603,84,0,16599
11/23/2019,11,9975,1281,3875,1621,156,1,16909
11/23/2019,12,9978,1248,3874,1304,265,2,16671
11/23/2019,13,9978,1253,4078,1303,293,0,16905
11/23/2019,14,9978,1515,4109,1029,253,0,16884
11/23/2019,15,9981,1906,4296,864,113,0,17160
11/23/2019,16,9981,1979,4235,681,33,0,16909
11/23/2019,17,10041,1976,4475,622,4,0,17118
11/23/2019,18,10037,1941,4640,752,0,0,17370
11/23/2019,19,10037,1709,4343,917,0,0,17006
11/23/2019,20,10037,1037,4382,797,0,0,16253
11/23/2019,21,10024,624,4548,655,0,0,15851
11/23/2019,22,10026,623,4441,765,0,0,15855
11/23/2019,23,10026,545,3905,1011,0,0,15487
11/23/2019,24,10036,410,3456,1120,0,0,15022
11/24/2019,1,10046,312,3398,1210,0,0,14966
11/24/2019,2,10043,312,3446,1182,0,0,14983
11/24/2019,3,10026,311,3635,1094,0,0,15066
11/24/2019,4,10001,347,3926,878,0,0,15152
11/24/2019,5,10016,462,3939,856,0,0,15273
11/24/2019,6,10034,345,3666,898,0,0,14943
11/24/2019,7,10045,315,3693,1287,2,0,15342
11/24/2019,8,10048,320,4151,1171,6,0,15696
11/24/2019,9,10044,444,4422,1185,31,0,16126
11/24/2019,10,10010,337,4221,1250,125,3,15946
11/24/2019,11,9988,432,4031,1460,266,3,16180
11/24/2019,12,9983,435,3567,1703,300,0,15988
11/24/2019,13,9986,439,3485,2245,318,0,16473
11/24/2019,14,9992,445,3710,1774,321,0,16242
11/24/2019,15,9994,375,3826,1943,236,0,16374
11/24/2019,16,10042,517,3837,2564,91,0,17051
11/24/2019,17,10046,551,3975,3220,11,0,17803
11/24/2019,18,10030,695,4417,3389,0,0,18531
11/24/2019,19,10032,693,4721,3130,0,0,18576
11/24/2019,20,10029,539,4600,3121,0,0,18289
11/24/2019,21,10031,506,4443,2974,0,0,17954
11/24/2019,22,10032,348,4357,2715,0,0,17452
11/24/2019,23,10030,314,4151,2452,0,0,16947
11/24/2019,24,10010,313,3624,2197,0,0,16144
11/25/2019,1,10012,364,3840,1767,0,0,15983
11/25/2019,2,10013,337,3554,1642,0,6,15552
11/25/2019,3,10015,315,3635,1358,0,11,15334
11/25/2019,4,10014,314,3760,1176,0,11,15275
11/25/2019,5,10014,333,3581,1143,0,12,15083
11/25/2019,6,10013,341,3437,1174,0,14,14979
11/25/2019,7,10006,345,3882,1285,1,16,15535
11/25/2019,8,10003,458,4483,1531,7,25,16507
11/25/2019,9,10006,470,4452,1593,57,26,16604
11/25/2019,10,10002,556,4296,1651,137,26,16668
11/25/2019,11,10007,1018,4387,1668,203,29,17312
11/25/2019,12,10005,1277,4451,1592,195,27,17547
11/25/2019,13,10006,1266,4438,1579,136,26,17451
11/25/2019,14,10009,1504,4301,1599,85,26,17524
11/25/2019,15,10017,1182,4284,1650,53,26,17212
11/25/2019,16,10015,1154,4131,1581,25,26,16932
11/25/2019,17,10027,1154,4490,1453,8,26,17158
11/25/2019,18,10033,1368,4910,1702,0,27,18040
11/25/2019,19,10032,1164,4206,2325,0,26,17753
11/25/2019,20,10033,1153,3963,2503,0,26,17678
11/25/2019,21,10037,638,3891,2722,0,27,17315
11/25/2019,22,10042,323,3831,2956,0,27,17179
11/25/2019,23,10046,317,3282,3127,0,27,16799
11/25/2019,24,10042,317,3078,2828,0,18,16283
11/26/2019,1,10045,318,2955,2714,0,12,16044
11/26/2019,2,10044,322,2982,2668,0,11,16027
11/26/2019,3,10040,327,2976,2348,0,11,15702
11/26/2019,4,10041,408,2998,1856,0,11,15314
11/26/2019,5,10044,651,3040,1845,0,12,15592
11/26/2019,6,10044,922,2991,2253,0,16,16226
11/26/2019,7,10040,1186,3840,2049,2,21,17138
11/26/2019,8,10035,1214,4602,2016,6,26,17899
11/26/2019,9,10040,1474,4883,1390,56,26,17869
11/26/2019,10,10033,1508,4612,922,138,26,17239
11/26/2019,11,10015,1287,4125,652,209,26,16314
11/26/2019,12,10014,1338,4357,361,254,27,16351
11/26/2019,13,10012,1417,4411,309,242,26,16417
11/26/2019,14,10012,1509,4396,240,218,26,16401
11/26/2019,15,10031,1314,4492,207,126,26,16196
11/26/2019,16,10030,1376,4385,118,59,26,15994
11/26/2019,17,10035,1617,4590,66,6,26,16340
11/26/2019,18,10035,1986,4981,83,0,26,17111
11/26/2019,19,10039,2043,4822,319,0,27,17250
11/26/2019,20,10039,1646,4701,714,0,27,17127
11/26/2019,21,10036,897,4166,1233,0,27,16359
11/26/2019,22,10039,612,4229,1652,0,26,16558
11/26/2019,23,10018,506,3689,1878,0,26,16117
11/26/2019,24,10016,335,3500,1641,0,21,15513
11/27/2019,1,10035,315,3210,1837,0,13,15410
11/27/2019,2,10051,316,2987,2237,0,11,15602
11/27/2019,3,10046,317,2906,2240,0,12,15521
11/27/2019,4,10038,331,2863,2011,0,11,15254
11/27/2019,5,10037,348,2878,2403,0,12,15678
11/27/2019,6,10038,358,3233,2723,0,14,16366
11/27/2019,7,10037,321,3577,3204,0,21,17160
11/27/2019,8,10035,320,3943,3917,0,26,18241
11/27/2019,9,10030,374,4165,4188,8,26,18791
11/27/2019,10,10027,257,4209,4248,25,26,18792
11/27/2019,11,10029,290,4156,4301,42,26,18844
11/27/2019,12,10039,313,4188,4211,63,26,18840
11/27/2019,13,10034,406,4320,4050,59,26,18895
11/27/2019,14,9980,517,4467,3892,68,26,18950
11/27/2019,15,9921,937,4261,3665,66,26,18876
11/27/2019,16,10121,985,4261,3914,9,26,19316
11/27/2019,17,10279,996,4362,3961,0,26,19624
11/27/2019,18,10282,970,4779,3994,0,27,20052
11/27/2019,19,10293,706,4425,4182,0,26,19632
11/27/2019,20,10288,700,4325,3990,0,26,19329
11/27/2019,21,10292,559,4300,4280,0,26,19457
11/27/2019,22,10284,533,4124,4123,0,27,19091
11/27/2019,23,10286,387,3950,3288,0,27,17938
11/27/2019,24,10288,327,4005,2065,0,18,16703
11/28/2019,1,10361,320,3665,1549,0,14,15909
11/28/2019,2,10441,318,3734,1209,0,11,15713
11/28/2019,3,10315,325,3995,837,0,11,15483
11/28/2019,4,10288,361,3921,877,0,12,15459
11/28/2019,5,10231,386,4115,870,0,14,15616
11/28/2019,6,10244,502,3953,1281,0,15,15995
11/28/2019,7,10515,802,4173,1689,0,21,17200
11/28/2019,8,10531,1438,4258,2256,1,26,18510
11/28/2019,9,10539,1907,4242,2604,11,26,19329
11/28/2019,10,10579,2015,4248,2569,30,26,19467
11/28/2019,11,10155,2051,4295,2923,59,26,19509
11/28/2019,12,10049,2170,4314,2770,69,26,19398
11/28/2019,13,10120,2152,4026,2500,90,26,18914
11/28/2019,14,10389,2532,4039,1892,98,26,18976
11/28/2019,15,10544,2570,3979,1794,57,26,18970
11/28/2019,16,10527,2506,3954,1592,20,26,18625
11/28/2019,17,10524,2531,4127,1601,1,26,18810
11/28/2019,18,10527,2540,4648,1778,1,26,19520
11/28/2019,19,10542,1684,5008,1431,0,26,18691
11/28/2019,20,10564,1382,5039,1230,0,25,18240
11/28/2019,21,10555,1295,4929,1096,0,26,17901
11/28/2019,22,10555,824,4647,1039,0,26,17091
11/28/2019,23,10554,298,4550,812,0,26,16240
11/28/2019,24,10555,234,4445,563,0,18,15815
11/29/2019,1,10563,305,4263,391,0,13,15535
11/29/2019,2,10561,263,4051,327,0,12,15214
11/29/2019,3,10663,342,4132,195,0,10,15342
11/29/2019,4,10678,647,4001,118,0,11,15455
11/29/2019,5,10677,979,3813,79,0,13,15561
11/29/2019,6,10704,1229,3871,66,0,24,15894
11/29/2019,7,10721,1256,4297,84,1,63,16422
11/29/2019,8,10719,1461,4819,116,2,102,17219
11/29/2019,9,10725,1836,4708,139,17,156,17581
11/29/2019,10,10748,1867,4725,145,33,165,17683
11/29/2019,11,10755,1590,4695,86,60,154,17340
11/29/2019,12,10751,2054,4816,39,73,135,17868
11/29/2019,13,10752,2089,4586,45,96,163,17731
11/29/2019,14,10749,1848,4508,32,102,146,17385
11/29/2019,15,10751,1759,4455,45,59,88,17157
11/29/2019,16,10762,1940,4517,110,37,83,17449
11/29/2019,17,10775,1929,4857,162,4,81,17808
11/29/2019,18,10776,2027,5211,131,0,138,18283
11/29/2019,19,10779,2068,5278,157,0,150,18432
11/29/2019,20,10783,1915,5154,210,0,89,18151
11/29/2019,21,10782,1798,5031,249,0,94,17954
11/29/2019,22,10796,1685,4832,258,0,92,17663
11/29/2019,23,10786,845,4390,229,0,94,16344
11/29/2019,24,10789,577,4079,186,0,26,15657
11/30/2019,1,10792,434,3705,167,0,0,15098
11/30/2019,2,10798,309,3757,210,0,0,15074
11/30/2019,3,10790,214,3580,255,0,1,14840
11/30/2019,4,10568,222,3669,433,0,0,14892
11/30/2019,5,10547,239,3815,545,0,0,15146
11/30/2019,6,10691,274,3834,540,0,0,15339
11/30/2019,7,10826,512,3864,658,2,0,15862
11/30/2019,8,10830,753,4064,794,4,0,16445
11/30/2019,9,10830,854,4101,814,37,0,16636
11/30/2019,10,10822,926,4353,814,106,0,17021
11/30/2019,11,10815,1403,4046,851,228,0,17343
11/30/2019,12,10826,1321,3695,817,286,0,16945
11/30/2019,13,10828,1323,3632,833,279,0,16895
11/30/2019,14,10823,1328,3694,1205,213,0,17263
11/30/2019,15,10829,1304,3808,1499,141,0,17581
11/30/2019,16,10824,1166,4027,1683,54,0,17754
11/30/2019,17,10823,1109,4332,1897,5,0,18166
11/30/2019,18,10851,1057,4399,2607,0,0,18914
11/30/2019,19,10861,524,4207,2798,0,0,18390
11/30/2019,20,10860,291,3933,3189,0,0,18273
11/30/2019,21,10851,199,3979,3551,0,0,18580
11/30/2019,22,10850,198,3780,3787,0,0,18615
11/30/2019,23,10850,198,3348,3603,0,0,17999
11/30/2019,24,10856,198,3010,3626,0,0,17690
12/1/2019,1,10850,198,2988,2868,0,0,16904
12/1/2019,2,10848,205,3059,2398,0,0,16510
12/1/2019,3,10846,206,2953,2282,0,1,16288
12/1/2019,4,10849,226,2913,2505,0,14,16507
12/1/2019,5,10849,240,2945,2590,0,13,16637
12/1/2019,6,10827,237,2863,2984,0,6,16917
12/1/2019,7,10784,239,3109,3352,1,0,17485
12/1/2019,8,10789,256,3424,3419,2,2,17892
12/1/2019,9,10788,652,4482,2760,9,3,18694
12/1/2019,10,10785,1085,4807,2185,27,9,18898
12/1/2019,11,10782,1067,4547,1988,42,11,18437
12/1/2019,12,10785,1318,4375,1708,57,12,18255
12/1/2019,13,10781,1728,4102,1574,56,15,18256
12/1/2019,14,10780,1770,4232,1368,56,9,18215
12/1/2019,15,10779,2058,4220,1053,35,1,18146
12/1/2019,16,10836,2220,4397,1044,13,1,18511
12/1/2019,17,10848,2396,4611,1095,0,0,18950
12/1/2019,18,10852,2570,4622,1140,0,0,19184
12/1/2019,19,10859,2297,4742,1266,0,1,19165
12/1/2019,20,10855,2231,4695,1192,0,0,18973
12/1/2019,21,10854,2129,4527,1089,0,0,18599
12/1/2019,22,10848,1977,4267,1122,0,1,18215
12/1/2019,23,10836,1445,3447,900,0,2,16630
12/1/2019,24,10829,522,3388,734,0,0,15473
12/2/2019,1,10839,270,3481,986,0,0,15576
12/2/2019,2,10840,240,3420,1306,0,0,15806
12/2/2019,3,10853,334,3433,1328,0,7,15955
12/2/2019,4,10871,470,3484,1383,0,12,16220
12/2/2019,5,10878,713,3231,1515,0,13,16350
12/2/2019,6,10879,1283,3293,1229,0,15,16699
12/2/2019,7,10887,1614,4038,1672,0,35,18246
12/2/2019,8,10886,2469,4466,1793,0,80,19694
12/2/2019,9,10884,2642,4752,1421,4,127,19830
12/2/2019,10,10890,2821,4723,1124,25,151,19734
12/2/2019,11,10895,3423,4709,1061,42,195,20325
12/2/2019,12,10888,2846,4381,1291,56,150,19612
12/2/2019,13,10893,2346,4253,1427,60,87,19066
12/2/2019,14,10881,2284,3945,1206,70,85,18471
12/2/2019,15,10882,2313,4314,1049,61,84,18703
12/2/2019,16,10887,2488,4462,1044,24,88,18993
12/2/2019,17,10884,2956,4900,958,2,115,19815
12/2/2019,18,10883,3445,5174,939,0,146,20587
12/2/2019,19,10884,3322,5115,1059,0,171,20551
12/2/2019,20,10882,2792,5003,1236,0,122,20035
12/2/2019,21,10878,2443,4732,1327,0,103,19483
12/2/2019,22,10877,2450,4547,1045,0,113,19032
12/2/2019,23,10873,1783,4312,629,0,112,17709
12/2/2019,24,10867,1011,4063,543,0,78,16562
12/3/2019,1,10867,634,3995,501,0,65,16062
12/3/2019,2,10866,561,3847,389,0,23,15686
12/3/2019,3,10870,506,3573,416,0,13,15378
12/3/2019,4,10871,517,3526,444,0,13,15371
12/3/2019,5,10871,633,3801,497,0,13,15815
12/3/2019,6,10868,934,3616,286,0,15,15719
12/3/2019,7,10879,1390,4158,588,0,20,17035
12/3/2019,8,10880,2077,4682,801,3,41,18484
12/3/2019,9,10879,2244,4037,1127,24,73,18384
12/3/2019,10,10880,2105,4164,882,52,82,18165
12/3/2019,11,10885,2265,4446,817,81,95,18589
12/3/2019,12,10885,2402,4482,636,145,121,18671
12/3/2019,13,10878,2664,4161,669,161,120,18653
12/3/2019,14,10859,2389,3946,946,120,99,18359
12/3/2019,15,10866,2553,4027,1195,91,96,18828
12/3/2019,16,10877,2603,3869,1064,36,93,18542
12/3/2019,17,10889,2649,4247,1117,3,92,18997
12/3/2019,18,10888,2806,4925,1210,0,113,19942
12/3/2019,19,10893,2948,5057,1096,0,132,20126
12/3/2019,20,10884,2088,5089,1430,0,138,19629
12/3/2019,21,10888,1761,4793,1630,0,93,19165
12/3/2019,22,10882,1115,4499,1641,0,83,18220
12/3/2019,23,10882,509,4211,1531,0,85,17218
12/3/2019,24,10883,320,3499,1679,0,108,16489
12/4/2019,1,10893,258,3205,1755,0,59,16170
12/4/2019,2,10887,250,3433,1671,0,54,16295
12/4/2019,3,10893,277,3509,1657,0,52,16388
12/4/2019,4,10894,343,3528,1566,0,52,16383
12/4/2019,5,10888,568,3542,1552,0,50,16600
12/4/2019,6,10883,949,3257,1339,0,53,16481
12/4/2019,7,10895,1195,3768,1100,0,70,17028
12/4/2019,8,10891,1577,4221,1352,1,109,18151
12/4/2019,9,10885,1687,4422,1408,5,131,18538
12/4/2019,10,10865,1680,4204,1441,29,119,18338
12/4/2019,11,10870,1971,4132,1532,45,133,18683
12/4/2019,12,10888,1602,3980,1813,54,115,18452
12/4/2019,13,10879,1678,3787,2000,71,100,18515
12/4/2019,14,10722,1749,3899,2140,55,106,18671
12/4/2019,15,10752,2023,3775,2071,27,102,18750
12/4/2019,16,10888,1852,3763,2023,11,102,18639
12/4/2019,17,10894,1865,4352,2477,1,111,19700
12/4/2019,18,10890,1936,4556,2659,0,111,20152
12/4/2019,19,10887,1528,4433,2695,0,109,19652
12/4/2019,20,10878,1144,4630,2743,0,108,19503
12/4/2019,21,10873,949,4318,2854,0,101,19095
12/4/2019,22,10880,366,4141,2856,0,116,18359
12/4/2019,23,10884,224,3584,3023,0,113,17828
12/4/2019,24,10888,224,3199,2890,0,54,17255
12/5/2019,1,10891,225,3038,2821,0,31,17006
12/5/2019,2,10902,230,3029,2738,0,21,16920
12/5/2019,3,10895,241,3115,2587,0,17,16855
12/5/2019,4,10898,319,3074,2400,0,13,16704
12/5/2019,5,10905,574,3046,2487,0,18,17030
12/5/2019,6,10903,947,3333,2263,0,18,17464
12/5/2019,7,10904,1058,3633,2469,1,40,18105
12/5/2019,8,10898,1255,4104,2466,2,87,18812
12/5/2019,9,10894,1378,4165,2454,12,111,19014
12/5/2019,10,10893,1575,4166,2464,26,111,19235
12/5/2019,11,10887,1500,4047,2470,33,111,19048
12/5/2019,12,10890,1575,3952,2487,53,113,19070
12/5/2019,13,10894,1602,3893,2347,54,108,18898
12/5/2019,14,10897,1543,3833,2235,71,105,18684
12/5/2019,15,10893,1457,4401,2049,88,97,18985
12/5/2019,16,10849,1918,4406,1282,30,103,18588
12/5/2019,17,10890,2114,4768,769,4,112,18657
12/5/2019,18,10892,2645,5088,557,0,143,19325
12/5/2019,19,10891,2514,4929,429,0,159,18922
12/5/2019,20,10884,2580,4846,368,0,143,18821
12/5/2019,21,10880,2313,4674,397,0,133,18397
12/5/2019,22,10868,2076,4278,460,0,124,17806
12/5/2019,23,10867,1063,4213,531,0,120,16794
12/5/2019,24,10876,694,3972,620,0,33,16195
12/6/2019,1,10879,444,3853,810,0,14,16000
12/6/2019,2,10879,277,3915,936,0,10,16017
12/6/2019,3,10875,361,3765,1099,0,9,16109
12/6/2019,4,10875,332,3687,1280,0,10,16184
12/6/2019,5,10886,376,3890,1344,0,12,16508
12/6/2019,6,10886,550,3923,1397,0,13,16769
12/6/2019,7,10885,825,4145,1476,0,38,17369
12/6/2019,8,10886,1112,4605,1858,0,86,18547
12/6/2019,9,10845,1215,4286,1950,0,90,18386
12/6/2019,10,10789,1229,4280,2061,4,90,18453
12/6/2019,11,10786,1538,4407,2048,13,133,18925
12/6/2019,12,10787,1162,4339,1976,24,109,18397
12/6/2019,13,10789,1052,4214,1790,32,91,17968
12/6/2019,14,10778,1050,4017,1695,56,87,17683
12/6/2019,15,10774,1133,3850,1729,35,83,17604
12/6/2019,16,10792,1304,3811,1757,51,85,17800
12/6/2019,17,10864,1329,4044,2065,3,81,18386
12/6/2019,18,10875,1313,4907,2314,0,80,19489
12/6/2019,19,10872,1213,4620,2562,0,78,19345
12/6/2019,20,10867,882,4447,2672,0,79,18947
12/6/2019,21,10862,809,4453,2487,0,79,18690
12/6/2019,22,10861,702,4693,2010,0,92,18358
12/6/2019,23,10868,470,4402,1858,0,124,17722
12/6/2019,24,10866,217,3770,1753,0,70,16676
12/7/2019,1,10864,218,3730,1659,0,20,16491
12/7/2019,2,10863,274,3904,1513,0,0,16554
12/7/2019,3,10863,245,3668,1254,0,0,16030
12/7/2019,4,10862,484,3956,959,0,0,16261
12/7/2019,5,10819,671,3886,692,0,0,16068
12/7/2019,6,10805,742,3714,629,0,0,15890
12/7/2019,7,10804,991,3660,461,1,0,15917
12/7/2019,8,10804,1360,4034,344,1,0,16543
12/7/2019,9,10809,1770,4154,263,12,0,17008
12/7/2019,10,10810,2066,4045,157,29,0,17107
12/7/2019,11,10807,2034,4281,124,86,3,17335
12/7/2019,12,10799,1811,4191,174,116,4,17095
12/7/2019,13,10807,1298,4060,228,149,7,16549
12/7/2019,14,10806,1239,4094,285,140,4,16568
12/7/2019,15,10823,1300,3938,353,109,1,16524
12/7/2019,16,10860,1359,4022,497,59,0,16797
12/7/2019,17,10855,1505,4489,657,7,0,17513
12/7/2019,18,10853,1910,4797,780,0,0,18340
12/7/2019,19,10855,1642,4711,943,0,0,18151
12/7/2019,20,10854,1464,4189,1395,0,0,17902
12/7/2019,21,10844,1013,3857,1819,0,0,17533
12/7/2019,22,10833,482,3828,2278,0,0,17421
12/7/2019,23,10856,324,3506,2595,0,0,17281
12/7/2019,24,10860,321,3210,2695,0,0,17086
12/8/2019,1,10865,318,3090,2704,0,0,16977
12/8/2019,2,10858,318,3077,2818,0,0,17071
12/8/2019,3,10863,319,3070,2533,0,0,16785
12/8/2019,4,10854,317,3068,2492,0,0,16731
12/8/2019,5,10858,316,3093,2389,0,0,16656
12/8/2019,6,10859,315,3107,2587,0,0,16868
12/8/2019,7,10865,315,3206,2819,1,0,17206
12/8/2019,8,10864,317,3266,3379,1,0,17827
12/8/2019,9,10862,568,3310,3523,21,0,18284
12/8/2019,10,10865,591,3317,3785,69,0,18627
12/8/2019,11,10864,482,3287,3976,94,0,18703
12/8/2019,12,10866,387,3220,4087,113,0,18673
12/8/2019,13,10868,255,3562,4091,73,0,18849
12/8/2019,14,10875,255,3736,3942,127,0,18935
12/8/2019,15,10875,254,3803,3978,66,0,18976
12/8/2019,16,10843,254,3873,3885,22,1,18878
12/8/2019,17,10874,262,4227,4085,3,2,19453
12/8/2019,18,10875,280,4988,4142,0,0,20285
12/8/2019,19,10878,221,4555,4153,0,0,19807
12/8/2019,20,10873,219,4589,4126,0,0,19807
12/8/2019,21,10879,221,4268,4092,0,6,19466
12/8/2019,22,10871,220,3782,3755,0,3,18631
12/8/2019,23,10873,220,3536,3108,0,0,17737
12/8/2019,24,10876,220,3200,2026,0,0,16322
12/9/2019,1,10876,223,3050,1738,0,0,15887
12/9/2019,2,10882,244,3087,1491,0,0,15704
12/9/2019,3,10881,255,3065,1362,0,10,15573
12/9/2019,4,10866,261,3154,1110,0,11,15402
12/9/2019,5,10885,260,3364,1239,0,11,15759
12/9/2019,6,10892,258,3392,1668,0,13,16223
12/9/2019,7,10890,257,3748,2257,0,22,17174
12/9/2019,8,10887,274,4460,2909,0,27,18557
12/9/2019,9,10882,305,4258,3166,12,27,18650
12/9/2019,10,10880,298,4084,3233,33,27,18555
12/9/2019,11,10881,321,4306,3330,41,27,18906
12/9/2019,12,10878,364,4583,3186,39,27,19077
12/9/2019,13,10882,505,4703,3063,21,27,19201
12/9/2019,14,10881,391,3954,3387,19,27,18659
12/9/2019,15,10881,315,3972,3459,11,27,18665
12/9/2019,16,10880,327,4008,3366,2,27,18610
12/9/2019,17,10889,422,4117,3796,0,26,19250
12/9/2019,18,10888,388,4362,4006,0,27,19671
12/9/2019,19,10892,243,4622,3805,0,26,19588
12/9/2019,20,10888,227,4617,3871,0,26,19629
12/9/2019,21,10887,246,4285,4026,0,26,19470
12/9/2019,22,10885,254,3952,3890,0,26,19007
12/9/2019,23,10885,261,3363,3560,0,26,18095
12/9/2019,24,10889,245,3161,2463,0,17,16775
12/10/2019,1,10889,225,3106,1507,0,13,15740
12/10/2019,2,10888,225,3083,1071,0,13,15280
12/10/2019,3,10890,227,2973,798,0,14,14902
12/10/2019,4,10879,225,3172,720,0,13,15009
12/10/2019,5,10885,224,3299,744,0,14,15166
12/10/2019,6,10889,224,3339,1417,0,14,15883
12/10/2019,7,10895,227,3636,2574,0,27,17359
12/10/2019,8,10886,241,4199,3023,0,30,18379
12/10/2019,9,10717,291,4455,2880,6,27,18376
12/10/2019,10,9454,945,5168,2201,16,39,17823
12/10/2019,11,9445,1013,4849,1883,43,45,17278
12/10/2019,12,10041,922,4374,1648,58,39,17082
12/10/2019,13,10885,996,4003,1593,63,27,17567
12/10/2019,14,10876,1210,4046,1976,49,26,18183
12/10/2019,15,10719,1817,4283,2231,38,27,19115
12/10/2019,16,10892,1971,4456,1883,18,27,19247
12/10/2019,17,10892,2065,4833,1956,2,27,19775
12/10/2019,18,10889,2470,5097,1671,0,27,20154
12/10/2019,19,10890,2474,5181,1439,0,25,20009
12/10/2019,20,10886,2037,5112,1420,0,26,19481
12/10/2019,21,10884,1778,4840,1400,0,26,18928
12/10/2019,22,10921,1306,4425,1585,0,26,18263
12/10/2019,23,10864,870,4129,811,0,26,16700
12/10/2019,24,10004,389,4062,1527,0,18,16000
12/11/2019,1,9996,253,3877,1768,0,15,15909
12/11/2019,2,9991,290,3860,2002,0,17,16160
12/11/2019,3,9987,289,3816,2107,0,15,16214
12/11/2019,4,9989,215,3397,2143,0,16,15760
12/11/2019,5,9996,234,3501,2273,0,15,16019
12/11/2019,6,10001,359,3879,2088,0,15,16342
12/11/2019,7,10005,633,4497,2713,0,16,17864
12/11/2019,8,10002,1205,4451,3168,2,25,18853
12/11/2019,9,10000,1077,4442,3442,14,26,19001
12/11/2019,10,9980,1086,4090,3826,37,26,19045
12/11/2019,11,9983,1291,4115,3895,98,26,19408
12/11/2019,12,9994,1399,4241,3858,78,28,19598
12/11/2019,13,9865,1692,4149,3952,103,33,19794
12/11/2019,14,9834,1548,4223,3982,65,47,19699
12/11/2019,15,9842,1644,4075,4104,68,81,19814
12/11/2019,16,9999,1627,3847,4107,37,85,19702
12/11/2019,17,9995,1764,4414,3711,9,86,19979
12/11/2019,18,10004,2462,4909,3570,0,98,21043
12/11/2019,19,10058,2799,4764,3244,0,100,20965
12/11/2019,20,10232,2390,4781,3018,0,101,20522
12/11/2019,21,10233,1938,4653,2946,0,84,19854
12/11/2019,22,10241,1629,4587,2658,0,80,19195
12/11/2019,23,10237,1471,4386,2059,0,81,18234
12/11/2019,24,10239,1390,4013,1603,0,84,17329
12/12/2019,1,10243,1472,4049,1179,0,51,16994
12/12/2019,2,10286,1374,4082,1041,0,11,16794
12/12/2019,3,10453,1158,3726,800,0,11,16148
12/12/2019,4,10458,1646,3949,661,0,10,16724
12/12/2019,5,10475,1879,4033,503,0,10,16900
12/12/2019,6,10625,1874,3989,446,0,15,16949
12/12/2019,7,10629,2427,4676,432,1,51,18216
12/12/2019,8,10631,3448,4761,427,2,87,19356
12/12/2019,9,10630,3052,4514,566,29,134,18925
12/12/2019,10,10631,2440,4640,783,99,121,18714
12/12/2019,11,10613,2004,4703,852,119,87,18378
12/12/2019,12,10609,2258,4777,1133,106,95,18978
12/12/2019,13,10611,2305,4376,1650,130,132,19204
12/12/2019,14,10622,1960,4252,2120,109,108,19171
12/12/2019,15,10619,1671,3976,2556,63,79,18964
12/12/2019,16,10619,1374,4103,3049,24,76,19245
12/12/2019,17,10697,1248,4459,3215,3,77,19699
12/12/2019,18,10725,1234,4611,3625,0,81,20276
12/12/2019,19,10726,1113,4613,3618,0,84,20154
12/12/2019,20,10727,882,4548,3705,0,84,19946
12/12/2019,21,10728,402,4562,3829,0,83,19604
12/12/2019,22,10709,447,4276,4007,0,104,19543
12/12/2019,23,10708,275,3933,3850,0,43,18809
12/12/2019,24,10718,231,3765,3500,0,22,18236
12/13/2019,1,10729,207,3555,2868,0,13,17372
12/13/2019,2,10735,210,3283,2813,0,11,17052
12/13/2019,3,10736,274,3307,2509,0,11,16837
12/13/2019,4,10767,284,3236,2545,0,10,16842
12/13/2019,5,10778,531,3229,2416,0,10,16964
12/13/2019,6,10776,795,3224,2491,0,14,17300
12/13/2019,7,10776,1042,3434,2434,1,36,17723
12/13/2019,8,10769,1037,4061,2798,1,74,18740
12/13/2019,9,10741,1201,3824,2736,43,89,18634
12/13/2019,10,10693,1331,4150,2394,118,90,18776
12/13/2019,11,10689,1496,4139,2178,181,84,18767
12/13/2019,12,10691,1836,4183,1678,203,86,18677
12/13/2019,13,10688,1955,4108,1319,182,113,18365
12/13/2019,14,10683,1963,4332,1119,154,132,18383
12/13/2019,15,10694,1720,4172,1029,130,109,17854
12/13/2019,16,10743,1654,4053,1085,29,84,17648
12/13/2019,17,10749,1663,4609,1135,5,86,18247
12/13/2019,18,10744,1856,5193,1266,0,137,19196
12/13/2019,19,10745,1563,5017,1327,0,102,18754
12/13/2019,20,10745,1277,4953,1274,0,81,18330
12/13/2019,21,10741,854,4846,1185,0,112,17738
12/13/2019,22,10737,882,4715,1004,0,142,17480
12/13/2019,23,10743,723,4382,954,0,84,16886
12/13/2019,24,10751,228,4510,704,0,79,16272
12/14/2019,1,10747,261,4103,498,0,60,15669
12/14/2019,2,10736,259,4100,337,0,61,15493
12/14/2019,3,10738,283,4199,243,0,24,15487
12/14/2019,4,10741,300,4081,195,0,0,15317
12/14/2019,5,10738,351,4035,261,0,0,15385
12/14/2019,6,10745,522,3888,346,0,0,15501
12/14/2019,7,10748,751,3690,350,0,1,15540
12/14/2019,8,10746,1042,4079,377,0,11,16255
12/14/2019,9,10740,1152,4204,624,3,7,16730
12/14/2019,10,10735,1218,4502,789,11,83,17338
12/14/2019,11,10736,1459,4712,827,22,144,17900
12/14/2019,12,10736,1714,4514,696,27,173,17860
12/14/2019,13,10733,1700,4376,660,27,140,17636
12/14/2019,14,10624,1538,4512,867,25,119,17685
12/14/2019,15,10668,1521,4341,1365,15,103,18013
12/14/2019,16,10743,1129,3934,1732,7,54,17599
12/14/2019,17,10783,794,4155,2211,1,54,17998
12/14/2019,18,10776,609,4428,2503,0,56,18372
12/14/2019,19,10785,434,4221,2684,0,55,18179
12/14/2019,20,10784,332,4108,2951,0,56,18231
12/14/2019,21,10773,329,4051,2882,0,56,18091
12/14/2019,22,10770,215,3724,3029,0,66,17804
12/14/2019,23,10776,148,3347,3107,0,18,17396
12/14/2019,24,10779,146,3146,3040,0,0,17111
12/15/2019,1,10775,147,3071,2446,0,0,16439
12/15/2019,2,10782,147,3128,2095,0,0,16152
12/15/2019,3,10778,147,3114,1874,0,0,15913
12/15/2019,4,10741,147,3123,1629,0,0,15640
12/15/2019,5,10774,150,3104,1662,0,0,15690
12/15/2019,6,10775,148,3117,1846,0,0,15886
12/15/2019,7,10777,232,3202,2082,0,5,16298
12/15/2019,8,10772,311,3311,2533,2,24,16953
12/15/2019,9,10767,418,3400,2639,4,20,17248
12/15/2019,10,10766,492,3416,3233,30,9,17946
12/15/2019,11,10766,677,3707,3185,71,5,18411
12/15/2019,12,10766,755,4025,2781,93,3,18423
12/15/2019,13,10747,1141,3888,2720,93,3,18592
12/15/2019,14,10734,1461,3844,2694,127,4,18864
12/15/2019,15,10698,1475,4076,2401,93,5,18748
12/15/2019,16,10760,1483,4223,1911,53,6,18436
12/15/2019,17,10760,1712,4783,1364,8,4,18631
12/15/2019,18,10758,2219,5185,907,0,8,19077
12/15/2019,19,10760,2026,4940,737,0,7,18470
12/15/2019,20,10760,1663,4787,797,0,9,18016
12/15/2019,21,10754,1670,4609,656,0,9,17698
12/15/2019,22,10753,1743,4571,420,0,5,17492
12/15/2019,23,10752,1330,4462,310,0,0,16854
12/15/2019,24,10757,1007,4303,330,0,0,16397
12/16/2019,1,10769,860,3870,287,0,0,15786
12/16/2019,2,10775,1015,3960,178,0,10,15938
12/16/2019,3,10781,1216,3768,202,0,10,15977
12/16/2019,4,10786,1454,3574,251,0,10,16075
12/16/2019,5,10778,1507,3562,269,0,10,16126
12/16/2019,6,10786,1562,3668,314,0,12,16342
12/16/2019,7,10786,1913,4106,376,1,20,17202
12/16/2019,8,10784,2614,4468,356,3,26,18251
12/16/2019,9,10784,2794,4355,376,11,25,18345
12/16/2019,10,10785,2979,4338,318,60,25,18505
12/16/2019,11,10809,3102,4232,222,98,26,18489
12/16/2019,12,10810,2853,4155,295,143,26,18282
12/16/2019,13,10809,2440,4091,398,163,28,17929
12/16/2019,14,10803,2521,4171,339,150,40,18024
12/16/2019,15,10798,2540,4431,298,93,68,18228
12/16/2019,16,10786,2748,4513,325,29,87,18488
12/16/2019,17,10784,2863,4865,382,4,93,18991
12/16/2019,18,10786,3513,4936,386,0,132,19753
12/16/2019,19,10787,3385,4890,502,0,135,19699
12/16/2019,20,10785,3369,4803,546,0,133,19636
12/16/2019,21,10781,3381,4477,580,0,132,19351
12/16/2019,22,10778,2408,4311,555,0,92,18144
12/16/2019,23,10790,1776,3930,513,0,90,17099
12/16/2019,24,10797,1228,3847,522,0,27,16421
12/17/2019,1,10795,951,3471,649,0,12,15878
12/17/2019,2,10799,868,3473,757,0,13,15910
12/17/2019,3,10786,968,3686,644,0,12,16096
12/17/2019,4,10762,1149,3683,555,0,12,16161
12/17/2019,5,10758,1253,3334,550,0,13,15908
12/17/2019,6,10758,1258,3414,546,0,13,15989
12/17/2019,7,10755,1287,4024,495,0,21,16582
12/17/2019,8,10754,1481,4579,493,1,27,17335
12/17/2019,9,10748,1885,4687,512,3,26,17861
12/17/2019,10,10741,2128,4704,484,12,24,18093
12/17/2019,11,10754,2363,4817,654,17,24,18629
12/17/2019,12,10756,2415,4376,986,32,25,18590
12/17/2019,13,10759,2377,4266,1304,46,26,18778
12/17/2019,14,10759,2427,4039,1265,67,26,18583
12/17/2019,15,10760,2380,3954,1247,44,26,18411
12/17/2019,16,10759,2454,4240,1168,23,26,18670
12/17/2019,17,10744,2800,4666,1034,2,26,19272
12/17/2019,18,10734,3289,4977,1310,0,27,20337
12/17/2019,19,10733,2564,4923,1790,0,22,20032
12/17/2019,20,10755,2286,4459,2167,0,26,19693
12/17/2019,21,10731,1759,4195,2424,0,26,19135
12/17/2019,22,10744,1344,4012,2516,0,26,18642
12/17/2019,23,10744,820,3494,2470,0,26,17554
12/17/2019,24,10747,475,3320,2442,0,18,17002
12/18/2019,1,10741,288,3284,2390,0,12,16715
12/18/2019,2,10756,272,3333,2492,0,13,16866
12/18/2019,3,10729,284,3519,2653,0,12,17197
12/18/2019,4,10702,386,3246,2673,0,12,17019
12/18/2019,5,10680,641,3168,2656,0,12,17157
12/18/2019,6,10673,976,3328,2318,0,14,17309
12/18/2019,7,10688,1416,3414,2486,0,24,18028
12/18/2019,8,10662,1422,4223,2996,2,26,19331
12/18/2019,9,10664,1444,4129,3201,9,26,19473
12/18/2019,10,10667,1532,4320,3008,35,27,19589
12/18/2019,11,10631,1703,4187,2905,67,27,19520
12/18/2019,12,10622,1833,3958,2938,85,26,19462
12/18/2019,13,10617,1868,3633,2763,84,26,18991
12/18/2019,14,10596,1937,3645,3358,57,27,19620
12/18/2019,15,10569,2244,3887,3443,44,45,20232
12/18/2019,16,10561,2237,4021,3404,29,77,20329
12/18/2019,17,10558,2156,4438,3355,4,79,20590
12/18/2019,18,10514,2510,4981,3195,0,78,21278
12/18/2019,19,10496,2608,5142,2901,0,82,21229
12/18/2019,20,10499,2881,5043,2666,0,98,21187
12/18/2019,21,10500,2633,5013,2406,0,90,20642
12/18/2019,22,10458,2875,4807,2033,0,98,20271
12/18/2019,23,10451,2482,4301,1557,0,85,18876
12/18/2019,24,10445,2196,4012,1183,0,74,17910
12/19/2019,1,10193,2829,3610,1007,0,133,17772
12/19/2019,2,9942,2432,3515,959,0,121,16969
12/19/2019,3,9942,2688,3573,776,0,155,17134
12/19/2019,4,9936,2720,3410,687,0,123,16876
12/19/2019,5,9946,3001,3677,632,0,152,17408
12/19/2019,6,9949,3736,3782,533,0,180,18180
12/19/2019,7,9953,3807,4427,574,0,180,18941
12/19/2019,8,9947,4469,4963,660,1,122,20162
12/19/2019,9,9947,4631,4898,746,6,176,20404
12/19/2019,10,9948,4814,5042,954,32,195,20985
12/19/2019,11,9948,3992,4701,1297,80,195,20213
12/19/2019,12,9940,3852,4579,1594,107,193,20265
12/19/2019,13,9936,3082,4499,1795,106,180,19598
12/19/2019,14,9936,3035,4571,1690,92,101,19425
12/19/2019,15,9942,3477,4723,1648,68,164,20022
12/19/2019,16,9942,3821,4825,1854,32,197,20671
12/19/2019,17,9945,4194,5126,1510,6,196,20977
12/19/2019,18,9947,5128,5630,1126,0,198,22029
12/19/2019,19,9947,5120,5672,922,0,183,21844
12/19/2019,20,9945,5149,5612,687,0,180,21573
12/19/2019,21,9945,5337,5469,460,0,196,21407
12/19/2019,22,9935,5272,5057,370,0,199,20833
12/19/2019,23,9937,4754,4439,370,0,206,19706
12/19/2019,24,9938,4091,3795,364,0,200,18388
12/20/2019,1,9944,3942,3583,373,0,123,17965
12/20/2019,2,9947,3732,3569,412,0,23,17683
12/20/2019,3,9935,3483,3567,435,0,10,17430
12/20/2019,4,9934,2973,3507,561,0,10,16985
12/20/2019,5,9952,3240,3638,747,0,11,17588
12/20/2019,6,9957,3623,3760,933,0,14,18287
12/20/2019,7,9955,3791,4442,1052,1,22,19263
12/20/2019,8,9949,3824,5051,1399,3,26,20252
12/20/2019,9,9950,3732,5046,1588,19,26,20361
12/20/2019,10,9948,3873,4955,1517,71,26,20390
12/20/2019,11,9946,4393,5021,1133,129,45,20667
12/20/2019,12,9946,4105,4699,1095,197,85,20127
12/20/2019,13,10003,3075,4362,1228,212,91,18971
12/20/2019,14,10385,2653,4143,1367,200,84,18832
12/20/2019,15,10403,2658,4225,1637,150,83,19156
12/20/2019,16,10405,2692,4465,1338,52,83,19035
12/20/2019,17,10411,3349,5262,1246,7,84,20359
12/20/2019,18,10413,4259,5538,1143,0,142,21495
12/20/2019,19,10408,4064,5427,1414,0,187,21500
12/20/2019,20,10405,3687,5110,1733,0,122,21057
12/20/2019,21,10401,3661,5018,1938,0,126,21144
12/20/2019,22,10395,4141,4256,1678,0,116,20586
12/20/2019,23,10402,3422,3877,1821,0,43,19565
12/20/2019,24,10374,2127,3311,1885,0,22,17719
12/21/2019,1,10421,1254,3145,1801,0,14,16635
12/21/2019,2,10540,568,3311,1867,0,8,16294
12/21/2019,3,10631,386,3279,1838,0,10,16144
12/21/2019,4,10669,234,3168,1706,0,14,15791
12/21/2019,5,10668,368,3460,1478,0,7,15981
12/21/2019,6,10681,752,3408,1377,0,4,16222
12/21/2019,7,10681,1072,3278,1318,0,0,16349
12/21/2019,8,10679,1318,3756,1404,1,1,17159
12/21/2019,9,10678,1461,4475,1618,8,2,18242
12/21/2019,10,10676,1649,4690,1613,30,0,18658
12/21/2019,11,10676,2022,4619,1477,74,0,18868
12/21/2019,12,10672,2048,4546,1193,124,0,18583
12/21/2019,13,10699,1774,4504,1206,180,0,18363
12/21/2019,14,10592,1388,4353,1291,208,0,17832
12/21/2019,15,10529,1430,4053,1511,162,0,17685
12/21/2019,16,10616,1564,4079,1771,84,0,18114
12/21/2019,17,10756,1634,4128,2318,13,0,18849
12/21/2019,18,10751,1741,4521,2896,0,0,19909
12/21/2019,19,10760,1734,4192,2995,0,0,19681
12/21/2019,20,10759,1292,4100,3345,0,0,19496
12/21/2019,21,10755,1118,4042,3363,0,0,19278
12/21/2019,22,10728,595,3729,3301,0,0,18353
12/21/2019,23,10714,374,3320,3482,0,0,17890
12/21/2019,24,10743,211,2925,3544,0,0,17423
12/22/2019,1,10750,188,2750,3397,0,0,17085
12/22/2019,2,10754,188,2756,3100,0,0,16798
12/22/2019,3,10756,187,2812,2412,0,0,16167
12/22/2019,4,10762,186,2802,2655,0,0,16405
12/22/2019,5,10755,186,2799,2614,0,0,16354
12/22/2019,6,10755,187,2801,2604,0,0,16347
12/22/2019,7,10752,187,3057,2819,0,0,16815
12/22/2019,8,10761,187,3206,3072,1,0,17227
12/22/2019,9,10764,187,3388,3148,30,0,17517
12/22/2019,10,10767,188,3633,2912,98,0,17598
12/22/2019,11,10771,188,3881,2587,196,0,17623
12/22/2019,12,10775,187,3750,2403,256,0,17371
12/22/2019,13,10768,187,3711,2267,280,0,17213
12/22/2019,14,10775,189,3848,2295,248,0,17355
12/22/2019,15,10776,192,3906,2372,176,0,17422
12/22/2019,16,10781,192,4019,2579,86,0,17657
12/22/2019,17,10782,191,4100,2919,14,0,18006
12/22/2019,18,10781,191,4322,3500,0,0,18794
12/22/2019,19,10781,191,4480,3754,0,0,19206
12/22/2019,20,10782,191,4297,3831,0,0,19101
12/22/2019,21,10771,193,4047,3948,0,8,18967
12/22/2019,22,10775,193,3798,3972,0,8,18746
12/22/2019,23,10777,192,3430,3573,0,6,17978
12/22/2019,24,10772,191,3012,3054,0,6,17035
12/23/2019,1,10765,191,2868,2731,0,14,16569
12/23/2019,2,10770,190,2954,1889,0,23,15826
12/23/2019,3,10773,190,2906,1845,0,25,15739
12/23/2019,4,10775,190,2887,1630,0,27,15509
12/23/2019,5,10771,192,2934,1684,0,23,15604
12/23/2019,6,10768,190,2967,2259,0,27,16211
12/23/2019,7,10768,196,3241,2866,1,34,17106
12/23/2019,8,10774,196,3583,3112,2,41,17708
12/23/2019,9,10776,254,3716,3407,42,44,18239
12/23/2019,10,10779,314,3719,3024,157,48,18041
12/23/2019,11,10773,535,3733,2658,264,37,18000
12/23/2019,12,10780,785,3692,2068,330,35,17690
12/23/2019,13,10772,1021,3678,1594,303,34,17402
12/23/2019,14,10789,1193,3672,1499,274,41,17468
12/23/2019,15,10786,1287,3753,1411,212,36,17485
12/23/2019,16,10787,1264,4202,1133,95,27,17508
12/23/2019,17,10784,1259,4497,1186,12,26,17764
12/23/2019,18,10789,1253,4893,1335,0,33,18303
12/23/2019,19,10778,1123,4975,1258,0,34,18168
12/23/2019,20,10774,847,4871,1351,0,32,17875
12/23/2019,21,10770,334,5266,1354,0,34,17758
12/23/2019,22,10772,247,4501,1508,0,31,17059
12/23/2019,23,10769,245,3979,1381,0,33,16407
12/23/2019,24,10769,211,3646,1271,0,28,15925
12/24/2019,1,10765,205,3282,1188,0,22,15462
12/24/2019,2,10770,209,3098,1062,0,24,15163
12/24/2019,3,10770,210,3094,1131,0,28,15233
12/24/2019,4,10768,210,2983,1121,0,26,15108
12/24/2019,5,10770,286,3191,1067,0,29,15343
12/24/2019,6,10771,455,3350,1237,0,31,15844
12/24/2019,7,10760,589,3724,1351,2,24,16450
12/24/2019,8,10773,656,4421,1290,2,27,17169
12/24/2019,9,10763,641,4717,1340,50,27,17538
12/24/2019,10,10770,641,4720,1088,162,26,17407
12/24/2019,11,10771,763,4801,952,251,27,17565
12/24/2019,12,10776,927,4875,772,238,28,17616
12/24/2019,13,10786,1017,4603,714,217,29,17366
12/24/2019,14,10788,877,4569,736,163,45,17178
12/24/2019,15,10780,801,4708,774,127,42,17232
12/24/2019,16,10774,470,4902,797,73,39,17055
12/24/2019,17,10772,497,5399,705,10,34,17417
12/24/2019,18,10782,638,5606,691,0,26,17743
12/24/2019,19,10780,336,5008,924,0,27,17075
12/24/2019,20,10779,289,4777,1156,0,28,17029
12/24/2019,21,10779,288,3856,1377,0,29,16329
12/24/2019,22,10777,216,3997,1322,0,32,16344
12/24/2019,23,10771,206,4206,1225,0,26,16434
12/24/2019,24,10776,201,3496,1215,0,17,15705
12/25/2019,1,10769,201,3541,931,0,9,15451
12/25/2019,2,10769,200,3377,905,0,0,15251
12/25/2019,3,10768,201,2933,840,0,0,14742
12/25/2019,4,10767,201,2992,673,0,0,14633
12/25/2019,5,10775,201,2974,659,0,0,14609
12/25/2019,6,10779,200,3338,573,0,0,14890
12/25/2019,7,10782,201,3757,563,0,0,15303
12/25/2019,8,10780,229,3978,605,1,0,15593
12/25/2019,9,10773,462,4304,571,14,0,16124
12/25/2019,10,10777,500,4331,622,56,0,16286
12/25/2019,11,10779,435,4215,624,92,0,16145
12/25/2019,12,10779,571,4367,552,128,0,16397
12/25/2019,13,10781,457,4167,393,176,0,15974
12/25/2019,14,10782,425,4335,308,204,0,16054
12/25/2019,15,10781,441,4264,384,181,0,16051
12/25/2019,16,10767,475,4488,405,72,0,16207
12/25/2019,17,10760,578,4924,457,8,0,16727
12/25/2019,18,10763,608,5161,631,0,0,17163
12/25/2019,19,10758,580,4830,853,0,0,17021
12/25/2019,20,10756,577,4146,1058,0,0,16537
12/25/2019,21,10755,419,4048,1193,0,0,16415
12/25/2019,22,10756,386,3890,1264,0,0,16296
12/25/2019,23,10779,241,3869,1181,0,0,16070
12/25/2019,24,10781,228,3862,1025,0,0,15896
12/26/2019,1,10780,202,3663,924,0,0,15569
12/26/2019,2,10783,203,3261,1033,0,0,15280
12/26/2019,3,10777,201,3149,979,0,0,15106
12/26/2019,4,10779,206,2924,1057,0,0,14966
12/26/2019,5,10776,207,2865,1112,0,0,14960
12/26/2019,6,10776,205,2856,1484,0,0,15321
12/26/2019,7,10780,204,3234,1432,0,0,15650
12/26/2019,8,10776,205,3578,1643,1,0,16203
12/26/2019,9,10777,204,3663,1562,8,5,16219
12/26/2019,10,10779,204,3797,2172,36,4,16992
12/26/2019,11,10778,203,4231,2122,67,0,17401
12/26/2019,12,10771,202,4282,2198,71,0,17524
12/26/2019,13,10776,200,4678,2203,52,0,17909
12/26/2019,14,10780,199,4495,2233,49,0,17756
12/26/2019,15,10780,205,4580,2152,37,0,17754
12/26/2019,16,10781,222,4736,2032,19,0,17790
12/26/2019,17,10779,219,4680,2283,2,0,17963
12/26/2019,18,10778,204,4790,2553,0,0,18325
12/26/2019,19,10781,198,4728,2656,0,0,18363
12/26/2019,20,10780,197,4307,2886,0,0,18170
12/26/2019,21,10775,197,3948,3051,0,0,17971
12/26/2019,22,10773,197,3577,3103,0,0,17650
12/26/2019,23,10768,195,3348,2774,0,0,17085
12/26/2019,24,10768,196,3160,2192,0,0,16316
12/27/2019,1,10784,196,3023,1359,0,0,15362
12/27/2019,2,10783,196,3106,957,0,0,15042
12/27/2019,3,10778,195,2953,1221,0,0,15147
12/27/2019,4,10788,195,2942,1240,0,0,15165
12/27/2019,5,10788,195,2948,1127,0,0,15058
12/27/2019,6,10784,196,3151,1161,0,1,15293
12/27/2019,7,10788,196,3250,1574,0,7,15815
12/27/2019,8,10787,223,3571,1876,1,22,16480
12/27/2019,9,10776,206,3602,2435,4,44,17067
12/27/2019,10,10775,199,3703,2568,18,49,17312
12/27/2019,11,10777,199,3650,3027,40,48,17741
12/27/2019,12,10759,239,3870,3053,86,49,18056
12/27/2019,13,10767,294,4293,2679,123,46,18202
12/27/2019,14,10764,402,4122,2353,85,42,17768
12/27/2019,15,10772,577,4375,1978,49,29,17780
12/27/2019,16,10773,744,4945,1598,25,26,18111
12/27/2019,17,10778,929,5210,1418,4,26,18365
12/27/2019,18,10775,961,5633,1431,0,27,18827
12/27/2019,19,10779,861,5413,1320,0,26,18399
12/27/2019,20,10780,834,5481,1263,0,27,18385
12/27/2019,21,10780,841,5444,1203,0,26,18294
12/27/2019,22,10774,896,4897,1176,0,26,17769
12/27/2019,23,10777,716,4285,1281,0,38,17097
12/27/2019,24,10780,311,3711,1221,0,21,16044
12/28/2019,1,10778,232,3199,1049,0,0,15258
12/28/2019,2,10784,232,3054,855,0,0,14925
12/28/2019,3,10785,232,3115,768,0,0,14900
12/28/2019,4,10785,232,3056,694,0,0,14767
12/28/2019,5,10787,232,3021,608,0,0,14648
12/28/2019,6,10790,237,3135,511,0,0,14673
12/28/2019,7,10788,240,3627,472,0,0,15127
12/28/2019,8,10782,365,3912,421,1,0,15481
12/28/2019,9,10784,445,4180,396,13,0,15818
12/28/2019,10,10789,642,4416,347,85,0,16279
12/28/2019,11,10782,709,4285,264,164,0,16204
12/28/2019,12,10785,792,4324,298,205,0,16404
12/28/2019,13,10789,696,4378,431,159,0,16453
12/28/2019,14,10805,612,4220,446,185,0,16268
12/28/2019,15,10818,786,4273,407,136,0,16420
12/28/2019,16,10819,1155,4418,307,65,0,16764
12/28/2019,17,10820,1261,5111,344,8,0,17544
12/28/2019,18,10824,1638,5680,440,0,0,18582
12/28/2019,19,10821,1438,5397,451,0,0,18107
12/28/2019,20,10827,1205,5585,420,0,0,18037
12/28/2019,21,10814,975,5465,562,0,0,17816
12/28/2019,22,10813,701,5043,579,0,0,17136
12/28/2019,23,10814,467,4402,673,0,0,16356
12/28/2019,24,10814,398,3579,974,0,0,15765
12/29/2019,1,10827,233,3090,793,0,0,14943
12/29/2019,2,10842,199,2977,1219,0,0,15237
12/29/2019,3,10862,199,2946,706,0,0,14713
12/29/2019,4,10876,202,2936,1116,0,0,15130
12/29/2019,5,10891,199,3003,1547,0,0,15640
12/29/2019,6,10893,202,3164,1323,0,0,15582
12/29/2019,7,10897,202,3277,1049,0,0,15425
12/29/2019,8,10895,204,3310,1683,1,0,16093
12/29/2019,9,10896,333,3343,2186,12,0,16770
12/29/2019,10,10897,526,3418,2431,35,0,17307
12/29/2019,11,10892,567,3402,2940,49,0,17850
12/29/2019,12,10898,691,3676,3169,49,0,18483
12/29/2019,13,10948,806,3797,3065,35,0,18651
12/29/2019,14,10978,899,3594,2948,26,0,18445
12/29/2019,15,11016,917,4101,2672,16,0,18722
12/29/2019,16,11038,917,4109,2638,8,0,18710
12/29/2019,17,11034,930,4293,2499,0,0,18756
12/29/2019,18,11023,932,4811,2617,0,0,19383
12/29/2019,19,11037,776,4372,2563,0,0,18748
12/29/2019,20,11037,677,4857,2432,0,0,19003
12/29/2019,21,11041,678,4379,2585,0,0,18683
12/29/2019,22,11046,348,4478,2475,0,0,18347
12/29/2019,23,11054,285,3988,2407,0,0,17734
12/29/2019,24,11050,271,3295,2234,0,0,16850
12/30/2019,1,11041,270,3061,1927,0,0,16299
12/30/2019,2,11036,271,3043,1718,0,6,16074
12/30/2019,3,11048,268,3025,1531,0,14,15886
12/30/2019,4,11047,268,2968,1678,0,16,15977
12/30/2019,5,10882,267,3014,1978,0,15,16156
12/30/2019,6,10793,264,3111,2282,0,15,16465
12/30/2019,7,10795,265,3334,2749,0,22,17165
12/30/2019,8,10792,388,3618,2533,1,30,17362
12/30/2019,9,10791,505,3664,2578,2,33,17573
12/30/2019,10,10788,517,3686,2924,56,48,18019
12/30/2019,11,10792,515,3722,3236,124,51,18440
12/30/2019,12,10791,516,3914,3015,101,43,18380
12/30/2019,13,10795,501,3847,3204,67,36,18450
12/30/2019,14,10800,288,3821,3158,68,38,18173
12/30/2019,15,10810,239,3812,2960,29,46,17896
12/30/2019,16,10806,239,4145,2666,14,45,17915
12/30/2019,17,10808,237,4496,2772,2,34,18349
12/30/2019,18,10988,239,4810,2944,0,34,19015
12/30/2019,19,11040,238,4363,3077,0,34,18752
12/30/2019,20,11045,236,3909,3244,0,34,18468
12/30/2019,21,11042,238,3755,3126,0,34,18195
12/30/2019,22,11041,239,3682,2713,0,34,17709
12/30/2019,23,11028,237,3553,2355,0,34,17207
12/30/2019,24,10982,239,3483,1335,0,23,16062
12/31/2019,1,10983,240,3221,1706,0,19,16169
12/31/2019,2,11238,203,3048,1201,0,18,15708
12/31/2019,3,11248,197,3010,1072,0,17,15544
12/31/2019,4,11253,196,3022,1130,0,17,15618
12/31/2019,5,11256,198,3072,1155,0,18,15699
12/31/2019,6,11256,196,3146,1294,0,21,15913
12/31/2019,7,11266,196,3241,1852,0,28,16583
12/31/2019,8,11261,197,3653,1971,1,34,17117
12/31/2019,9,11251,326,3772,2176,6,34,17565
12/31/2019,10,11249,445,3758,2683,21,34,18190
12/31/2019,11,11414,472,3752,2817,35,34,18524
12/31/2019,12,11473,473,3703,2980,37,34,18700
12/31/2019,13,11468,473,3704,2975,34,34,18688
12/31/2019,14,11464,474,3706,2735,32,34,18445
12/31/2019,15,11465,476,3753,2726,16,34,18470
12/31/2019,16,11470,478,3763,2734,5,34,18484
12/31/2019,17,11471,477,3905,2689,2,34,18578
12/31/2019,18,11468,272,4147,3171,0,34,19092
12/31/2019,19,11468,232,4043,3021,0,34,18798
12/31/2019,20,11462,232,3819,2735,0,34,18282
12/31/2019,21,11514,230,3719,2066,0,34,17563
12/31/2019,22,11605,229,3700,1260,0,34,16828
12/31/2019,23,11615,229,3548,1142,0,34,16568
12/31/2019,24,11625,230,3190,1463,0,24,16532
