Date,Hour,NUCLEAR,GAS,HYDRO,WIND,SOLAR,BIOFUEL,Total Output
1/1/2017,1,11592,234,2455,2433,0,1,16715
1/1/2017,2,11591,235,2523,1994,0,1,16344
1/1/2017,3,11596,234,2464,1647,0,1,15942
1/1/2017,4,11610,236,2494,1386,0,1,15727
1/1/2017,5,11611,235,2476,1330,0,1,15653
1/1/2017,6,11611,234,2471,1125,0,1,15442
1/1/2017,7,11609,235,2516,1136,0,1,15497
1/1/2017,8,11610,236,2675,1269,0,1,15791
1/1/2017,9,11609,236,2672,1095,21,1,15634
1/1/2017,10,11609,236,2952,1108,62,1,15968
1/1/2017,11,11611,235,3070,1103,95,3,16117
1/1/2017,12,11604,235,3143,1023,116,3,16124
1/1/2017,13,11597,235,3212,924,121,1,16090
1/1/2017,14,11600,235,3243,833,156,1,16068
1/1/2017,15,11599,233,3326,929,135,1,16223
1/1/2017,16,11599,236,3557,1081,63,1,16537
1/1/2017,17,11600,234,4303,657,9,1,16804
1/1/2017,18,11610,241,5160,1142,0,1,18154
1/1/2017,19,11611,235,5272,1155,0,2,18275
1/1/2017,20,11607,234,4761,1147,0,1,17750
1/1/2017,21,11607,235,4833,1044,0,1,17720
1/1/2017,22,11600,236,4640,947,0,1,17424
1/1/2017,23,11599,236,4121,895,0,1,16852
1/1/2017,24,11596,249,3817,615,0,1,16278
1/2/2017,1,11600,237,3388,474,0,1,15700
1/2/2017,2,11612,236,3386,478,0,1,15713
1/2/2017,3,11604,236,2821,728,0,1,15390
1/2/2017,4,11612,236,2457,867,0,1,15173
1/2/2017,5,11610,236,2478,876,0,1,15201
1/2/2017,6,11608,235,2472,953,0,1,15269
1/2/2017,7,11613,238,2540,1284,0,1,15676
1/2/2017,8,11613,238,2760,1251,2,1,15865
1/2/2017,9,11610,238,2919,1570,18,1,16356
1/2/2017,10,11601,238,3114,1247,67,1,16268
1/2/2017,11,11599,237,3259,1182,117,1,16395
1/2/2017,12,11592,237,3608,1374,117,1,16929
1/2/2017,13,11580,244,4160,828,107,1,16920
1/2/2017,14,11571,243,4177,785,94,1,16871
1/2/2017,15,11572,255,4096,891,38,1,16853
1/2/2017,16,11599,269,4256,939,8,1,17072
1/2/2017,17,11586,288,4546,1140,0,1,17561
1/2/2017,18,11582,417,5008,1635,0,1,18643
1/2/2017,19,11581,427,4904,1709,0,1,18622
1/2/2017,20,11582,426,5230,1711,0,1,18950
1/2/2017,21,11572,431,5005,1554,0,1,18563
1/2/2017,22,11565,399,4815,883,0,1,17663
1/2/2017,23,11563,628,4049,786,0,2,17028
1/2/2017,24,11572,549,2991,715,0,1,15828
1/3/2017,1,11574,267,3027,841,0,11,15720
1/3/2017,2,11582,237,2789,1034,0,11,15653
1/3/2017,3,11592,237,2757,1386,0,11,15983
1/3/2017,4,11597,235,2772,848,0,11,15463
1/3/2017,5,11591,247,2905,851,0,12,15606
1/3/2017,6,11589,258,3106,1042,0,17,16012
1/3/2017,7,11588,265,3578,995,0,23,16449
1/3/2017,8,11593,437,4141,703,0,27,16901
1/3/2017,9,11587,532,4625,534,1,27,17306
1/3/2017,10,11595,817,4150,810,4,27,17403
1/3/2017,11,11600,771,4251,935,9,35,17601
1/3/2017,12,11605,701,5175,490,14,37,18022
1/3/2017,13,11606,915,5079,181,14,42,17837
1/3/2017,14,11610,832,4623,145,11,40,17261
1/3/2017,15,11612,601,4814,84,8,52,17171
1/3/2017,16,11611,722,5009,110,2,59,17513
1/3/2017,17,11613,890,5243,167,0,60,17973
1/3/2017,18,11610,1046,5678,296,0,56,18686
1/3/2017,19,11610,1120,5628,302,0,48,18708
1/3/2017,20,11612,1125,5516,299,0,53,18605
1/3/2017,21,11602,1277,4697,438,0,58,18072
1/3/2017,22,11601,796,4447,656,0,53,17553
1/3/2017,23,11585,511,3661,929,0,48,16734
1/3/2017,24,11597,490,2700,1392,0,45,16224
1/4/2017,1,11597,501,2525,1336,0,44,16003
1/4/2017,2,11604,502,2524,1313,0,43,15986
1/4/2017,3,11604,502,2510,1116,0,44,15776
1/4/2017,4,11600,503,2512,997,0,41,15653
1/4/2017,5,11603,501,2505,1087,0,40,15736
1/4/2017,6,11601,502,2591,1588,0,34,16316
1/4/2017,7,11601,497,2659,2550,0,34,17341
1/4/2017,8,11598,501,3314,2591,0,40,18044
1/4/2017,9,11598,502,3468,2766,4,36,18374
1/4/2017,10,11594,503,3552,2905,40,34,18628
1/4/2017,11,11550,501,3409,3288,50,34,18832
1/4/2017,12,11583,489,3676,3165,62,34,19009
1/4/2017,13,11587,501,3731,3274,26,30,19149
1/4/2017,14,11430,504,3703,3481,39,38,19195
1/4/2017,15,11507,503,3795,3581,24,34,19444
1/4/2017,16,11594,503,3744,3737,14,36,19628
1/4/2017,17,11601,504,4174,3795,1,31,20106
1/4/2017,18,11596,504,5007,3876,0,28,21011
1/4/2017,19,11595,509,5077,3911,0,27,21119
1/4/2017,20,11595,509,4803,3849,0,26,20782
1/4/2017,21,11590,510,4643,3770,0,26,20539
1/4/2017,22,11583,540,4028,3781,0,26,19958
1/4/2017,23,11081,573,3880,3655,0,26,19215
1/4/2017,24,11079,511,3233,3540,0,18,18381
1/5/2017,1,11090,515,2873,3468,0,15,17961
1/5/2017,2,11093,518,2657,3158,0,14,17440
1/5/2017,3,11096,565,2726,2898,0,14,17299
1/5/2017,4,11095,566,2747,2727,0,13,17148
1/5/2017,5,11093,598,2706,2542,0,14,16953
1/5/2017,6,11088,659,3003,2487,0,16,17253
1/5/2017,7,11087,783,3281,2399,0,21,17571
1/5/2017,8,11089,880,4076,2621,0,26,18692
1/5/2017,9,11091,900,4796,2647,19,25,19478
1/5/2017,10,11095,1014,4847,2646,59,25,19686
1/5/2017,11,11092,923,4517,2865,51,27,19475
1/5/2017,12,11099,971,4437,3028,56,25,19616
1/5/2017,13,11101,985,4393,2769,78,26,19352
1/5/2017,14,11103,717,4628,2618,66,26,19158
1/5/2017,15,11105,707,4473,2592,46,26,18949
1/5/2017,16,11103,840,4674,2572,18,25,19232
1/5/2017,17,11103,1102,4649,2390,3,25,19272
1/5/2017,18,11101,1483,5693,2184,1,26,20488
1/5/2017,19,11101,1380,5874,2132,1,26,20514
1/5/2017,20,11100,1284,5962,2109,1,26,20482
1/5/2017,21,11098,1126,5283,2149,1,26,19683
1/5/2017,22,11097,1135,4737,2037,1,27,19034
1/5/2017,23,11096,1146,4148,1956,1,26,18373
1/5/2017,24,11101,970,3829,1816,1,17,17734
1/6/2017,1,11095,647,3473,1547,1,14,16777
1/6/2017,2,11105,616,3341,1452,1,13,16528
1/6/2017,3,11106,862,3397,1173,1,12,16551
1/6/2017,4,11109,1100,3277,1132,1,14,16633
1/6/2017,5,11113,1243,3260,1320,1,15,16952
1/6/2017,6,11108,1413,3048,1211,1,34,16815
1/6/2017,7,11106,1557,3952,1114,1,78,17808
1/6/2017,8,11105,1717,4866,1176,2,167,19033
1/6/2017,9,11109,1622,5233,1152,27,197,19340
1/6/2017,10,11113,1870,5155,1028,90,200,19456
1/6/2017,11,11118,1643,4953,1247,159,167,19287
1/6/2017,12,11121,1198,4393,1574,194,83,18563
1/6/2017,13,11121,1197,4448,1597,194,78,18635
1/6/2017,14,11118,1496,4199,1513,158,78,18562
1/6/2017,15,11124,1969,4392,1439,145,82,19151
1/6/2017,16,11119,2232,4757,1293,76,80,19557
1/6/2017,17,11119,2424,5038,1181,13,132,19907
1/6/2017,18,11109,2695,5809,1136,1,193,20943
1/6/2017,19,11115,2668,5896,1169,1,191,21040
1/6/2017,20,11112,2419,5624,1285,1,132,20573
1/6/2017,21,11112,2257,5179,1324,1,114,19987
1/6/2017,22,11110,2171,4504,1380,1,162,19328
1/6/2017,23,11110,2047,3700,1388,1,71,18317
1/6/2017,24,11115,1415,3400,1322,1,15,17268
1/7/2017,1,11116,1343,3168,1224,1,10,16862
1/7/2017,2,11125,1018,3053,1126,1,0,16323
1/7/2017,3,11125,751,2872,1149,1,0,15898
1/7/2017,4,11124,786,3182,1107,1,0,16200
1/7/2017,5,11124,991,3137,1049,1,0,16302
1/7/2017,6,11123,1159,3499,900,1,0,16682
1/7/2017,7,11123,1215,3807,827,1,0,16973
1/7/2017,8,11120,1168,4399,903,1,16,17607
1/7/2017,9,11116,1125,4801,999,21,9,18071
1/7/2017,10,11122,1235,4783,935,95,43,18213
1/7/2017,11,11124,1138,4559,1112,150,133,18216
1/7/2017,12,11131,1116,4575,1380,180,135,18517
1/7/2017,13,11123,792,4262,1795,132,70,18174
1/7/2017,14,11125,530,4338,2077,103,71,18244
1/7/2017,15,11129,548,4544,2238,97,78,18634
1/7/2017,16,11125,773,4446,2318,70,64,18796
1/7/2017,17,11123,990,4572,2430,8,64,19187
1/7/2017,18,11114,1438,5368,2422,0,150,20492
1/7/2017,19,11111,1494,5330,2478,0,154,20567
1/7/2017,20,11118,1164,5175,2652,0,108,20217
1/7/2017,21,11115,1128,4957,2816,0,72,20088
1/7/2017,22,11115,1014,4473,2788,0,58,19448
1/7/2017,23,11109,799,3643,2967,0,24,18542
1/7/2017,24,11097,777,3386,3086,0,1,18347
1/8/2017,1,11122,779,2695,2651,0,1,17248
1/8/2017,2,11126,461,2745,3053,0,1,17386
1/8/2017,3,11127,376,2617,2936,0,1,17057
1/8/2017,4,11127,374,2669,2537,0,2,16709
1/8/2017,5,11126,373,3017,2328,0,1,16845
1/8/2017,6,11126,372,3120,2286,0,1,16905
1/8/2017,7,11127,374,3440,2317,0,1,17259
1/8/2017,8,11126,353,3684,2493,2,1,17659
1/8/2017,9,11120,410,3930,2882,6,1,18349
1/8/2017,10,11121,455,4230,2776,23,1,18606
1/8/2017,11,11120,717,4070,2546,53,1,18507
1/8/2017,12,11120,1185,3885,2653,93,1,18937
1/8/2017,13,11116,1513,3912,2520,112,1,19174
1/8/2017,14,11119,1622,3977,2269,106,1,19094
1/8/2017,15,11117,1776,4332,2175,91,1,19492
1/8/2017,16,11080,2050,4679,1741,45,1,19596
1/8/2017,17,11109,2372,5084,1267,9,1,19842
1/8/2017,18,11113,3093,5390,1070,0,1,20667
1/8/2017,19,11107,3384,5417,923,0,1,20832
1/8/2017,20,11112,3111,5402,893,0,1,20519
1/8/2017,21,11112,2717,5385,946,0,1,20161
1/8/2017,22,11113,2430,5001,934,0,1,19479
1/8/2017,23,11111,1567,4761,1035,0,1,18475
1/8/2017,24,11109,975,4085,1313,0,1,17483
1/9/2017,1,11117,456,2950,1703,0,4,16230
1/9/2017,2,11118,390,2776,2135,0,12,16431
1/9/2017,3,11116,449,2664,2317,0,12,16558
1/9/2017,4,11117,585,2650,2535,0,12,16899
1/9/2017,5,11111,690,2730,2530,0,12,17073
1/9/2017,6,11113,898,2978,2336,0,16,17341
1/9/2017,7,11113,1217,3642,3161,0,32,19165
1/9/2017,8,11108,1506,4821,3337,1,41,20814
1/9/2017,9,11105,1861,5167,3418,3,44,21598
1/9/2017,10,11106,1487,4712,3422,11,49,20787
1/9/2017,11,11111,1391,4466,3412,17,57,20454
1/9/2017,12,11109,1313,4104,3440,35,60,20061
1/9/2017,13,11111,1092,4341,3246,61,48,19899
1/9/2017,14,11114,1120,4627,2698,68,46,19673
1/9/2017,15,11116,1485,4971,2254,32,42,19900
1/9/2017,16,11117,1826,4928,1897,10,28,19806
1/9/2017,17,11111,2667,5327,1620,1,27,20753
1/9/2017,18,11121,2542,5770,1647,0,27,21107
1/9/2017,19,11116,2159,5592,1915,0,25,20807
1/9/2017,20,11124,2003,5357,2152,0,31,20667
1/9/2017,21,11126,1968,4638,2277,0,28,20037
1/9/2017,22,11115,1280,4435,2442,0,26,19298
1/9/2017,23,11106,616,4026,2623,0,26,18397
1/9/2017,24,11088,493,3654,2396,0,20,17651
1/10/2017,1,11097,477,3073,2622,0,16,17285
1/10/2017,2,11098,431,2673,2657,0,15,16874
1/10/2017,3,11104,406,2649,2477,0,19,16655
1/10/2017,4,11129,408,2653,2342,0,16,16548
1/10/2017,5,11129,425,2783,2581,0,16,16934
1/10/2017,6,11134,436,3151,2310,0,17,17048
1/10/2017,7,11133,439,3382,2941,0,22,17917
1/10/2017,8,11131,443,4304,3382,0,27,19287
1/10/2017,9,11132,444,4319,3379,5,27,19306
1/10/2017,10,11128,444,4135,3491,14,28,19240
1/10/2017,11,11129,443,4347,3707,18,28,19672
1/10/2017,12,11124,443,4442,3704,21,21,19755
1/10/2017,13,11117,443,4386,3739,18,27,19730
1/10/2017,14,11115,440,4008,3784,12,28,19387
1/10/2017,15,11094,442,4015,3804,7,27,19389
1/10/2017,16,11092,450,4306,3726,2,27,19603
1/10/2017,17,11104,447,4716,3848,0,27,20142
1/10/2017,18,11116,449,5111,3906,0,27,20609
1/10/2017,19,11113,447,5165,3763,0,28,20516
1/10/2017,20,11113,451,5496,3420,0,30,20510
1/10/2017,21,11111,487,5397,2907,0,30,19932
1/10/2017,22,11108,561,4929,2890,0,33,19521
1/10/2017,23,11106,455,3751,3212,0,27,18551
1/10/2017,24,11114,438,3386,2849,0,15,17802
1/11/2017,1,11113,437,2995,2806,0,14,17365
1/11/2017,2,11110,437,2796,2712,0,14,17069
1/11/2017,3,11110,437,2698,2604,0,14,16863
1/11/2017,4,11111,437,2653,2379,0,14,16594
1/11/2017,5,11108,436,2889,2145,0,14,16592
1/11/2017,6,11111,435,3298,2462,0,17,17323
1/11/2017,7,11113,439,3761,2690,0,21,18024
1/11/2017,8,11116,421,4346,2787,0,26,18696
1/11/2017,9,11119,419,4444,2537,18,27,18564
1/11/2017,10,11131,417,4241,2625,63,27,18504
1/11/2017,11,11139,418,3820,2627,106,27,18137
1/11/2017,12,11140,417,3832,2744,94,27,18254
1/11/2017,13,11141,416,3595,2832,117,26,18127
1/11/2017,14,10967,441,4075,2673,121,26,18303
1/11/2017,15,10928,452,4191,2783,57,27,18438
1/11/2017,16,11025,452,4269,2952,24,27,18749
1/11/2017,17,11127,454,4621,2770,1,27,19000
1/11/2017,18,11129,448,4979,3189,0,28,19773
1/11/2017,19,11126,448,4966,3250,0,28,19818
1/11/2017,20,11131,450,4583,3503,0,32,19699
1/11/2017,21,11130,449,4249,3321,0,32,19181
1/11/2017,22,11133,450,3630,3452,0,27,18692
1/11/2017,23,11127,450,3352,2912,0,27,17868
1/11/2017,24,11126,412,3260,2156,0,19,16973
1/12/2017,1,11125,408,3108,2050,0,11,16702
1/12/2017,2,11118,408,2965,2270,0,10,16771
1/12/2017,3,11120,409,2935,1753,0,9,16226
1/12/2017,4,11118,410,2883,1675,0,9,16095
1/12/2017,5,11118,409,2894,1721,0,10,16152
1/12/2017,6,11125,408,3097,1410,0,17,16057
1/12/2017,7,11126,409,3671,1476,0,22,16704
1/12/2017,8,11125,412,4516,1443,0,26,17522
1/12/2017,9,11126,462,5241,860,5,27,17721
1/12/2017,10,11136,598,5223,493,11,27,17488
1/12/2017,11,11123,542,4946,423,16,27,17077
1/12/2017,12,11120,610,5161,222,22,27,17162
1/12/2017,13,11121,826,5103,301,20,26,17397
1/12/2017,14,11127,876,4368,444,17,27,16859
1/12/2017,15,11128,915,4064,727,23,27,16884
1/12/2017,16,11128,818,4303,824,13,25,17111
1/12/2017,17,11144,817,4660,985,2,23,17631
1/12/2017,18,11144,826,5271,1110,0,18,18369
1/12/2017,19,11136,825,5507,1260,0,17,18745
1/12/2017,20,11139,827,5183,1487,0,21,18657
1/12/2017,21,11135,825,4883,1753,0,25,18621
1/12/2017,22,11129,522,4457,1828,0,27,17963
1/12/2017,23,11129,414,3852,1953,0,26,17374
1/12/2017,24,11134,403,3418,1915,0,18,16888
1/13/2017,1,11167,404,3316,1857,0,11,16755
1/13/2017,2,11168,415,3319,1732,0,10,16644
1/13/2017,3,11178,430,3350,1221,0,10,16189
1/13/2017,4,11191,520,3240,1251,0,10,16212
1/13/2017,5,11196,699,3263,1234,0,12,16404
1/13/2017,6,11195,832,3400,1460,0,18,16905
1/13/2017,7,11197,896,3982,1637,0,22,17734
1/13/2017,8,11201,1127,4684,1579,0,27,18618
1/13/2017,9,11205,1157,4757,1435,35,25,18614
1/13/2017,10,11208,995,4253,1274,85,24,17839
1/13/2017,11,11205,1046,4343,1026,155,24,17799
1/13/2017,12,11207,1091,4269,829,155,24,17575
1/13/2017,13,11210,933,3933,687,179,24,16966
1/13/2017,14,11207,1019,4052,635,163,23,17099
1/13/2017,15,11202,1306,4155,530,117,23,17333
1/13/2017,16,11200,1494,4478,390,40,23,17625
1/13/2017,17,11196,1736,5088,305,8,23,18356
1/13/2017,18,11195,2030,6000,232,0,23,19480
1/13/2017,19,11207,2043,6146,229,0,23,19648
1/13/2017,20,11248,1808,6145,310,0,25,19536
1/13/2017,21,11247,1660,5816,320,0,24,19067
1/13/2017,22,10788,1643,5350,367,0,23,18171
1/13/2017,23,10506,1509,4797,398,0,23,17233
1/13/2017,24,10554,620,4468,393,0,10,16045
1/14/2017,1,10555,257,4398,445,0,0,15655
1/14/2017,2,10557,233,3943,471,0,0,15204
1/14/2017,3,10561,250,3861,548,0,0,15220
1/14/2017,4,10559,377,3853,584,0,0,15373
1/14/2017,5,10553,565,3953,540,0,0,15611
1/14/2017,6,10534,704,3612,449,0,0,15299
1/14/2017,7,10499,826,3926,475,0,0,15726
1/14/2017,8,10495,978,4797,452,0,0,16722
1/14/2017,9,10492,1348,5271,413,8,0,17532
1/14/2017,10,10490,1388,5363,390,23,0,17654
1/14/2017,11,10490,1326,5154,375,33,0,17378
1/14/2017,12,10494,753,4962,342,47,0,16598
1/14/2017,13,10483,691,4913,322,56,0,16465
1/14/2017,14,10497,1011,5088,284,37,0,16917
1/14/2017,15,10488,1217,4773,316,31,0,16825
1/14/2017,16,10491,1362,5039,412,21,1,17326
1/14/2017,17,10506,1090,5329,451,2,2,17380
1/14/2017,18,10557,1259,5397,467,0,4,17684
1/14/2017,19,10562,1345,5449,578,0,1,17935
1/14/2017,20,10563,1219,5421,683,0,0,17886
1/14/2017,21,10566,1269,4940,779,0,0,17554
1/14/2017,22,10560,1074,4519,876,0,0,17029
1/14/2017,23,10552,422,4142,1013,0,0,16129
1/14/2017,24,10559,238,3730,1094,0,0,15621
1/15/2017,1,10555,232,3511,1073,0,0,15371
1/15/2017,2,10550,241,3532,1036,0,0,15359
1/15/2017,3,10553,355,3707,783,0,0,15398
1/15/2017,4,10557,539,3679,568,0,0,15343
1/15/2017,5,10558,638,3606,438,0,0,15240
1/15/2017,6,10540,659,3401,331,0,0,14931
1/15/2017,7,10492,644,3732,328,0,0,15196
1/15/2017,8,10490,651,4432,268,0,0,15841
1/15/2017,9,10492,684,4829,206,34,0,16245
1/15/2017,10,10499,675,4652,160,115,0,16101
1/15/2017,11,10589,722,4296,133,169,0,15909
1/15/2017,12,10657,791,4116,144,133,0,15841
1/15/2017,13,10707,513,4076,196,138,0,15630
1/15/2017,14,10722,456,3986,319,152,0,15635
1/15/2017,15,10675,627,3888,449,122,0,15761
1/15/2017,16,10728,1108,4263,427,90,0,16616
1/15/2017,17,10722,1294,4839,363,21,0,17239
1/15/2017,18,10723,1549,5509,480,0,1,18262
1/15/2017,19,10735,1575,5557,623,0,0,18490
1/15/2017,20,10738,1292,5302,774,0,0,18106
1/15/2017,21,10747,1243,5152,916,0,0,18058
1/15/2017,22,10736,1078,4886,1074,0,0,17774
1/15/2017,23,10747,710,3992,1089,0,0,16538
1/15/2017,24,10757,482,3601,842,0,0,15682
1/16/2017,1,10781,263,3356,829,0,0,15229
1/16/2017,2,10792,243,3544,925,0,10,15514
1/16/2017,3,10796,250,3816,815,0,11,15688
1/16/2017,4,10791,344,3358,833,0,11,15337
1/16/2017,5,10788,537,3530,865,0,11,15731
1/16/2017,6,10801,649,3465,795,0,15,15725
1/16/2017,7,10811,678,4235,810,0,37,16571
1/16/2017,8,10819,1065,4987,905,1,73,17850
1/16/2017,9,10818,1220,5095,892,17,138,18180
1/16/2017,10,10819,1113,4742,865,70,192,17801
1/16/2017,11,10822,1016,4382,703,135,179,17237
1/16/2017,12,10818,946,4684,550,176,179,17353
1/16/2017,13,10819,730,4724,483,148,197,17101
1/16/2017,14,10822,869,4939,406,73,140,17249
1/16/2017,15,10822,1150,4636,385,41,136,17170
1/16/2017,16,10816,1303,4814,325,25,134,17417
1/16/2017,17,10819,1538,4903,317,5,127,17709
1/16/2017,18,10815,1545,5839,399,0,126,18724
1/16/2017,19,10813,1502,6008,373,0,130,18826
1/16/2017,20,10811,1447,6022,415,0,127,18822
1/16/2017,21,10809,1367,5453,430,0,117,18176
1/16/2017,22,10803,1286,4917,533,0,80,17619
1/16/2017,23,10800,978,4053,686,0,42,16559
1/16/2017,24,10804,502,3585,727,0,16,15634
1/17/2017,1,10808,408,3366,721,0,15,15318
1/17/2017,2,10804,407,3380,930,0,13,15534
1/17/2017,3,10801,408,3206,1174,0,13,15602
1/17/2017,4,10802,426,3107,1110,0,14,15459
1/17/2017,5,10801,447,3058,1322,0,16,15644
1/17/2017,6,10800,456,3125,1685,0,21,16087
1/17/2017,7,10807,465,3382,1850,0,41,16545
1/17/2017,8,10806,474,3891,2376,0,76,17623
1/17/2017,9,10805,478,4663,2399,12,106,18463
1/17/2017,10,10799,558,5023,2149,33,195,18757
1/17/2017,11,10800,582,5017,2175,15,200,18789
1/17/2017,12,10794,580,5048,2062,18,192,18694
1/17/2017,13,10780,708,4841,1864,16,188,18397
1/17/2017,14,10780,765,4607,1782,19,150,18103
1/17/2017,15,10779,960,4410,1645,18,94,17906
1/17/2017,16,10782,1101,4735,1407,9,145,18179
1/17/2017,17,10770,1107,5065,1431,1,187,18561
1/17/2017,18,10773,1253,5523,1473,0,186,19208
1/17/2017,19,10778,1260,5351,1534,0,138,19061
1/17/2017,20,10772,1256,5508,1441,0,80,19057
1/17/2017,21,10768,1008,5560,1191,0,95,18622
1/17/2017,22,10765,707,4690,1282,0,63,17507
1/17/2017,23,10764,484,3816,1338,0,29,16431
1/17/2017,24,10767,461,3483,1261,0,15,15987
1/18/2017,1,10771,461,2671,1163,0,14,15080
1/18/2017,2,10780,419,2978,1176,0,13,15366
1/18/2017,3,10787,411,3119,1315,0,14,15646
1/18/2017,4,10784,421,3317,1254,0,15,15791
1/18/2017,5,10785,508,3379,1164,0,20,15856
1/18/2017,6,10785,663,3507,1070,0,22,16047
1/18/2017,7,10789,824,3930,1009,0,24,16576
1/18/2017,8,10793,838,4598,972,0,26,17227
1/18/2017,9,10784,851,5164,947,3,26,17775
1/18/2017,10,10785,837,5078,1025,16,27,17768
1/18/2017,11,10788,847,4968,903,23,27,17556
1/18/2017,12,10793,851,4844,921,34,26,17469
1/18/2017,13,10798,512,4420,984,32,26,16772
1/18/2017,14,10656,416,4542,1089,23,26,16752
1/18/2017,15,10732,518,4574,945,18,27,16814
1/18/2017,16,10784,798,4917,701,11,44,17255
1/18/2017,17,10788,1057,5035,608,2,82,17572
1/18/2017,18,10783,944,5237,913,0,148,18025
1/18/2017,19,10789,834,4991,1375,0,114,18103
1/18/2017,20,10790,819,4800,1579,0,89,18077
1/18/2017,21,10788,823,4727,1814,0,126,18278
1/18/2017,22,10779,818,4179,2018,0,114,17908
1/18/2017,23,10775,507,3478,1929,0,77,16766
1/18/2017,24,10778,408,3347,1777,0,29,16339
1/19/2017,1,10779,415,3047,1797,0,17,16055
1/19/2017,2,10781,475,3019,1577,0,13,15865
1/19/2017,3,10779,545,3012,1267,0,13,15616
1/19/2017,4,10774,851,2959,969,0,13,15566
1/19/2017,5,10783,1066,3003,876,0,14,15742
1/19/2017,6,10783,1200,3274,906,0,21,16184
1/19/2017,7,10793,1211,4141,756,0,29,16930
1/19/2017,8,10798,1231,5036,657,0,37,17759
1/19/2017,9,10794,1168,5207,487,5,36,17697
1/19/2017,10,10795,1326,5132,338,14,36,17641
1/19/2017,11,10792,1436,5090,232,28,39,17617
1/19/2017,12,10782,936,5041,156,35,37,16987
1/19/2017,13,10799,820,4907,188,30,35,16779
1/19/2017,14,11001,690,4875,190,34,37,16827
1/19/2017,15,11113,826,4790,306,25,60,17120
1/19/2017,16,11213,829,4748,401,10,96,17297
1/19/2017,17,11193,835,5422,357,1,144,17952
1/19/2017,18,11326,1103,5892,273,0,129,18723
1/19/2017,19,11373,952,5729,183,0,166,18403
1/19/2017,20,11373,837,5544,90,0,198,18042
1/19/2017,21,11370,858,5353,78,0,179,17838
1/19/2017,22,11375,505,4859,93,0,148,16980
1/19/2017,23,11370,410,3997,210,0,85,16072
1/19/2017,24,11376,402,3593,192,0,31,15594
1/20/2017,1,11368,400,3490,219,0,15,15492
1/20/2017,2,11358,401,3683,197,0,17,15656
1/20/2017,3,11361,400,3824,281,0,13,15879
1/20/2017,4,11378,399,3263,514,0,13,15567
1/20/2017,5,11375,401,3104,752,0,14,15646
1/20/2017,6,11402,403,3132,629,0,19,15585
1/20/2017,7,11469,499,3649,925,0,41,16583
1/20/2017,8,11471,675,4179,1316,0,80,17721
1/20/2017,9,11472,823,4506,1481,3,82,18367
1/20/2017,10,11473,820,4792,1381,12,123,18601
1/20/2017,11,11440,817,4584,1240,21,173,18275
1/20/2017,12,11410,850,4865,1129,30,184,18468
1/20/2017,13,11473,875,4964,876,38,194,18420
1/20/2017,14,11474,890,5044,626,29,200,18263
1/20/2017,15,11469,947,5020,475,22,189,18122
1/20/2017,16,11480,965,4874,503,13,161,17996
1/20/2017,17,11496,1007,5067,475,3,112,18160
1/20/2017,18,11543,1033,5635,442,0,149,18802
1/20/2017,19,11549,709,5578,518,0,151,18505
1/20/2017,20,11547,608,5440,661,0,158,18414
1/20/2017,21,11542,476,5358,664,0,195,18235
1/20/2017,22,11545,448,5104,628,0,167,17892
1/20/2017,23,11541,412,4204,746,0,89,16992
1/20/2017,24,11547,259,3708,806,0,33,16353
1/21/2017,1,11549,242,3489,585,0,2,15867
1/21/2017,2,11565,242,3591,520,0,0,15918
1/21/2017,3,11574,243,3310,455,0,0,15582
1/21/2017,4,11565,243,3084,350,0,0,15242
1/21/2017,5,11560,241,2974,329,0,0,15104
1/21/2017,6,11559,241,3108,235,0,0,15143
1/21/2017,7,11560,242,3509,659,0,0,15970
1/21/2017,8,11567,242,3811,761,1,0,16382
1/21/2017,9,11562,242,4633,898,10,1,17346
1/21/2017,10,11562,243,4753,994,27,1,17580
1/21/2017,11,11566,243,4360,992,33,1,17195
1/21/2017,12,11564,242,4525,849,52,1,17233
1/21/2017,13,11578,242,4715,682,82,1,17300
1/21/2017,14,11576,242,4771,627,79,1,17296
1/21/2017,15,11571,328,5302,510,37,1,17749
1/21/2017,16,11542,527,5171,551,31,1,17823
1/21/2017,17,11568,828,4608,759,5,1,17769
1/21/2017,18,11574,842,4780,1005,0,1,18202
1/21/2017,19,11569,841,5062,1224,1,1,18698
1/21/2017,20,11573,836,4682,1422,0,1,18514
1/21/2017,21,11567,712,4399,1524,0,1,18203
1/21/2017,22,11563,653,4131,1446,0,1,17794
1/21/2017,23,11560,334,3657,1684,0,1,17236
1/21/2017,24,11563,241,3397,1254,0,1,16456
1/22/2017,1,11560,242,3080,1152,0,1,16035
1/22/2017,2,11566,241,3047,873,0,1,15728
1/22/2017,3,11566,241,2998,807,0,1,15613
1/22/2017,4,11566,241,2900,994,0,1,15702
1/22/2017,5,11567,241,2951,988,0,1,15748
1/22/2017,6,11566,241,3066,682,0,1,15556
1/22/2017,7,11565,240,3549,460,0,1,15815
1/22/2017,8,11567,240,3805,464,0,1,16077
1/22/2017,9,11561,240,4518,549,9,1,16878
1/22/2017,10,11568,239,4853,572,37,1,17270
1/22/2017,11,11569,239,5241,620,43,1,17713
1/22/2017,12,11567,241,5122,729,39,1,17699
1/22/2017,13,11566,251,5112,809,57,1,17796
1/22/2017,14,11570,332,5065,780,45,1,17793
1/22/2017,15,11565,501,4858,861,41,2,17828
1/22/2017,16,11567,655,4802,1069,37,2,18132
1/22/2017,17,11571,651,4629,1084,9,1,17945
1/22/2017,18,11572,647,5012,1139,2,1,18373
1/22/2017,19,11573,646,5288,1390,1,1,18899
1/22/2017,20,11567,648,4985,1792,0,1,18993
1/22/2017,21,11565,651,4529,1881,0,1,18627
1/22/2017,22,11560,333,4152,2002,0,2,18049
1/22/2017,23,11557,241,3638,2046,0,1,17483
1/22/2017,24,11547,241,3410,1784,0,1,16983
1/23/2017,1,11542,239,3354,1235,0,1,16371
1/23/2017,2,11547,237,3210,1032,0,6,16032
1/23/2017,3,11545,237,3264,1011,0,10,16067
1/23/2017,4,11554,239,3187,1113,0,11,16104
1/23/2017,5,11556,241,3147,1258,0,13,16215
1/23/2017,6,11557,240,3404,1034,0,19,16254
1/23/2017,7,11561,284,3925,1587,0,24,17381
1/23/2017,8,11553,373,4580,1615,2,32,18155
1/23/2017,9,11544,418,5158,1644,6,36,18806
1/23/2017,10,11544,518,4777,1717,20,34,18610
1/23/2017,11,11544,531,4786,1749,27,28,18665
1/23/2017,12,11550,462,4484,1667,34,39,18236
1/23/2017,13,11549,433,4640,1648,50,29,18349
1/23/2017,14,11543,535,4844,1444,38,26,18430
1/23/2017,15,11544,726,4826,1320,32,28,18476
1/23/2017,16,11542,866,4564,1401,22,27,18422
1/23/2017,17,11548,829,4652,1439,8,27,18503
1/23/2017,18,11552,878,5726,1356,0,27,19539
1/23/2017,19,11548,951,5745,1531,0,27,19802
1/23/2017,20,11556,828,5375,1674,0,27,19460
1/23/2017,21,11539,891,5535,1538,0,31,19534
1/23/2017,22,11542,507,5135,1482,0,31,18697
1/23/2017,23,11546,411,4334,1286,0,27,17604
1/23/2017,24,11552,357,3993,1118,0,17,17037
1/24/2017,1,11554,363,3735,881,0,14,16547
1/24/2017,2,11555,428,3474,692,0,13,16162
1/24/2017,3,11563,465,3341,509,0,12,15890
1/24/2017,4,11566,496,3413,432,0,12,15919
1/24/2017,5,11567,658,3277,310,0,17,15829
1/24/2017,6,11575,804,3462,269,0,39,16149
1/24/2017,7,11587,1077,3906,166,0,82,16818
1/24/2017,8,11585,1425,4607,107,2,143,17869
1/24/2017,9,11585,1200,5047,72,3,138,18045
1/24/2017,10,11584,1179,5090,67,15,171,18106
1/24/2017,11,11581,1150,5098,53,26,204,18112
1/24/2017,12,11579,1135,5052,64,30,196,18056
1/24/2017,13,11581,932,4758,205,28,177,17681
1/24/2017,14,11578,511,4835,435,23,131,17513
1/24/2017,15,11561,426,5003,599,13,142,17744
1/24/2017,16,11565,601,5203,581,6,140,18096
1/24/2017,17,11565,964,5396,573,2,143,18643
1/24/2017,18,11579,1407,5661,599,0,170,19416
1/24/2017,19,11583,1462,5785,694,0,166,19690
1/24/2017,20,11581,1401,5719,796,0,130,19627
1/24/2017,21,11571,1313,6172,600,0,149,19805
1/24/2017,22,11569,1329,5490,521,0,130,19039
1/24/2017,23,11575,1216,4596,479,0,42,17908
1/24/2017,24,11577,538,3666,485,0,14,16280
1/25/2017,1,11575,406,3509,552,0,11,16053
1/25/2017,2,11576,404,3791,483,0,11,16265
1/25/2017,3,11572,405,3419,626,0,11,16033
1/25/2017,4,11575,414,3273,604,0,12,15878
1/25/2017,5,11578,414,3319,662,0,13,15986
1/25/2017,6,11584,529,3444,280,0,20,15857
1/25/2017,7,11585,672,4129,219,0,24,16629
1/25/2017,8,11574,829,4800,310,3,27,17543
1/25/2017,9,11578,847,4917,377,5,27,17751
1/25/2017,10,11575,863,4909,442,19,27,17835
1/25/2017,11,11579,879,4598,800,31,27,17914
1/25/2017,12,11580,904,4477,1122,48,27,18158
1/25/2017,13,11579,906,4524,1167,30,27,18233
1/25/2017,14,11444,1006,5263,800,23,27,18563
1/25/2017,15,11585,978,5067,560,14,27,18231
1/25/2017,16,11583,1159,5357,423,11,27,18560
1/25/2017,17,11587,1127,5250,404,3,27,18398
1/25/2017,18,11591,1102,5605,678,1,27,19004
1/25/2017,19,11587,772,5456,958,1,27,18801
1/25/2017,20,11592,685,5197,1279,0,27,18780
1/25/2017,21,11584,552,5181,1677,0,27,19021
1/25/2017,22,11576,503,4555,1973,0,27,18634
1/25/2017,23,11562,493,3797,2089,0,27,17968
1/25/2017,24,11571,480,3559,1549,0,18,17177
1/26/2017,1,11572,477,3364,1437,0,13,16863
1/26/2017,2,11580,478,3340,1072,0,12,16482
1/26/2017,3,11577,478,3349,790,0,11,16205
1/26/2017,4,11577,478,3278,784,0,11,16128
1/26/2017,5,11576,476,3271,833,0,13,16169
1/26/2017,6,11575,477,3419,1237,0,19,16727
1/26/2017,7,11577,477,3709,1517,0,24,17304
1/26/2017,8,11581,490,4360,2083,2,27,18543
1/26/2017,9,11580,490,4838,2101,3,27,19039
1/26/2017,10,11579,492,5038,2128,8,27,19272
1/26/2017,11,11580,493,4881,2139,18,27,19138
1/26/2017,12,11587,491,4494,2282,23,27,18904
1/26/2017,13,11591,491,4516,2443,22,27,19090
1/26/2017,14,11597,492,4300,2640,30,27,19086
1/26/2017,15,11596,492,4167,2636,38,27,18956
1/26/2017,16,11592,492,4389,2539,22,27,19061
1/26/2017,17,11590,491,4663,2698,1,27,19470
1/26/2017,18,11577,491,5060,3065,0,27,20220
1/26/2017,19,11577,492,5016,3308,0,26,20419
1/26/2017,20,11575,493,4985,3156,0,28,20237
1/26/2017,21,11572,493,4831,3025,0,27,19948
1/26/2017,22,11562,492,4331,2892,0,27,19304
1/26/2017,23,11574,493,3727,2955,0,27,18776
1/26/2017,24,11579,478,3544,2190,0,16,17807
1/27/2017,1,11575,479,3206,1722,0,13,16995
1/27/2017,2,11578,478,3193,1416,0,12,16677
1/27/2017,3,11579,479,3135,1266,0,12,16471
1/27/2017,4,11575,480,3073,1217,0,12,16357
1/27/2017,5,11579,490,3124,1331,0,13,16537
1/27/2017,6,11575,507,3211,1632,0,19,16944
1/27/2017,7,11584,511,3684,2073,0,22,17874
1/27/2017,8,11586,523,4219,2511,1,27,18867
1/27/2017,9,11585,522,4374,2641,3,27,19152
1/27/2017,10,11587,522,4513,2780,14,27,19443
1/27/2017,11,11583,524,4495,2538,22,27,19189
1/27/2017,12,11578,524,4170,2586,35,27,18920
1/27/2017,13,11571,642,4120,1948,58,27,18366
1/27/2017,14,11581,536,4083,2527,61,27,18815
1/27/2017,15,11580,520,4208,2628,34,26,18996
1/27/2017,16,11578,526,4265,2572,14,25,18980
1/27/2017,17,11577,526,4461,2804,3,26,19397
1/27/2017,18,11579,521,4946,2987,0,27,20060
1/27/2017,19,11589,522,4880,3127,0,27,20145
1/27/2017,20,11590,520,4843,3129,0,27,20109
1/27/2017,21,11587,492,4677,3068,0,27,19851
1/27/2017,22,11581,494,4216,3003,0,27,19321
1/27/2017,23,11577,477,3376,2905,0,27,18362
1/27/2017,24,11577,345,3126,2624,0,15,17687
1/28/2017,1,11572,319,2989,2163,0,13,17056
1/28/2017,2,11578,293,3017,1687,0,1,16576
1/28/2017,3,11583,282,2993,1396,0,0,16254
1/28/2017,4,11579,280,2939,1302,0,0,16100
1/28/2017,5,11586,279,2962,1276,0,0,16103
1/28/2017,6,11586,280,3023,1393,0,0,16282
1/28/2017,7,11590,280,3338,1651,0,0,16859
1/28/2017,8,11592,279,3659,1850,1,0,17381
1/28/2017,9,11589,278,3859,2140,5,0,17871
1/28/2017,10,11590,278,3898,2637,20,0,18423
1/28/2017,11,11591,271,4262,2510,22,1,18657
1/28/2017,12,11590,265,4431,2582,22,1,18891
1/28/2017,13,11586,270,4392,2614,30,1,18893
1/28/2017,14,11533,275,4246,2675,31,1,18761
1/28/2017,15,11487,275,4107,2745,27,1,18642
1/28/2017,16,11516,275,4198,2720,19,1,18729
1/28/2017,17,11513,272,4707,2708,5,1,19206
1/28/2017,18,11510,277,5524,2608,0,1,19920
1/28/2017,19,11509,281,5449,2610,0,1,19850
1/28/2017,20,11508,282,5234,2374,0,1,19399
1/28/2017,21,11508,283,4501,2634,0,1,18927
1/28/2017,22,11505,284,4027,2503,0,1,18320
1/28/2017,23,11519,328,3437,2521,0,1,17806
1/28/2017,24,11526,337,3011,2327,0,1,17202
1/29/2017,1,11517,336,2982,2163,0,1,16999
1/29/2017,2,11511,370,3027,1808,0,1,16717
1/29/2017,3,11511,372,3022,1560,0,1,16466
1/29/2017,4,11507,382,2967,1550,0,1,16407
1/29/2017,5,11508,404,2980,1540,0,1,16433
1/29/2017,6,11508,417,3041,1409,0,1,16376
1/29/2017,7,11511,449,3447,1304,0,1,16712
1/29/2017,8,11514,484,3805,1170,2,2,16977
1/29/2017,9,11504,542,4086,1235,5,1,17373
1/29/2017,10,11506,663,4463,1253,13,1,17899
1/29/2017,11,11507,733,4684,1252,29,1,18206
1/29/2017,12,11519,808,4627,1237,59,1,18251
1/29/2017,13,11519,1008,4510,1248,57,1,18343
1/29/2017,14,11518,1338,4421,1127,29,1,18434
1/29/2017,15,11522,1550,4513,941,30,1,18557
1/29/2017,16,11524,1581,4748,938,21,1,18813
1/29/2017,17,11515,1705,5406,717,7,1,19351
1/29/2017,18,11514,1717,5852,523,0,1,19607
1/29/2017,19,11510,1732,6067,434,0,1,19744
1/29/2017,20,11512,1680,6051,376,0,1,19620
1/29/2017,21,11511,1380,5886,391,0,3,19171
1/29/2017,22,11509,987,5640,287,0,7,18430
1/29/2017,23,11511,912,5105,179,0,0,17707
1/29/2017,24,11516,410,4353,163,0,7,16449
1/30/2017,1,11504,311,3664,288,0,10,15777
1/30/2017,2,11501,323,3796,274,0,10,15904
1/30/2017,3,11497,417,4037,190,0,10,16151
1/30/2017,4,11512,585,3833,281,0,10,16221
1/30/2017,5,11518,835,3532,562,0,12,16459
1/30/2017,6,11512,1110,3901,450,0,30,17003
1/30/2017,7,11514,1149,4815,520,0,78,18076
1/30/2017,8,11518,1215,5563,688,2,183,19169
1/30/2017,9,11517,1330,5694,676,21,220,19458
1/30/2017,10,11518,1334,5682,559,79,215,19387
1/30/2017,11,11521,1231,5278,443,97,199,18769
1/30/2017,12,11524,1240,5119,418,105,136,18542
1/30/2017,13,11519,1267,4879,444,115,141,18365
1/30/2017,14,11473,1232,4548,548,125,82,18008
1/30/2017,15,11337,1109,4615,546,133,81,17821
1/30/2017,16,11514,1275,4935,412,74,88,18298
1/30/2017,17,11517,1399,5508,300,15,107,18846
1/30/2017,18,11507,1585,5907,309,0,139,19447
1/30/2017,19,11505,1655,5952,473,0,147,19732
1/30/2017,20,11505,1289,5877,651,0,155,19477
1/30/2017,21,11506,1099,5558,762,0,165,19090
1/30/2017,22,11541,1226,5357,884,0,138,19146
1/30/2017,23,11117,1009,4425,1183,0,39,17773
1/30/2017,24,10726,850,3541,1292,0,18,16427
1/31/2017,1,9923,754,4297,1179,0,10,16163
1/31/2017,2,9912,434,4024,1444,0,9,15823
1/31/2017,3,9917,436,3353,1406,0,10,15122
1/31/2017,4,9916,452,3410,1717,0,10,15505
1/31/2017,5,9916,628,3469,1767,0,12,15792
1/31/2017,6,9917,802,3657,1813,0,18,16207
1/31/2017,7,9916,1194,4601,1610,1,23,17345
1/31/2017,8,9920,1556,5524,1475,2,27,18504
1/31/2017,9,9920,1863,5879,1125,12,26,18825
1/31/2017,10,9906,1898,5751,798,37,27,18417
1/31/2017,11,9894,1955,5555,623,38,49,18114
1/31/2017,12,9888,1868,5404,526,63,75,17824
1/31/2017,13,9886,1911,5105,373,85,90,17450
1/31/2017,14,9885,2025,5080,270,62,131,17453
1/31/2017,15,9891,2305,5159,204,45,137,17741
1/31/2017,16,9893,2597,5069,238,25,90,17912
1/31/2017,17,9914,2336,5709,255,8,103,18325
1/31/2017,18,9908,2922,5924,520,1,153,19428
1/31/2017,19,9909,2557,5904,884,0,153,19407
1/31/2017,20,9909,2000,5874,1400,0,166,19349
1/31/2017,21,9909,1608,5596,1703,0,177,18993
1/31/2017,22,9910,1115,5258,1951,0,192,18426
1/31/2017,23,9904,1016,4634,2227,0,181,17962
1/31/2017,24,9907,395,4032,2565,0,120,17019
2/1/2017,1,9910,297,3391,2630,0,20,16248
2/1/2017,2,9908,294,3190,2855,0,9,16256
2/1/2017,3,9903,295,3199,3064,0,9,16470
2/1/2017,4,9877,299,3385,2829,0,9,16399
2/1/2017,5,9869,412,3572,2462,0,12,16327
2/1/2017,6,9877,598,3663,2182,0,18,16338
2/1/2017,7,9873,808,4569,2106,0,24,17380
2/1/2017,8,9878,857,5256,1946,1,29,17967
2/1/2017,9,9875,930,5225,1829,12,28,17899
2/1/2017,10,9877,802,4786,2016,61,27,17569
2/1/2017,11,9865,1011,4659,2008,96,26,17665
2/1/2017,12,9878,1419,4532,2133,104,26,18092
2/1/2017,13,9876,1578,4572,2173,105,26,18330
2/1/2017,14,9730,1558,4315,2119,84,26,17832
2/1/2017,15,9738,1562,4329,1863,119,26,17637
2/1/2017,16,9885,1626,4373,1765,88,26,17763
2/1/2017,17,9881,1783,4726,1638,28,30,18086
2/1/2017,18,9878,1731,5444,1526,1,28,18608
2/1/2017,19,9877,1777,5883,1574,1,27,19139
2/1/2017,20,9876,1848,5945,1490,1,27,19187
2/1/2017,21,9875,1518,5866,1454,1,27,18741
2/1/2017,22,9864,768,5253,1628,1,27,17541
2/1/2017,23,9870,666,4319,1731,1,27,16614
2/1/2017,24,9872,543,4012,1640,1,17,16085
2/2/2017,1,9884,383,4028,1511,1,16,15823
2/2/2017,2,9882,327,4094,1613,1,14,15931
2/2/2017,3,9797,427,3251,1657,0,13,15145
2/2/2017,4,9742,550,3343,1885,0,10,15530
2/2/2017,5,9739,708,3344,2057,0,19,15867
2/2/2017,6,9743,705,3726,2019,0,42,16235
2/2/2017,7,9925,704,4133,2176,1,52,16991
2/2/2017,8,9950,707,4661,2491,3,54,17866
2/2/2017,9,9945,707,5125,2596,15,55,18443
2/2/2017,10,9950,699,4824,2860,73,56,18462
2/2/2017,11,10002,774,4335,2795,128,59,18093
2/2/2017,12,10209,476,4394,3243,148,59,18529
2/2/2017,13,10412,498,4119,3324,180,40,18573
2/2/2017,14,10419,759,3892,3324,131,55,18580
2/2/2017,15,10417,1000,4012,3201,121,54,18805
2/2/2017,16,10419,1158,4072,3033,92,53,18827
2/2/2017,17,10363,1294,4638,2742,42,57,19136
2/2/2017,18,10364,1364,5366,2610,3,60,19767
2/2/2017,19,10365,1358,5873,2595,0,55,20246
2/2/2017,20,10368,1285,5578,2866,0,54,20151
2/2/2017,21,10362,1154,5159,2952,0,33,19660
2/2/2017,22,10354,804,4692,2871,0,37,18758
2/2/2017,23,10055,370,4207,2881,0,47,17560
2/2/2017,24,10029,287,3632,2767,0,38,16753
2/3/2017,1,10017,300,3325,2690,0,31,16363
2/3/2017,2,10080,308,3691,2501,0,15,16595
2/3/2017,3,10096,312,3895,2235,0,8,16546
2/3/2017,4,10104,408,3619,2072,0,9,16212
2/3/2017,5,10107,546,3701,2115,0,9,16478
2/3/2017,6,10129,707,3406,2056,0,10,16308
2/3/2017,7,10135,738,4208,2237,0,19,17337
2/3/2017,8,10211,728,5551,2324,2,27,18843
2/3/2017,9,10299,782,5798,2313,18,27,19237
2/3/2017,10,10303,890,5668,2232,89,27,19209
2/3/2017,11,10320,724,4932,2282,131,27,18416
2/3/2017,12,10374,720,4462,2526,134,30,18246
2/3/2017,13,10438,716,4633,2687,139,34,18647
2/3/2017,14,10476,720,4254,2853,138,32,18473
2/3/2017,15,10816,407,3832,3049,87,30,18221
2/3/2017,16,10883,307,4065,3030,52,23,18360
2/3/2017,17,10882,298,4729,2784,39,27,18759
2/3/2017,18,10881,298,5678,2561,4,28,19450
2/3/2017,19,10882,366,5858,2504,1,30,19641
2/3/2017,20,10908,311,5688,2787,1,27,19722
2/3/2017,21,10631,303,5235,2894,0,27,19090
2/3/2017,22,10480,301,4762,2864,1,27,18435
2/3/2017,23,10270,299,4104,2825,0,27,17525
2/3/2017,24,10260,300,3872,2652,0,16,17100
2/4/2017,1,10341,301,3516,2442,0,2,16602
2/4/2017,2,10268,299,3780,2120,0,0,16467
2/4/2017,3,10339,300,3376,1985,0,0,16000
2/4/2017,4,10357,301,3451,1905,0,0,16014
2/4/2017,5,10363,299,3278,1937,0,0,15877
2/4/2017,6,10369,299,3462,1996,0,0,16126
2/4/2017,7,10368,304,3781,2138,0,0,16591
2/4/2017,8,10372,301,4489,2261,4,2,17429
2/4/2017,9,10376,303,5118,2249,41,1,18088
2/4/2017,10,10424,339,5385,2040,100,0,18288
2/4/2017,11,10474,368,5210,2231,139,0,18422
2/4/2017,12,10470,310,4583,2449,162,0,17974
2/4/2017,13,10477,301,4263,2584,170,0,17795
2/4/2017,14,10518,301,4141,2516,167,2,17645
2/4/2017,15,10516,301,4193,2551,142,1,17704
2/4/2017,16,10523,301,4241,2388,80,0,17533
2/4/2017,17,10513,301,4804,2283,21,2,17924
2/4/2017,18,10511,301,5384,2225,1,1,18423
2/4/2017,19,10514,302,5809,2376,0,0,19001
2/4/2017,20,10520,302,5784,2477,0,0,19083
2/4/2017,21,10596,300,4968,2557,0,1,18422
2/4/2017,22,10579,301,4363,2679,0,1,17923
2/4/2017,23,10564,300,3691,2821,0,0,17376
2/4/2017,24,10574,327,3235,2814,0,0,16950
2/5/2017,1,10597,358,3086,2599,0,0,16640
2/5/2017,2,10604,361,3053,2063,0,0,16081
2/5/2017,3,10599,352,3088,1960,0,0,15999
2/5/2017,4,10599,338,3024,1773,0,0,15734
2/5/2017,5,10605,332,3010,1759,0,0,15706
2/5/2017,6,10595,326,3118,1855,0,0,15894
2/5/2017,7,10589,325,3438,1885,0,0,16237
2/5/2017,8,10588,299,3605,2122,1,0,16615
2/5/2017,9,10589,301,3814,2543,11,0,17258
2/5/2017,10,10590,299,3997,2966,28,0,17880
2/5/2017,11,10596,296,3677,3145,43,0,17757
2/5/2017,12,10626,294,4204,3229,32,0,18385
2/5/2017,13,10625,295,4410,3165,39,0,18534
2/5/2017,14,10627,295,4452,3277,36,0,18687
2/5/2017,15,10631,295,4229,3181,27,0,18363
2/5/2017,16,10591,295,4352,3044,17,0,18299
2/5/2017,17,10630,267,4971,2847,5,0,18720
2/5/2017,18,10629,265,5261,2790,0,0,18945
2/5/2017,19,10636,295,5173,2731,0,0,18835
2/5/2017,20,10638,296,4787,2657,0,0,18378
2/5/2017,21,10631,296,5217,2250,0,0,18394
2/5/2017,22,10618,299,5544,1660,0,0,18121
2/5/2017,23,10610,306,5188,1282,0,5,17391
2/5/2017,24,10615,297,4228,1048,0,0,16188
2/6/2017,1,10623,304,3777,973,0,6,15683
2/6/2017,2,10625,326,3678,621,0,9,15259
2/6/2017,3,10625,323,3939,409,0,9,15305
2/6/2017,4,10629,387,3824,287,0,9,15136
2/6/2017,5,10636,416,3735,336,0,12,15135
2/6/2017,6,10669,604,3513,240,0,44,15070
2/6/2017,7,10668,766,4518,186,0,73,16211
2/6/2017,8,10670,1076,5447,217,0,163,17573
2/6/2017,9,10664,955,5540,423,11,199,17792
2/6/2017,10,10675,892,5298,558,38,179,17640
2/6/2017,11,10677,890,5123,671,57,144,17562
2/6/2017,12,10675,931,5087,932,63,187,17875
2/6/2017,13,10668,898,4705,1034,115,126,17546
2/6/2017,14,10659,941,4654,847,130,76,17307
2/6/2017,15,10663,988,5047,612,102,95,17507
2/6/2017,16,10662,1141,5394,326,48,91,17662
2/6/2017,17,10664,1170,5631,136,15,81,17697
2/6/2017,18,10661,1426,5881,240,1,126,18335
2/6/2017,19,10668,1518,5965,355,0,180,18686
2/6/2017,20,10658,1467,5867,450,0,180,18622
2/6/2017,21,10657,1468,5682,711,0,149,18667
2/6/2017,22,10675,729,5148,909,0,114,17575
2/6/2017,23,10663,497,4615,982,0,139,16896
2/6/2017,24,10664,390,3898,1154,0,77,16183
2/7/2017,1,10663,297,3960,1100,0,68,16088
2/7/2017,2,10666,297,3953,1110,0,144,16170
2/7/2017,3,10668,300,3526,1285,0,137,15916
2/7/2017,4,10672,302,3241,1526,0,67,15808
2/7/2017,5,10674,319,3155,1964,0,63,16175
2/7/2017,6,10672,364,3336,1953,0,71,16396
2/7/2017,7,10679,491,3873,2013,0,75,17131
2/7/2017,8,10670,497,4434,2753,0,78,18432
2/7/2017,9,10665,542,4681,3203,1,78,19170
2/7/2017,10,10659,711,5044,3087,6,82,19589
2/7/2017,11,10657,831,5340,2744,7,160,19739
2/7/2017,12,10659,737,5279,2863,14,189,19741
2/7/2017,13,10665,966,5513,2327,16,195,19682
2/7/2017,14,10661,1275,5448,1943,11,201,19539
2/7/2017,15,10662,1139,5120,1712,9,207,18849
2/7/2017,16,10666,942,4873,2058,4,135,18678
2/7/2017,17,10665,685,4996,2190,0,100,18636
2/7/2017,18,10662,660,5493,2188,0,188,19191
2/7/2017,19,10661,750,5415,2507,0,194,19527
2/7/2017,20,10659,880,4877,2602,0,144,19162
2/7/2017,21,10662,1490,4612,2310,0,85,19159
2/7/2017,22,10664,1499,3820,2404,0,78,18465
2/7/2017,23,10666,1354,3504,2269,0,36,17829
2/7/2017,24,10670,1014,3297,1999,0,15,16995
2/8/2017,1,10672,610,3343,1992,0,10,16627
2/8/2017,2,10670,610,3350,1448,0,9,16087
2/8/2017,3,10666,618,3312,1352,0,11,15959
2/8/2017,4,10655,563,3260,1398,0,12,15888
2/8/2017,5,10664,662,3305,1322,0,14,15967
2/8/2017,6,10665,830,3426,1778,0,17,16716
2/8/2017,7,10662,1061,3815,2306,0,24,17868
2/8/2017,8,10665,1212,4421,2441,3,27,18769
2/8/2017,9,10671,1215,4478,2057,34,26,18481
2/8/2017,10,10668,1242,4788,1683,64,26,18471
2/8/2017,11,10672,1295,4846,1572,132,26,18543
2/8/2017,12,10681,1500,5258,1358,129,26,18952
2/8/2017,13,10670,1624,4742,1553,108,27,18724
2/8/2017,14,10673,1597,4239,1645,115,27,18296
2/8/2017,15,10673,1602,4324,1390,91,26,18106
2/8/2017,16,10672,1630,5081,1256,68,26,18733
2/8/2017,17,10680,1696,5262,1113,26,27,18804
2/8/2017,18,10680,1821,5555,1174,1,27,19258
2/8/2017,19,10680,1912,5938,1039,0,27,19596
2/8/2017,20,10679,1861,5858,982,0,27,19407
2/8/2017,21,10673,1432,5872,1176,0,27,19180
2/8/2017,22,10673,806,5235,1223,0,27,17964
2/8/2017,23,10666,628,4988,1034,0,27,17343
2/8/2017,24,10665,613,4399,1055,0,17,16749
2/9/2017,1,10667,697,3692,1256,0,15,16327
2/9/2017,2,10667,845,3408,1192,0,17,16129
2/9/2017,3,10666,998,3625,1131,0,17,16437
2/9/2017,4,10669,986,3637,952,0,15,16259
2/9/2017,5,10668,982,3359,1069,0,14,16092
2/9/2017,6,10665,981,3486,974,0,18,16124
2/9/2017,7,10669,1020,4065,1260,0,24,17038
2/9/2017,8,10669,1293,4877,1440,2,25,18306
2/9/2017,9,10669,1343,5374,1338,41,27,18792
2/9/2017,10,10671,1122,5081,1463,93,26,18456
2/9/2017,11,10672,1022,4612,1662,118,26,18112
2/9/2017,12,10659,1006,4697,1820,179,26,18387
2/9/2017,13,10652,992,4849,1984,143,26,18646
2/9/2017,14,10661,995,4467,2387,109,27,18646
2/9/2017,15,10665,1023,4180,2675,104,26,18673
2/9/2017,16,10669,1059,4203,2966,77,27,19001
2/9/2017,17,10667,1258,4577,2967,36,20,19525
2/9/2017,18,10671,1401,4921,3057,4,26,20080
2/9/2017,19,10674,1505,5464,3006,0,27,20676
2/9/2017,20,10674,1504,5559,2976,1,27,20741
2/9/2017,21,10669,1337,5639,3129,0,27,20801
2/9/2017,22,10662,965,4502,3089,0,27,19245
2/9/2017,23,10664,389,4339,3049,0,27,18468
2/9/2017,24,10671,295,3659,2920,0,19,17564
2/10/2017,1,10666,301,3588,2614,0,14,17183
2/10/2017,2,10676,336,3719,2436,0,13,17180
2/10/2017,3,10676,551,3469,2052,0,14,16762
2/10/2017,4,10671,907,3606,1668,0,16,16868
2/10/2017,5,10671,1095,3614,1588,0,17,16985
2/10/2017,6,10681,1116,3914,1121,0,19,16851
2/10/2017,7,10684,1246,5074,940,1,24,17969
2/10/2017,8,10684,1486,5533,1013,5,31,18752
2/10/2017,9,10683,1226,5560,1084,42,31,18626
2/10/2017,10,10681,1120,5298,1282,79,31,18491
2/10/2017,11,10684,784,4852,1750,106,31,18207
2/10/2017,12,10687,674,4453,2169,137,31,18151
2/10/2017,13,10682,696,4829,2362,84,31,18684
2/10/2017,14,10678,538,4787,2895,77,31,19006
2/10/2017,15,10678,504,4421,3138,75,31,18847
2/10/2017,16,10676,501,4416,3329,26,31,18979
2/10/2017,17,10680,400,4615,3345,6,31,19077
2/10/2017,18,10681,338,5400,3324,0,31,19774
2/10/2017,19,10680,318,5760,3342,0,31,20131
2/10/2017,20,10688,318,5099,3312,0,30,19447
2/10/2017,21,10686,318,5021,3259,0,29,19313
2/10/2017,22,10685,321,4703,3099,0,31,18839
2/10/2017,23,10682,363,4466,2746,0,29,18286
2/10/2017,24,10673,296,3888,2432,0,7,17296
2/11/2017,1,10685,342,3186,2048,0,0,16261
2/11/2017,2,10682,334,3241,1976,0,0,16233
2/11/2017,3,10677,414,2670,2044,0,0,15805
2/11/2017,4,10681,519,2697,1816,0,0,15713
2/11/2017,5,10680,719,3006,1494,0,0,15899
2/11/2017,6,10679,1037,3234,1143,0,0,16093
2/11/2017,7,10684,1091,3610,1021,0,0,16406
2/11/2017,8,10681,1121,4163,973,2,0,16940
2/11/2017,9,10681,1428,4622,686,9,0,17426
2/11/2017,10,10682,1542,4810,354,20,0,17408
2/11/2017,11,10685,1640,4976,203,47,0,17551
2/11/2017,12,10679,1536,4838,146,48,0,17247
2/11/2017,13,10676,1547,4813,128,60,0,17224
2/11/2017,14,10677,1375,4721,141,56,0,16970
2/11/2017,15,10676,1030,4745,50,46,0,16547
2/11/2017,16,10677,989,4932,31,38,0,16667
2/11/2017,17,10676,1012,5026,34,14,0,16762
2/11/2017,18,10677,985,5533,55,4,0,17254
2/11/2017,19,10680,1190,5625,99,0,0,17594
2/11/2017,20,10675,933,5395,132,0,0,17135
2/11/2017,21,10673,670,5160,187,0,0,16690
2/11/2017,22,10668,649,4737,301,0,0,16355
2/11/2017,23,10667,656,4125,312,0,0,15760
2/11/2017,24,10676,665,3555,491,0,0,15387
2/12/2017,1,10668,330,2970,775,0,0,14743
2/12/2017,2,10665,240,3040,944,0,0,14889
2/12/2017,3,10667,242,3179,1044,0,0,15132
2/12/2017,4,10655,241,3024,1095,0,0,15015
2/12/2017,5,10661,241,3341,1013,0,0,15256
2/12/2017,6,10668,241,3702,750,0,0,15361
2/12/2017,7,10664,241,3865,669,0,0,15439
2/12/2017,8,10672,238,4242,477,2,0,15631
2/12/2017,9,10666,291,5214,395,2,4,16572
2/12/2017,10,10672,617,5427,308,6,10,17040
2/12/2017,11,10671,571,4832,731,6,8,16819
2/12/2017,12,10675,566,5221,852,11,0,17325
2/12/2017,13,10680,693,5057,977,9,0,17416
2/12/2017,14,10682,338,4916,1676,20,2,17634
2/12/2017,15,10636,270,4676,1975,17,0,17574
2/12/2017,16,10676,272,4344,2718,8,0,18018
2/12/2017,17,10675,272,4173,3149,1,0,18270
2/12/2017,18,10675,280,4805,3346,0,0,19106
2/12/2017,19,10677,393,4877,3535,0,0,19482
2/12/2017,20,10676,318,4680,3568,0,0,19242
2/12/2017,21,10660,271,4338,3574,0,0,18843
2/12/2017,22,10656,271,3615,3556,0,0,18098
2/12/2017,23,10658,271,3359,3574,0,0,17862
2/12/2017,24,10658,271,2977,3225,0,5,17136
2/13/2017,1,10657,272,2837,2499,0,10,16275
2/13/2017,2,10413,272,2890,2338,0,12,15925
2/13/2017,3,10336,272,2845,2186,0,12,15651
2/13/2017,4,9885,397,2936,2581,0,11,15810
2/13/2017,5,9880,288,2855,2945,0,12,15980
2/13/2017,6,9880,297,3178,2998,0,17,16370
2/13/2017,7,9883,407,3740,2898,0,21,16949
2/13/2017,8,9882,651,4432,2882,2,32,17881
2/13/2017,9,9879,793,4763,2609,5,32,18081
2/13/2017,10,9877,1172,4895,2472,11,34,18461
2/13/2017,11,9879,1106,4835,2099,19,34,17972
2/13/2017,12,9884,1444,4847,1628,19,33,17855
2/13/2017,13,9880,1319,4940,1434,34,28,17635
2/13/2017,14,9886,1501,4701,1250,28,27,17393
2/13/2017,15,9845,1804,4826,1082,24,27,17608
2/13/2017,16,9846,1770,4867,977,16,27,17503
2/13/2017,17,9843,1878,5044,705,10,33,17513
2/13/2017,18,9841,2076,5558,574,2,30,18081
2/13/2017,19,9841,2516,5833,598,0,28,18816
2/13/2017,20,9831,2142,5574,1034,0,28,18609
2/13/2017,21,9826,1840,5143,1373,0,27,18209
2/13/2017,22,9824,1646,4688,1663,0,27,17848
2/13/2017,23,9823,1367,3899,1981,0,27,17097
2/13/2017,24,9810,573,3377,2079,0,18,15857
2/14/2017,1,9804,302,3211,2293,0,13,15623
2/14/2017,2,9807,300,3215,2378,0,12,15712
2/14/2017,3,9808,300,3252,2362,0,12,15734
2/14/2017,4,9805,298,3076,2310,0,12,15501
2/14/2017,5,9797,297,3244,2544,0,13,15895
2/14/2017,6,9803,298,3201,2660,0,20,15982
2/14/2017,7,9795,349,3812,2910,0,23,16889
2/14/2017,8,9794,497,4492,3087,3,27,17900
2/14/2017,9,9793,508,4660,2994,38,27,18020
2/14/2017,10,9789,505,4947,2930,72,27,18270
2/14/2017,11,9795,506,4637,2883,98,27,17946
2/14/2017,12,9806,517,4684,2867,101,27,18002
2/14/2017,13,9789,520,4326,2951,111,27,17724
2/14/2017,14,9788,361,4407,3094,109,27,17786
2/14/2017,15,9787,441,4303,3050,66,27,17674
2/14/2017,16,9787,596,4887,2726,28,27,18051
2/14/2017,17,9818,777,4723,2521,9,29,17877
2/14/2017,18,9818,799,5093,2522,2,28,18262
2/14/2017,19,9812,910,5453,2574,0,27,18776
2/14/2017,20,9816,959,5062,2788,0,27,18652
2/14/2017,21,9811,1006,5111,2801,0,27,18756
2/14/2017,22,9804,1196,4897,2320,0,27,18244
2/14/2017,23,9801,765,4196,2160,0,27,16949
2/14/2017,24,9804,592,3952,1630,0,19,15997
2/15/2017,1,9803,536,3583,1495,0,15,15432
2/15/2017,2,9793,323,3463,1552,0,15,15146
2/15/2017,3,9782,293,3703,1546,0,17,15341
2/15/2017,4,9795,296,3381,1922,0,17,15411
2/15/2017,5,9798,292,2951,2237,0,14,15292
2/15/2017,6,9826,298,3283,2273,0,19,15699
2/15/2017,7,9857,330,4002,2198,0,25,16412
2/15/2017,8,9851,363,4464,2671,0,27,17376
2/15/2017,9,9847,503,4943,2773,7,27,18100
2/15/2017,10,9845,638,4743,2801,43,27,18097
2/15/2017,11,9846,710,5065,2785,55,27,18488
2/15/2017,12,9847,862,5147,2842,82,27,18807
2/15/2017,13,9845,1135,4558,2914,89,27,18568
2/15/2017,14,9842,1223,4256,3078,112,27,18538
2/15/2017,15,9839,1206,4270,3084,81,27,18507
2/15/2017,16,9832,1266,4638,3066,26,27,18855
2/15/2017,17,9827,1172,5092,2932,9,27,19059
2/15/2017,18,9827,1202,5402,2624,0,27,19082
2/15/2017,19,9829,1406,5690,2530,0,27,19482
2/15/2017,20,9830,1160,5534,2748,0,27,19299
2/15/2017,21,9829,994,5390,2725,0,27,18965
2/15/2017,22,9819,642,4724,2523,0,27,17735
2/15/2017,23,9826,557,4287,2447,0,27,17144
2/15/2017,24,9834,453,3739,2393,0,17,16436
2/16/2017,1,9830,269,3481,2217,0,11,15808
2/16/2017,2,9836,290,3302,2166,0,10,15604
2/16/2017,3,9839,298,3466,1991,0,10,15604
2/16/2017,4,9840,356,3483,1972,0,10,15661
2/16/2017,5,9842,428,3618,2159,0,11,16058
2/16/2017,6,9848,549,3539,2244,0,29,16209
2/16/2017,7,9839,708,4452,2136,1,68,17204
2/16/2017,8,9843,877,5429,1993,2,148,18292
2/16/2017,9,9846,973,5341,1866,15,167,18208
2/16/2017,10,9846,971,4857,1736,53,151,17614
2/16/2017,11,9845,1020,4699,1423,115,124,17226
2/16/2017,12,9847,1155,4836,1169,141,134,17282
2/16/2017,13,9850,1013,4849,966,198,133,17009
2/16/2017,14,9840,1173,4831,839,218,134,17035
2/16/2017,15,9842,1399,5037,804,209,135,17426
2/16/2017,16,9841,1695,4877,799,158,133,17503
2/16/2017,17,9837,1819,4872,626,68,136,17358
2/16/2017,18,9835,1917,5505,507,6,138,17908
2/16/2017,19,9836,2368,5757,472,0,155,18588
2/16/2017,20,9833,2454,5687,511,0,182,18667
2/16/2017,21,9832,2316,5568,445,0,178,18339
2/16/2017,22,9829,1763,5383,357,0,184,17516
2/16/2017,23,9830,1055,4948,332,0,169,16334
2/16/2017,24,9828,739,4710,362,0,155,15794
2/17/2017,1,9829,366,3958,358,0,113,14624
2/17/2017,2,9835,312,3763,406,0,133,14449
2/17/2017,3,10002,318,3612,517,0,135,14584
2/17/2017,4,10069,424,3726,626,0,134,14979
2/17/2017,5,10063,584,3971,729,0,111,15458
2/17/2017,6,10072,718,3798,952,0,72,15612
2/17/2017,7,10074,759,4756,1088,2,75,16754
2/17/2017,8,10079,888,5109,1116,14,95,17301
2/17/2017,9,10048,901,5049,1073,93,76,17240
2/17/2017,10,10032,894,5153,993,152,79,17303
2/17/2017,11,10029,965,5165,919,182,97,17357
2/17/2017,12,10031,666,5109,842,172,111,16931
2/17/2017,13,10035,701,4745,927,198,127,16733
2/17/2017,14,10033,845,4675,911,208,94,16766
2/17/2017,15,10024,742,4763,1028,188,88,16833
2/17/2017,16,10030,786,5343,881,112,119,17271
2/17/2017,17,10033,733,5449,808,31,96,17150
2/17/2017,18,10034,709,5508,879,4,40,17174
2/17/2017,19,10040,702,5438,1330,0,27,17537
2/17/2017,20,10041,699,5208,1581,0,27,17556
2/17/2017,21,10037,700,5001,1776,0,27,17541
2/17/2017,22,10033,700,4612,1893,0,27,17265
2/17/2017,23,10035,386,4347,2043,0,27,16838
2/17/2017,24,10036,241,3758,2286,0,16,16337
2/18/2017,1,10035,236,3224,2625,0,12,16132
2/18/2017,2,10034,245,2791,2742,0,4,15816
2/18/2017,3,10031,255,2695,2686,0,0,15667
2/18/2017,4,10031,264,2704,2547,0,0,15546
2/18/2017,5,10028,264,2673,2638,0,0,15603
2/18/2017,6,10034,257,2908,2583,0,0,15782
2/18/2017,7,10037,207,3185,2448,0,0,15877
2/18/2017,8,10041,206,3335,2450,12,0,16044
2/18/2017,9,10041,211,3524,2288,92,0,16156
2/18/2017,10,10039,209,3657,2127,167,0,16199
2/18/2017,11,10036,199,3654,1794,212,0,15895
2/18/2017,12,10039,200,3547,1650,184,0,15620
2/18/2017,13,10033,202,3532,1621,106,0,15494
2/18/2017,14,10036,201,3425,1456,50,0,15168
2/18/2017,15,10040,173,3554,1217,12,1,14997
2/18/2017,16,9996,221,3713,1254,87,1,15272
2/18/2017,17,10022,228,3935,1482,53,0,15720
2/18/2017,18,10029,227,4474,2040,10,1,16781
2/18/2017,19,10036,228,4857,2622,0,1,17744
2/18/2017,20,10039,229,4856,2553,0,1,17678
2/18/2017,21,10037,229,4621,2369,0,1,17257
2/18/2017,22,10033,229,4178,1854,0,1,16295
2/18/2017,23,10036,228,3910,1747,0,1,15922
2/18/2017,24,10039,227,3677,1521,0,1,15465
2/19/2017,1,10042,228,3001,1587,0,1,14859
2/19/2017,2,10037,228,3033,1251,0,1,14550
2/19/2017,3,9963,228,3103,925,0,1,14220
2/19/2017,4,9740,230,3055,1000,0,1,14026
2/19/2017,5,9737,228,3118,961,0,1,14045
2/19/2017,6,9961,228,3179,873,0,1,14242
2/19/2017,7,10029,229,3602,883,1,1,14745
2/19/2017,8,10033,229,3691,827,19,1,14800
2/19/2017,9,10034,229,3682,823,84,1,14853
2/19/2017,10,10032,228,3694,655,138,1,14748
2/19/2017,11,10033,229,3747,566,171,1,14747
2/19/2017,12,10032,229,3853,678,190,1,14983
2/19/2017,13,10036,228,3825,797,209,1,15096
2/19/2017,14,10034,229,3853,512,166,1,14795
2/19/2017,15,10032,230,3898,488,61,1,14710
2/19/2017,16,10034,230,3979,508,96,1,14848
2/19/2017,17,10034,230,4538,673,78,1,15554
2/19/2017,18,10022,230,5202,878,13,2,16347
2/19/2017,19,10023,230,5746,971,0,1,16971
2/19/2017,20,10034,230,5675,912,0,1,16852
2/19/2017,21,10028,236,5840,703,0,1,16808
2/19/2017,22,10027,269,5293,632,0,1,16222
2/19/2017,23,10024,232,5008,529,0,1,15794
2/19/2017,24,10032,242,4755,493,0,1,15523
2/20/2017,1,10027,232,4172,428,0,1,14860
2/20/2017,2,10031,232,3875,345,0,1,14484
2/20/2017,3,10027,230,3569,364,0,1,14191
2/20/2017,4,10030,231,3470,430,0,1,14162
2/20/2017,5,10028,230,3470,614,0,1,14343
2/20/2017,6,10031,231,3320,903,0,1,14486
2/20/2017,7,10032,233,3746,1146,0,1,15158
2/20/2017,8,10032,232,3590,1196,21,1,15072
2/20/2017,9,10033,231,3559,753,109,1,14686
2/20/2017,10,10032,228,3712,833,165,1,14971
2/20/2017,11,10030,231,3906,864,217,1,15249
2/20/2017,12,10034,232,3872,856,224,1,15219
2/20/2017,13,10035,231,3809,780,223,1,15079
2/20/2017,14,10034,231,3823,477,223,1,14789
2/20/2017,15,10036,229,3822,375,208,1,14671
2/20/2017,16,10040,228,4189,497,138,1,15093
2/20/2017,17,10034,229,4434,883,81,1,15662
2/20/2017,18,10032,230,5314,1453,7,1,17037
2/20/2017,19,10032,235,5739,1865,0,1,17872
2/20/2017,20,10028,230,5138,2558,0,1,17955
2/20/2017,21,10028,231,4791,2356,0,1,17407
2/20/2017,22,10022,228,4305,2365,0,1,16921
2/20/2017,23,10016,227,3623,2337,0,1,16204
2/20/2017,24,10023,229,3384,2260,0,1,15897
2/21/2017,1,10015,231,3142,2192,0,1,15581
2/21/2017,2,10013,230,3137,2041,0,1,15422
2/21/2017,3,10013,231,3164,1923,0,1,15332
2/21/2017,4,10009,230,3081,1909,0,1,15230
2/21/2017,5,10010,229,3126,2014,0,1,15380
2/21/2017,6,10009,231,3298,2466,0,2,16006
2/21/2017,7,10016,286,4089,2384,1,9,16785
2/21/2017,8,10016,517,4660,2264,9,10,17476
2/21/2017,9,10022,816,4170,2306,29,13,17356
2/21/2017,10,10013,743,4425,2068,60,14,17323
2/21/2017,11,10024,608,4992,1720,81,10,17435
2/21/2017,12,10021,705,4970,1634,92,8,17430
2/21/2017,13,9897,790,4833,1275,83,9,16887
2/21/2017,14,9898,887,4515,1168,92,2,16562
2/21/2017,15,9899,1029,5012,1337,58,1,17336
2/21/2017,16,9898,1185,5388,1096,25,1,17593
2/21/2017,17,9900,1334,5277,1106,10,1,17628
2/21/2017,18,9902,1320,5641,956,1,1,17821
2/21/2017,19,9942,1328,5841,790,0,1,17902
2/21/2017,20,9952,1361,5918,826,0,1,18058
2/21/2017,21,9955,1383,5846,928,0,1,18113
2/21/2017,22,9951,1128,5470,721,0,1,17271
2/21/2017,23,9939,986,5001,682,0,1,16609
2/21/2017,24,9942,425,4387,624,0,1,15379
2/22/2017,1,9945,291,4339,525,0,1,15101
2/22/2017,2,9949,292,3929,428,0,1,14599
2/22/2017,3,9953,295,3753,344,0,1,14346
2/22/2017,4,9952,293,3490,532,0,1,14268
2/22/2017,5,9958,292,3172,787,0,4,14213
2/22/2017,6,9959,289,3589,712,0,4,14553
2/22/2017,7,9960,291,4151,919,0,2,15323
2/22/2017,8,9959,291,5006,1187,6,3,16452
2/22/2017,9,9959,291,5134,1274,42,22,16722
2/22/2017,10,9954,290,5155,1032,71,48,16550
2/22/2017,11,9951,289,5409,802,62,75,16588
2/22/2017,12,9954,289,4817,828,130,83,16101
2/22/2017,13,9955,288,4318,919,126,86,15692
2/22/2017,14,9817,290,4319,997,109,87,15619
2/22/2017,15,9877,384,4358,1179,107,86,15991
2/22/2017,16,9959,529,4378,1502,67,86,16521
2/22/2017,17,9961,705,4450,1806,32,86,17040
2/22/2017,18,9956,703,4976,2071,2,87,17795
2/22/2017,19,9959,707,4989,2517,0,95,18267
2/22/2017,20,9958,707,4996,2722,0,45,18428
2/22/2017,21,9955,705,4624,2769,0,62,18115
2/22/2017,22,9955,705,4046,3016,0,68,17790
2/22/2017,23,9952,377,3496,2902,0,67,16794
2/22/2017,24,9955,294,3154,2452,0,30,15885
2/23/2017,1,9952,307,2987,2033,0,13,15292
2/23/2017,2,9946,325,3045,1533,0,12,14861
2/23/2017,3,9942,324,3050,1332,0,12,14660
2/23/2017,4,9940,325,3001,1422,0,12,14700
2/23/2017,5,9945,321,3038,1412,0,15,14731
2/23/2017,6,9941,320,3328,1596,0,20,15205
2/23/2017,7,9952,319,3639,2502,0,47,16459
2/23/2017,8,9952,320,4013,3059,1,85,17430
2/23/2017,9,9950,297,4269,2694,8,108,17326
2/23/2017,10,9943,296,4368,2677,24,111,17419
2/23/2017,11,9945,343,4389,2480,39,109,17305
2/23/2017,12,9937,460,4472,2130,50,108,17157
2/23/2017,13,9942,566,4331,1908,113,110,16970
2/23/2017,14,9935,609,4423,1754,190,111,17022
2/23/2017,15,9928,637,4236,1599,192,111,16703
2/23/2017,16,9928,690,4374,1441,141,112,16686
2/23/2017,17,9922,777,5123,1180,73,111,17186
2/23/2017,18,9881,900,5552,1119,10,111,17573
2/23/2017,19,9078,923,5976,1385,0,111,17473
2/23/2017,20,9078,913,5840,1149,0,110,17090
2/23/2017,21,9077,912,6029,998,0,114,17130
2/23/2017,22,9067,908,5899,863,0,119,16856
2/23/2017,23,9070,608,4836,744,0,122,15380
2/23/2017,24,9071,343,4834,553,0,110,14911
2/24/2017,1,9070,293,4362,631,0,100,14456
2/24/2017,2,9084,306,3359,897,0,78,13724
2/24/2017,3,9112,310,3185,1066,0,38,13711
2/24/2017,4,9112,383,3039,1318,0,11,13863
2/24/2017,5,9113,462,3089,1464,0,13,14141
2/24/2017,6,9104,626,3351,1339,0,17,14437
2/24/2017,7,9108,891,3988,1445,0,23,15455
2/24/2017,8,9111,905,4812,1870,2,26,16726
2/24/2017,9,9109,952,5572,1756,12,26,17427
2/24/2017,10,9103,1110,5278,1968,28,26,17513
2/24/2017,11,9107,980,5419,1825,61,26,17418
2/24/2017,12,9106,912,5577,1825,94,26,17540
2/24/2017,13,9110,571,4833,2117,100,26,16757
2/24/2017,14,9108,493,5353,1757,95,27,16833
2/24/2017,15,9106,783,5559,1378,87,26,16939
2/24/2017,16,9112,876,5276,1403,83,26,16776
2/24/2017,17,9103,953,5255,1615,25,27,16978
2/24/2017,18,9104,713,5180,2100,2,27,17126
2/24/2017,19,9111,672,5121,2251,0,27,17182
2/24/2017,20,9110,674,4957,2575,0,27,17343
2/24/2017,21,9108,378,4986,2677,0,27,17176
2/24/2017,22,9102,291,4797,2784,0,27,17001
2/24/2017,23,9104,293,4136,2716,0,27,16276
2/24/2017,24,9103,272,3659,2643,0,21,15698
2/25/2017,1,9103,262,3644,2287,0,13,15309
2/25/2017,2,9105,260,3467,2164,0,0,14996
2/25/2017,3,9100,263,3471,1572,0,0,14406
2/25/2017,4,9099,262,3488,1287,0,0,14136
2/25/2017,5,9109,263,3418,1240,0,0,14030
2/25/2017,6,9137,223,3590,1424,0,0,14374
2/25/2017,7,9138,228,3887,2104,0,0,15357
2/25/2017,8,9140,228,4156,2128,2,0,15654
2/25/2017,9,9137,229,4338,2323,16,0,16043
2/25/2017,10,9138,231,4385,2624,36,0,16414
2/25/2017,11,9136,235,4423,3192,39,0,17025
2/25/2017,12,9142,234,4349,3417,78,0,17220
2/25/2017,13,9136,236,4350,3291,96,0,17109
2/25/2017,14,9135,236,4315,3433,38,0,17157
2/25/2017,15,9134,236,4185,3335,49,0,16939
2/25/2017,16,9133,237,4184,3236,39,0,16829
2/25/2017,17,9122,236,4675,3233,18,0,17284
2/25/2017,18,9119,279,4830,3284,2,0,17514
2/25/2017,19,9124,294,5105,3305,0,0,17828
2/25/2017,20,9120,294,5238,3207,0,0,17859
2/25/2017,21,9117,294,4808,3220,0,0,17439
2/25/2017,22,9116,291,4637,3069,0,0,17113
2/25/2017,23,9123,296,4026,2872,0,0,16317
2/25/2017,24,9336,296,3575,2541,0,0,15748
2/26/2017,1,9346,295,3518,2147,0,0,15306
2/26/2017,2,9352,296,3485,2021,0,0,15154
2/26/2017,3,9350,266,3427,1855,0,0,14898
2/26/2017,4,9351,265,3424,1679,0,0,14719
2/26/2017,5,9437,264,3454,1250,0,0,14405
2/26/2017,6,9515,264,3471,1726,0,0,14976
2/26/2017,7,9714,267,3742,1898,1,0,15622
2/26/2017,8,9825,266,4164,1759,19,0,16033
2/26/2017,9,9820,266,4560,1468,46,0,16160
2/26/2017,10,9820,263,4534,1286,143,0,16046
2/26/2017,11,9824,264,4664,1110,187,0,16049
2/26/2017,12,9826,275,4326,1581,193,0,16201
2/26/2017,13,9823,295,4315,1715,209,0,16357
2/26/2017,14,9833,295,3958,1859,199,0,16144
2/26/2017,15,9836,294,3865,1874,188,0,16057
2/26/2017,16,9841,295,3949,2089,130,0,16304
2/26/2017,17,9894,294,4285,2373,83,0,16929
2/26/2017,18,9948,295,4512,2851,14,0,17620
2/26/2017,19,9979,293,5077,3153,0,0,18502
2/26/2017,20,9985,293,5124,3382,0,0,18784
2/26/2017,21,10030,293,4797,3398,0,0,18518
2/26/2017,22,9690,293,4318,3363,0,0,17664
2/26/2017,23,9217,293,3839,3542,0,0,16891
2/26/2017,24,9219,294,3571,3227,0,0,16311
2/27/2017,1,9214,294,3627,2496,0,7,15638
2/27/2017,2,9218,295,3627,2098,0,9,15247
2/27/2017,3,9221,297,3607,1800,0,9,14934
2/27/2017,4,9227,271,3622,1917,0,11,15048
2/27/2017,5,9231,287,3665,2276,0,14,15473
2/27/2017,6,9228,303,3799,2377,0,17,15724
2/27/2017,7,9226,359,4366,2355,2,24,16332
2/27/2017,8,9226,574,5260,2137,14,36,17247
2/27/2017,9,9221,589,5145,1483,99,38,16575
2/27/2017,10,9224,651,5191,1122,159,40,16387
2/27/2017,11,9218,809,5373,984,210,42,16636
2/27/2017,12,9227,848,5274,901,203,41,16494
2/27/2017,13,9220,971,5161,858,186,37,16433
2/27/2017,14,9228,1242,4756,857,167,28,16278
2/27/2017,15,9229,1581,4518,575,150,27,16080
2/27/2017,16,9221,1732,4523,679,173,27,16355
2/27/2017,17,9219,1735,4910,616,78,26,16584
2/27/2017,18,9218,1738,5315,716,21,27,17035
2/27/2017,19,9218,1786,5762,673,0,26,17465
2/27/2017,20,9222,1808,5678,700,0,26,17434
2/27/2017,21,9218,1591,5541,881,0,26,17257
2/27/2017,22,9217,754,5385,1120,0,26,16502
2/27/2017,23,9210,448,5159,1256,0,27,16100
2/27/2017,24,9206,291,4793,1103,0,18,15411
2/28/2017,1,9211,290,4026,1278,0,15,14820
2/28/2017,2,9219,292,3970,1214,0,15,14710
2/28/2017,3,9217,295,4056,1049,0,14,14631
2/28/2017,4,9221,294,3902,965,0,14,14396
2/28/2017,5,9217,294,4047,870,0,15,14443
2/28/2017,6,9204,294,4183,1181,1,18,14881
2/28/2017,7,9204,291,4345,1706,1,23,15570
2/28/2017,8,9218,295,4468,1787,16,28,15812
2/28/2017,9,9222,294,4567,1982,60,28,16153
2/28/2017,10,9221,294,4888,2296,97,27,16823
2/28/2017,11,9172,294,4948,2409,127,27,16977
2/28/2017,12,9231,294,4787,2472,116,27,16927
2/28/2017,13,9245,294,5103,2511,119,27,17299
2/28/2017,14,9248,378,4993,2593,91,29,17332
2/28/2017,15,9244,569,4537,2727,45,26,17148
2/28/2017,16,9238,724,4859,2599,29,27,17476
2/28/2017,17,9236,736,5202,2652,13,40,17879
2/28/2017,18,9238,738,5377,2674,1,47,18075
2/28/2017,19,9234,736,5687,2536,0,45,18238
2/28/2017,20,9236,736,5947,2531,0,49,18499
2/28/2017,21,9232,736,5432,2718,0,48,18166
2/28/2017,22,9233,419,4685,2708,0,42,17087
2/28/2017,23,9237,323,4070,2608,0,39,16277
2/28/2017,24,9221,322,3951,2211,0,28,15733
3/1/2017,1,9221,322,3526,1938,0,26,15033
3/1/2017,2,9247,325,3527,1636,0,24,14759
3/1/2017,3,9251,323,3460,1090,0,29,14153
3/1/2017,4,9255,323,3555,1156,0,25,14314
3/1/2017,5,9257,323,3497,1210,0,27,14314
3/1/2017,6,9259,323,3472,1904,0,29,14987
3/1/2017,7,9259,336,4027,2220,2,30,15874
3/1/2017,8,9258,368,4128,2735,2,36,16527
3/1/2017,9,9264,411,4166,2893,15,31,16780
3/1/2017,10,9260,512,4717,2610,38,30,17167
3/1/2017,11,9253,507,4978,2239,79,27,17083
3/1/2017,12,9255,508,4653,2221,39,27,16703
3/1/2017,13,9256,508,4556,2292,61,27,16700
3/1/2017,14,9268,508,4594,2356,104,27,16857
3/1/2017,15,9271,509,4581,2487,55,27,16930
3/1/2017,16,9268,347,4715,2515,28,27,16900
3/1/2017,17,9273,323,5065,2461,19,27,17168
3/1/2017,18,9316,325,5439,2448,4,27,17559
3/1/2017,19,9499,346,5563,2386,0,27,17821
3/1/2017,20,9511,339,5472,2407,0,27,17756
3/1/2017,21,9484,330,5162,2555,0,27,17558
3/1/2017,22,9431,356,5044,2620,0,26,17477
3/1/2017,23,9496,325,4459,2630,0,27,16937
3/1/2017,24,9656,323,3650,2522,0,18,16169
3/2/2017,1,9658,323,3342,2397,0,15,15735
3/2/2017,2,9788,325,3311,1571,0,14,15009
3/2/2017,3,9846,324,3309,1393,0,14,14886
3/2/2017,4,9837,323,3315,1624,0,14,15113
3/2/2017,5,9861,323,3378,1711,0,15,15288
3/2/2017,6,9851,328,3673,1995,0,18,15865
3/2/2017,7,9865,330,4599,2222,3,24,17043
3/2/2017,8,9872,351,5136,2329,14,27,17729
3/2/2017,9,9869,409,5200,2377,57,27,17939
3/2/2017,10,9872,497,4853,2248,92,27,17589
3/2/2017,11,9869,492,4475,1955,148,27,16966
3/2/2017,12,9902,535,4364,1580,212,27,16620
3/2/2017,13,9963,698,4379,1661,212,29,16942
3/2/2017,14,9913,765,4315,1647,216,47,16903
3/2/2017,15,9915,888,4420,1812,175,89,17299
3/2/2017,16,9964,1187,4595,1656,158,92,17652
3/2/2017,17,9964,1366,4764,1399,76,87,17656
3/2/2017,18,9963,1509,5081,1338,26,89,18006
3/2/2017,19,9969,1526,5734,1347,0,116,18692
3/2/2017,20,9975,1520,6131,1120,0,99,18845
3/2/2017,21,9968,1706,6136,1045,0,79,18934
3/2/2017,22,9967,1040,6032,893,0,82,18014
3/2/2017,23,10036,595,5253,801,0,38,16723
3/2/2017,24,10034,301,4922,886,0,22,16165
3/3/2017,1,10049,301,4016,1040,0,17,15423
3/3/2017,2,10045,303,3771,984,0,16,15119
3/3/2017,3,10043,302,3714,1055,0,15,15129
3/3/2017,4,10056,300,3874,729,0,15,14974
3/3/2017,5,10047,304,3930,737,0,17,15035
3/3/2017,6,10048,365,4246,1138,0,35,15832
3/3/2017,7,10055,410,4573,1518,5,69,16630
3/3/2017,8,10045,448,4820,2267,29,83,17692
3/3/2017,9,10046,460,4713,2350,102,85,17756
3/3/2017,10,10045,432,4632,2460,139,86,17794
3/3/2017,11,10048,445,4712,2635,142,61,18043
3/3/2017,12,10044,588,4564,2101,221,27,17545
3/3/2017,13,10047,735,4452,1597,220,36,17087
3/3/2017,14,9910,811,4406,2317,172,35,17651
3/3/2017,15,9878,977,4519,2310,159,27,17870
3/3/2017,16,10034,1292,4712,2107,97,27,18269
3/3/2017,17,10048,1632,4594,1396,48,27,17745
3/3/2017,18,10053,1717,5472,1318,12,27,18599
3/3/2017,19,10050,1835,6176,1045,0,27,19133
3/3/2017,20,10052,2063,6277,838,0,27,19257
3/3/2017,21,10051,1580,6278,956,0,28,18893
3/3/2017,22,10059,856,5924,1310,0,27,18176
3/3/2017,23,10054,565,5275,1495,0,27,17416
3/3/2017,24,10061,399,4478,1580,0,16,16534
3/4/2017,1,10054,302,3823,1444,0,31,15654
3/4/2017,2,10061,299,3634,1282,0,32,15308
3/4/2017,3,10061,298,3565,1539,0,28,15491
3/4/2017,4,10058,299,3569,1264,0,27,15217
3/4/2017,5,10052,303,3644,1028,0,29,15056
3/4/2017,6,10055,300,3989,889,2,26,15261
3/4/2017,7,10058,302,4392,1041,5,25,15823
3/4/2017,8,10061,302,5005,965,26,22,16381
3/4/2017,9,10061,299,5075,816,83,29,16363
3/4/2017,10,10060,297,4903,614,171,20,16065
3/4/2017,11,10059,337,5088,412,225,13,16134
3/4/2017,12,10062,442,5542,291,214,19,16570
3/4/2017,13,10065,544,4969,203,224,21,16026
3/4/2017,14,10063,763,4899,149,241,15,16130
3/4/2017,15,10056,1092,4763,204,228,10,16353
3/4/2017,16,10056,1596,4474,166,221,20,16533
3/4/2017,17,10056,1826,4675,212,114,1,16884
3/4/2017,18,10061,1880,5702,205,34,1,17883
3/4/2017,19,10056,2004,6227,293,0,1,18581
3/4/2017,20,9840,2197,6196,433,0,1,18667
3/4/2017,21,9573,2154,6068,474,0,4,18273
3/4/2017,22,9572,1592,5429,744,0,20,17357
3/4/2017,23,9574,990,5165,832,0,15,16576
3/4/2017,24,9571,480,4365,1036,0,2,15454
3/5/2017,1,9566,302,4334,1304,0,1,15507
3/5/2017,2,9573,303,4038,1528,0,1,15443
3/5/2017,3,9574,303,3636,1689,0,1,15203
3/5/2017,4,9573,304,3497,1718,0,1,15093
3/5/2017,5,9570,303,3735,1549,0,1,15158
3/5/2017,6,9575,302,3964,1816,0,1,15658
3/5/2017,7,9570,303,4030,2229,6,1,16139
3/5/2017,8,9570,303,4289,1970,53,1,16186
3/5/2017,9,9570,303,4681,1351,156,1,16062
3/5/2017,10,9562,302,4746,1885,231,1,16727
3/5/2017,11,9562,303,4590,2755,258,1,17469
3/5/2017,12,9565,379,4522,2635,270,1,17372
3/5/2017,13,9558,394,4315,2726,269,1,17263
3/5/2017,14,9562,554,4194,2564,257,1,17132
3/5/2017,15,9564,667,4192,2430,232,1,17086
3/5/2017,16,9538,954,4198,2177,203,1,17071
3/5/2017,17,9559,1035,4627,2398,111,1,17731
3/5/2017,18,9574,1043,4905,2639,19,5,18185
3/5/2017,19,9569,1042,5352,2807,0,3,18773
3/5/2017,20,9571,1041,5424,2820,0,1,18857
3/5/2017,21,9568,896,5236,2663,0,1,18364
3/5/2017,22,9575,744,4861,2740,1,1,17922
3/5/2017,23,9565,582,4392,2561,0,0,17100
3/5/2017,24,9557,330,4109,2353,0,0,16349
3/6/2017,1,9551,300,3828,2586,0,1,16266
3/6/2017,2,9560,301,3614,2506,0,1,15982
3/6/2017,3,9564,305,3553,2237,0,9,15668
3/6/2017,4,9567,368,3585,2218,0,13,15751
3/6/2017,5,9571,445,3724,2137,0,13,15890
3/6/2017,6,9572,578,4142,1808,0,16,16116
3/6/2017,7,9574,739,4761,1867,1,24,16966
3/6/2017,8,9580,900,5496,2068,7,36,18087
3/6/2017,9,9580,1131,5539,2246,42,42,18580
3/6/2017,10,9580,1067,5266,2245,84,43,18285
3/6/2017,11,9583,992,5072,2356,117,44,18164
3/6/2017,12,9581,920,5024,2477,77,44,18123
3/6/2017,13,9579,597,5102,2610,72,45,18005
3/6/2017,14,9586,500,5124,2733,85,43,18071
3/6/2017,15,9586,501,4869,2866,84,37,17943
3/6/2017,16,9545,501,4918,3078,51,32,18125
3/6/2017,17,9589,498,4934,3237,30,33,18321
3/6/2017,18,9589,498,5062,3261,5,32,18447
3/6/2017,19,9589,501,5312,3501,0,32,18935
3/6/2017,20,9591,503,5336,3545,0,32,19007
3/6/2017,21,9582,336,5279,3547,0,32,18776
3/6/2017,22,9580,318,4756,3297,0,32,17983
3/6/2017,23,9577,318,4206,3399,0,32,17532
3/6/2017,24,9582,318,3926,2745,0,25,16596
3/7/2017,1,9579,320,3767,2281,0,19,15966
3/7/2017,2,9584,322,3700,1735,0,14,15355
3/7/2017,3,9584,321,3525,1566,0,13,15009
3/7/2017,4,9586,321,3418,1472,0,13,14810
3/7/2017,5,9577,321,3603,1356,0,16,14873
3/7/2017,6,9574,321,3686,1809,0,23,15413
3/7/2017,7,9575,318,4282,2616,2,30,16823
3/7/2017,8,9568,331,4786,3310,2,31,18028
3/7/2017,9,9573,394,4588,3557,7,31,18150
3/7/2017,10,9579,537,4389,3182,16,31,17734
3/7/2017,11,9580,540,4486,3160,32,30,17828
3/7/2017,12,9594,599,4534,3145,52,31,17955
3/7/2017,13,9598,615,4382,3113,44,31,17783
3/7/2017,14,9603,540,4018,3344,41,31,17577
3/7/2017,15,9600,541,4081,3022,39,31,17314
3/7/2017,16,9592,358,4237,3283,46,24,17540
3/7/2017,17,9588,321,4536,3259,18,0,17722
3/7/2017,18,9596,330,4750,3165,4,0,17845
3/7/2017,19,9597,359,4829,3091,0,6,17882
3/7/2017,20,9598,360,5069,2870,0,0,17897
3/7/2017,21,9587,360,4787,2743,0,11,17488
3/7/2017,22,9590,362,4459,2604,0,26,17041
3/7/2017,23,9585,324,4345,2229,0,27,16510
3/7/2017,24,9588,321,4018,1738,0,20,15685
3/8/2017,1,9589,320,3582,1810,0,12,15313
3/8/2017,2,9595,321,3438,1526,0,10,14890
3/8/2017,3,9589,322,3433,1114,0,9,14467
3/8/2017,4,9582,321,3495,984,0,9,14391
3/8/2017,5,9588,322,3572,1152,0,12,14646
3/8/2017,6,9592,321,3783,1382,0,22,15100
3/8/2017,7,9590,322,4313,2672,1,29,16927
3/8/2017,8,9603,330,4608,2922,42,41,17546
3/8/2017,9,9603,369,4589,2740,117,50,17468
3/8/2017,10,9612,425,4317,2207,198,54,16813
3/8/2017,11,9619,545,4297,1880,252,53,16646
3/8/2017,12,9647,549,4296,1789,227,53,16561
3/8/2017,13,9655,714,4103,1666,231,52,16421
3/8/2017,14,9531,751,3927,2087,241,51,16588
3/8/2017,15,9575,762,4014,1767,232,52,16402
3/8/2017,16,9669,786,4228,1089,135,47,15954
3/8/2017,17,9683,830,4544,785,41,43,15926
3/8/2017,18,9728,723,4537,1198,16,43,16245
3/8/2017,19,9771,386,4686,2355,1,42,17241
3/8/2017,20,9785,366,4656,2606,0,37,17450
3/8/2017,21,9778,365,4393,2724,0,34,17294
3/8/2017,22,9772,330,4286,2894,0,28,17310
3/8/2017,23,9767,330,4094,2616,0,27,16834
3/8/2017,24,9777,331,3711,1954,0,18,15791
3/9/2017,1,9778,330,3427,1314,0,12,14861
3/9/2017,2,9775,355,3451,1271,0,14,14866
3/9/2017,3,9774,428,3407,1212,0,13,14834
3/9/2017,4,9774,475,3435,1057,0,13,14754
3/9/2017,5,9775,486,3452,1164,0,15,14892
3/9/2017,6,9787,531,3555,1446,0,16,15335
3/9/2017,7,9783,781,3978,2105,4,21,16672
3/9/2017,8,9787,1021,4532,2053,19,26,17438
3/9/2017,9,9791,1053,4806,1858,51,26,17585
3/9/2017,10,9787,1099,4930,1651,79,27,17573
3/9/2017,11,9787,1140,4804,1349,130,26,17236
3/9/2017,12,9786,1059,4671,1375,155,27,17073
3/9/2017,13,9789,1293,4474,1276,196,27,17055
3/9/2017,14,9787,1295,4600,1232,197,27,17138
3/9/2017,15,9789,1212,4780,1222,147,29,17179
3/9/2017,16,9786,1399,4771,1222,140,27,17345
3/9/2017,17,9793,1608,4867,820,62,27,17177
3/9/2017,18,9792,2072,4946,791,17,29,17647
3/9/2017,19,9792,2250,5672,748,1,35,18498
3/9/2017,20,9784,2296,5863,696,0,52,18691
3/9/2017,21,9775,2216,5770,609,0,114,18484
3/9/2017,22,9782,1417,5651,585,1,185,17621
3/9/2017,23,9787,1309,5245,588,1,199,17129
3/9/2017,24,9776,828,4595,509,0,175,15883
3/10/2017,1,9770,391,4014,1122,0,136,15433
3/10/2017,2,9768,299,3551,1357,0,161,15136
3/10/2017,3,9757,299,3434,1765,0,180,15435
3/10/2017,4,9754,348,3438,1971,0,129,15640
3/10/2017,5,9752,581,3606,1898,0,71,15908
3/10/2017,6,9760,821,3701,1920,1,84,16287
3/10/2017,7,9771,964,4473,1938,5,113,17264
3/10/2017,8,9778,1028,4867,2423,33,98,18227
3/10/2017,9,9777,1147,4944,2147,113,84,18212
3/10/2017,10,9772,1155,4888,2372,146,83,18416
3/10/2017,11,9768,1154,4596,2886,148,79,18631
3/10/2017,12,9774,1021,4580,3004,171,81,18631
3/10/2017,13,9778,632,4300,3211,197,46,18164
3/10/2017,14,9779,520,4419,3497,192,27,18434
3/10/2017,15,9778,522,4511,3578,169,27,18585
3/10/2017,16,9774,357,4729,3751,138,27,18776
3/10/2017,17,9747,438,4979,3789,60,27,19040
3/10/2017,18,9578,652,4979,3701,10,29,18949
3/10/2017,19,9572,923,5644,3507,0,28,19674
3/10/2017,20,9573,992,6049,3272,0,27,19913
3/10/2017,21,9571,993,5630,3116,0,27,19337
3/10/2017,22,9568,957,5019,3150,0,29,18723
3/10/2017,23,9563,812,4456,3109,0,31,17971
3/10/2017,24,9563,680,4210,2881,0,18,17352
3/11/2017,1,9561,344,4064,3005,0,9,16983
3/11/2017,2,9567,252,3742,2885,0,4,16450
3/11/2017,3,9565,253,3725,2443,0,1,15987
3/11/2017,4,9564,251,4053,2239,0,1,16108
3/11/2017,5,9571,247,3963,2252,0,1,16034
3/11/2017,6,9566,242,4125,2352,0,1,16286
3/11/2017,7,9566,261,4349,2309,4,1,16490
3/11/2017,8,9568,414,4859,2225,15,1,17082
3/11/2017,9,9569,260,4593,2365,40,1,16828
3/11/2017,10,9564,233,4749,2637,81,2,17266
3/11/2017,11,9567,239,4770,2796,133,1,17506
3/11/2017,12,9571,266,5212,2840,186,1,18076
3/11/2017,13,9576,263,4676,2883,202,1,17601
3/11/2017,14,9582,337,4307,2763,197,2,17188
3/11/2017,15,9576,406,4175,3023,178,2,17360
3/11/2017,16,9572,524,4500,2914,128,16,17654
3/11/2017,17,9579,789,4857,2632,70,53,17980
3/11/2017,18,9575,1125,5535,2336,20,126,18717
3/11/2017,19,9571,1474,6008,1945,1,177,19176
3/11/2017,20,9575,2085,6120,1708,0,181,19669
3/11/2017,21,9578,1619,5528,1607,0,165,18497
3/11/2017,22,9573,1442,5158,1702,0,111,17986
3/11/2017,23,9577,849,4612,1858,0,98,16994
3/11/2017,24,9576,646,4368,1968,0,98,16656
3/12/2017,1,9582,327,4012,1789,0,114,15824
3/12/2017,2,9561,239,3835,1708,0,179,15522
3/12/2017,3,9583,243,3868,1446,0,180,15320
3/12/2017,4,9578,314,4116,1171,0,181,15360
3/12/2017,5,9587,336,4345,1042,0,181,15491
3/12/2017,6,9586,372,4323,813,0,146,15240
3/12/2017,7,9586,663,4408,551,6,140,15354
3/12/2017,8,9589,709,4811,369,37,127,15642
3/12/2017,9,9586,374,5114,262,96,171,15603
3/12/2017,10,9585,301,4803,215,163,173,15240
3/12/2017,11,9588,275,4779,293,200,165,15300
3/12/2017,12,9589,343,4797,462,228,175,15594
3/12/2017,13,9601,502,4653,605,209,175,15745
3/12/2017,14,9576,651,4285,742,207,155,15616
3/12/2017,15,9591,676,4200,890,175,82,15614
3/12/2017,16,9636,820,4337,953,188,53,15987
3/12/2017,17,9654,1171,4481,795,129,52,16282
3/12/2017,18,9673,1483,5179,590,44,52,17021
3/12/2017,19,9704,1737,5643,445,2,86,17617
3/12/2017,20,9743,2003,5598,379,1,162,17886
3/12/2017,21,9778,2002,5476,392,0,154,17802
3/12/2017,22,9813,2016,5130,494,0,177,17630
3/12/2017,23,9827,1558,4576,521,0,114,16596
3/12/2017,24,9834,743,4307,446,0,59,15389
3/13/2017,1,9833,597,4314,407,0,22,15173
3/13/2017,2,9834,462,4070,556,0,12,14934
3/13/2017,3,9838,601,4088,639,0,12,15178
3/13/2017,4,9838,840,4282,635,0,12,15607
3/13/2017,5,9834,1215,4391,727,0,17,16184
3/13/2017,6,9831,1650,4959,885,1,55,17381
3/13/2017,7,9840,2019,5182,1106,7,84,18238
3/13/2017,8,9895,2611,5294,1172,26,89,19087
3/13/2017,9,9969,2623,5406,1335,58,128,19519
3/13/2017,10,9999,2220,5455,1334,89,193,19290
3/13/2017,11,10007,2132,5331,1132,119,202,18923
3/13/2017,12,10007,2116,4990,1080,123,210,18526
3/13/2017,13,10010,2103,4880,1098,109,210,18410
3/13/2017,14,10002,1906,5041,1122,101,215,18387
3/13/2017,15,9998,1730,5268,1179,81,213,18469
3/13/2017,16,9997,1761,5265,1468,56,209,18756
3/13/2017,17,9998,1915,5303,1717,40,176,19149
3/13/2017,18,9997,2014,5335,1713,16,180,19255
3/13/2017,19,9995,2448,5502,1664,1,163,19773
3/13/2017,20,9985,2415,5488,1745,0,188,19821
3/13/2017,21,9986,1936,5144,1882,0,198,19146
3/13/2017,22,9990,1431,4731,1983,0,202,18337
3/13/2017,23,10010,1096,3970,1910,0,145,17131
3/13/2017,24,10011,544,3822,1766,0,80,16223
3/14/2017,1,10041,297,3651,2142,0,31,16162
3/14/2017,2,10061,299,3485,1936,0,19,15800
3/14/2017,3,10053,301,3434,1980,0,23,15791
3/14/2017,4,10063,398,3375,2118,0,22,15976
3/14/2017,5,10059,621,3482,1954,0,29,16145
3/14/2017,6,10063,775,3982,2693,0,57,17570
3/14/2017,7,10060,948,4888,2938,5,98,18937
3/14/2017,8,10057,1096,5182,2938,14,135,19422
3/14/2017,9,10062,1181,5377,2927,41,178,19766
3/14/2017,10,10064,1081,4800,2997,64,173,19179
3/14/2017,11,10071,1079,4545,3208,76,122,19101
3/14/2017,12,10062,566,4425,3202,84,119,18458
3/14/2017,13,10055,342,4836,3312,87,137,18769
3/14/2017,14,10056,344,4909,3408,91,126,18934
3/14/2017,15,10055,368,4951,3483,90,149,19096
3/14/2017,16,10042,392,5084,3511,63,108,19200
3/14/2017,17,10032,511,5351,3486,41,98,19519
3/14/2017,18,10050,893,5241,3389,17,107,19697
3/14/2017,19,10050,942,5315,3313,1,103,19724
3/14/2017,20,10052,942,5376,3265,0,144,19779
3/14/2017,21,10056,941,5106,3208,0,115,19426
3/14/2017,22,10062,823,4436,3059,0,32,18412
3/14/2017,23,10059,740,3878,2832,0,25,17534
3/14/2017,24,10050,739,3708,2285,0,21,16803
3/15/2017,1,10057,423,3606,2411,0,20,16517
3/15/2017,2,10065,339,3455,2488,0,24,16371
3/15/2017,3,10067,339,3340,2417,0,20,16183
3/15/2017,4,10064,338,3344,2513,0,20,16279
3/15/2017,5,10076,340,3567,2298,0,47,16328
3/15/2017,6,10076,338,3807,2896,1,80,17198
3/15/2017,7,10080,339,4251,3445,6,96,18217
3/15/2017,8,10083,337,4592,3573,17,124,18726
3/15/2017,9,10078,335,4847,3556,45,138,18999
3/15/2017,10,10074,332,4658,3517,74,129,18784
3/15/2017,11,10080,333,4316,3476,91,111,18407
3/15/2017,12,10074,331,4249,3414,121,95,18284
3/15/2017,13,10077,328,4336,3399,131,41,18312
3/15/2017,14,10078,328,4249,3429,162,31,18277
3/15/2017,15,10070,353,4243,3480,171,31,18348
3/15/2017,16,10070,356,4372,3436,146,31,18411
3/15/2017,17,10069,378,4538,3261,98,31,18375
3/15/2017,18,10078,506,4579,3158,35,31,18387
3/15/2017,19,10081,517,5400,3155,1,31,19185
3/15/2017,20,10076,516,5795,3099,0,31,19517
3/15/2017,21,10076,516,5078,3143,0,31,18844
3/15/2017,22,10073,485,4676,3015,0,32,18281
3/15/2017,23,10060,484,4241,2943,0,22,17750
3/15/2017,24,10055,348,3700,2650,0,20,16773
3/16/2017,1,10064,299,3516,2569,0,20,16468
3/16/2017,2,10069,297,3363,2492,0,20,16241
3/16/2017,3,10071,298,3295,2426,0,19,16109
3/16/2017,4,10328,300,3275,2064,0,20,15987
3/16/2017,5,10344,301,3376,1839,0,22,15882
3/16/2017,6,10357,301,3940,2470,4,28,17100
3/16/2017,7,10360,298,4841,2357,8,31,17895
3/16/2017,8,10361,298,4798,2333,47,31,17868
3/16/2017,9,10363,300,4574,2069,139,31,17476
3/16/2017,10,10052,299,4601,1704,221,31,16908
3/16/2017,11,9551,300,4593,1965,259,31,16699
3/16/2017,12,9560,301,4510,1648,267,31,16317
3/16/2017,13,9565,299,4373,1792,272,31,16332
3/16/2017,14,9553,392,4292,1382,275,31,15925
3/16/2017,15,9558,516,4338,1309,273,31,16025
3/16/2017,16,9620,766,4329,1212,224,31,16182
3/16/2017,17,9937,987,4635,1308,146,31,17044
3/16/2017,18,9936,1025,5001,1331,49,31,17373
3/16/2017,19,9932,1280,5876,1035,2,36,18161
3/16/2017,20,9934,1664,6118,943,0,38,18697
3/16/2017,21,9924,1537,5805,886,0,33,18185
3/16/2017,22,9979,1395,5253,832,0,31,17490
3/16/2017,23,9987,542,4495,842,0,20,15886
3/16/2017,24,9994,355,4176,872,0,16,15413
3/17/2017,1,10003,433,4018,823,0,16,15293
3/17/2017,2,9995,511,4117,704,0,16,15343
3/17/2017,3,10043,540,3756,608,0,17,14964
3/17/2017,4,10253,731,3742,581,0,20,15327
3/17/2017,5,10295,993,3717,470,0,45,15520
3/17/2017,6,10297,1145,4585,436,4,91,16558
3/17/2017,7,10296,1345,5501,292,13,163,17610
3/17/2017,8,10294,1210,5811,215,80,132,17742
3/17/2017,9,10298,1123,5415,222,181,104,17343
3/17/2017,10,10300,1121,5129,271,257,129,17207
3/17/2017,11,10296,1110,4827,418,275,109,17035
3/17/2017,12,10307,790,4456,709,281,102,16645
3/17/2017,13,10300,390,4385,657,282,87,16101
3/17/2017,14,10310,297,4481,767,279,47,16181
3/17/2017,15,10325,296,4465,883,268,35,16272
3/17/2017,16,10328,296,4462,940,198,35,16259
3/17/2017,17,10332,297,4859,905,120,34,16547
3/17/2017,18,10351,299,4991,846,39,33,16559
3/17/2017,19,10352,350,5813,771,2,32,17320
3/17/2017,20,10349,398,5561,863,0,32,17203
3/17/2017,21,10346,301,5260,847,0,32,16786
3/17/2017,22,10357,394,4780,985,0,32,16548
3/17/2017,23,10343,300,4079,1041,0,18,15781
3/17/2017,24,10352,299,3751,940,0,1,15343
3/18/2017,1,10364,298,3401,971,0,0,15034
3/18/2017,2,10364,297,3300,938,0,0,14899
3/18/2017,3,10362,298,3204,815,0,0,14679
3/18/2017,4,10366,299,3719,856,0,0,15240
3/18/2017,5,10364,300,3531,632,0,0,14827
3/18/2017,6,10374,280,3571,544,1,0,14770
3/18/2017,7,10369,289,3834,557,10,0,15059
3/18/2017,8,10367,303,4568,512,49,1,15800
3/18/2017,9,10366,342,5027,430,84,1,16250
3/18/2017,10,10364,460,5028,456,118,1,16427
3/18/2017,11,10360,459,4999,531,145,1,16495
3/18/2017,12,10362,490,5103,484,156,1,16596
3/18/2017,13,10361,465,4511,489,140,3,15969
3/18/2017,14,10371,463,4629,466,135,2,16066
3/18/2017,15,10332,471,4771,462,107,1,16144
3/18/2017,16,10369,357,5148,358,82,13,16327
3/18/2017,17,10376,307,4993,290,48,5,16019
3/18/2017,18,10378,288,4734,307,15,2,15724
3/18/2017,19,10370,295,5100,404,1,1,16171
3/18/2017,20,10367,297,4926,425,0,1,16016
3/18/2017,21,10348,297,5055,483,0,1,16184
3/18/2017,22,10356,299,4646,417,0,1,15719
3/18/2017,23,10349,298,4328,425,1,1,15402
3/18/2017,24,10353,298,3838,376,0,1,14866
3/19/2017,1,10357,299,3732,322,0,1,14711
3/19/2017,2,10358,300,3848,334,0,1,14841
3/19/2017,3,10358,300,3935,326,0,1,14920
3/19/2017,4,10364,300,3789,410,0,1,14864
3/19/2017,5,10373,299,3563,444,0,1,14680
3/19/2017,6,10374,298,3619,457,2,1,14751
3/19/2017,7,10374,298,4036,417,8,1,15134
3/19/2017,8,10370,298,4820,319,39,1,15847
3/19/2017,9,10372,295,4778,175,132,1,15753
3/19/2017,10,10361,293,4439,87,147,2,15329
3/19/2017,11,10378,292,4159,48,215,8,15100
3/19/2017,12,10376,291,4483,51,228,2,15431
3/19/2017,13,10378,291,4210,84,223,1,15187
3/19/2017,14,10379,353,3884,98,203,1,14918
3/19/2017,15,10376,364,3932,126,191,1,14990
3/19/2017,16,10373,429,4143,146,188,1,15280
3/19/2017,17,10373,574,4644,154,116,1,15862
3/19/2017,18,10369,695,5025,153,35,1,16278
3/19/2017,19,10374,699,5227,310,0,1,16611
3/19/2017,20,10365,698,5119,610,0,1,16793
3/19/2017,21,10371,701,4846,640,0,1,16559
3/19/2017,22,10371,703,4401,906,0,1,16382
3/19/2017,23,10369,702,3967,1065,0,1,16104
3/19/2017,24,10371,409,3570,1226,0,1,15577
3/20/2017,1,10371,293,3265,1243,0,1,15173
3/20/2017,2,10359,303,3238,1227,0,1,15128
3/20/2017,3,10363,306,3327,1225,0,1,15222
3/20/2017,4,10370,406,3275,1294,0,1,15346
3/20/2017,5,10377,554,3491,828,0,1,15251
3/20/2017,6,10380,779,4169,958,0,1,16287
3/20/2017,7,10385,970,5137,1068,2,3,17565
3/20/2017,8,10383,876,5067,1185,16,5,17532
3/20/2017,9,10386,778,4993,1207,41,7,17412
3/20/2017,10,10378,1065,5222,1180,61,5,17911
3/20/2017,11,10379,1072,4953,944,86,3,17437
3/20/2017,12,10380,975,4661,860,115,2,16993
3/20/2017,13,10378,927,4507,693,128,1,16634
3/20/2017,14,10376,1047,4624,606,127,1,16781
3/20/2017,15,10380,1185,4755,389,105,1,16815
3/20/2017,16,10378,1369,4878,256,102,19,17002
3/20/2017,17,10383,1393,5319,234,75,56,17460
3/20/2017,18,10390,1224,5327,271,30,119,17361
3/20/2017,19,10388,1283,5478,204,1,140,17494
3/20/2017,20,10379,1237,5512,200,0,159,17487
3/20/2017,21,10375,1117,5117,306,0,116,17031
3/20/2017,22,10056,1127,4808,317,0,75,16383
3/20/2017,23,10056,470,4107,344,0,1,14978
3/20/2017,24,9904,301,3807,321,0,5,14338
3/21/2017,1,9907,298,3511,446,0,14,14176
3/21/2017,2,9904,320,3135,403,0,15,13777
3/21/2017,3,9903,333,3052,645,0,16,13949
3/21/2017,4,9898,444,3128,729,0,18,14217
3/21/2017,5,9902,614,3373,832,0,21,14742
3/21/2017,6,9901,763,4409,888,1,29,15991
3/21/2017,7,9906,1054,5289,734,3,31,17017
3/21/2017,8,9898,981,5278,567,37,31,16792
3/21/2017,9,9843,904,5050,380,97,31,16305
3/21/2017,10,9893,902,4900,324,154,31,16204
3/21/2017,11,9918,758,4796,487,190,31,16180
3/21/2017,12,9901,715,4677,793,200,31,16317
3/21/2017,13,9901,718,4293,655,172,31,15770
3/21/2017,14,9900,713,4149,1085,246,31,16124
3/21/2017,15,9893,711,4096,1422,237,31,16390
3/21/2017,16,9933,715,3771,2252,143,31,16845
3/21/2017,17,9923,710,4131,2422,109,31,17326
3/21/2017,18,9925,711,4431,2523,43,31,17664
3/21/2017,19,9930,711,4703,3123,2,31,18500
3/21/2017,20,9934,711,4661,3273,0,17,18596
3/21/2017,21,9926,712,4561,3454,0,26,18679
3/21/2017,22,9909,709,3766,3026,0,31,17441
3/21/2017,23,9922,391,3362,2873,0,25,16573
3/21/2017,24,9921,301,3140,2768,0,21,16151
3/22/2017,1,9925,318,2965,2775,0,16,15999
3/22/2017,2,9923,319,2902,2562,0,16,15722
3/22/2017,3,9920,337,3021,2373,0,15,15666
3/22/2017,4,9917,344,3131,2563,0,16,15971
3/22/2017,5,9923,385,3267,2321,0,19,15915
3/22/2017,6,9930,413,3908,2495,1,33,16780
3/22/2017,7,9928,501,4917,2393,10,34,17783
3/22/2017,8,9931,467,4428,2420,82,23,17351
3/22/2017,9,9792,441,3975,2000,188,0,16396
3/22/2017,10,9724,474,3778,2101,268,0,16345
3/22/2017,11,9632,549,4196,1835,279,0,16491
3/22/2017,12,9780,787,4451,1596,283,0,16897
3/22/2017,13,9782,1016,3908,951,282,0,15939
3/22/2017,14,9781,1443,3680,1132,283,0,16319
3/22/2017,15,9784,1585,3766,1020,281,0,16436
3/22/2017,16,9932,1602,3839,755,253,0,16381
3/22/2017,17,9937,1741,4132,921,168,0,16899
3/22/2017,18,9937,1817,4823,621,65,10,17273
3/22/2017,19,9940,2097,5442,398,4,51,17932
3/22/2017,20,9936,2528,5571,294,0,90,18419
3/22/2017,21,9934,2242,5475,276,0,172,18099
3/22/2017,22,9927,1522,5168,254,0,192,17063
3/22/2017,23,9942,759,4752,241,0,147,15841
3/22/2017,24,9938,686,4509,265,0,146,15544
3/23/2017,1,9943,581,3985,247,0,100,14856
3/23/2017,2,9946,646,3995,234,0,81,14902
3/23/2017,3,9941,864,3898,246,0,24,14973
3/23/2017,4,9941,1215,3930,253,0,13,15352
3/23/2017,5,9941,1506,3870,299,0,22,15638
3/23/2017,6,9943,2216,4899,319,6,32,17415
3/23/2017,7,9941,2869,5150,366,15,46,18387
3/23/2017,8,9945,2407,4984,369,91,76,17872
3/23/2017,9,9946,2143,4661,410,194,108,17462
3/23/2017,10,9948,1742,4428,521,264,85,16988
3/23/2017,11,9950,1469,4089,681,279,80,16548
3/23/2017,12,9938,1129,3880,667,281,79,15974
3/23/2017,13,9930,827,3966,942,278,122,16065
3/23/2017,14,9929,783,3977,954,269,136,16048
3/23/2017,15,9934,782,3874,1034,258,111,15993
3/23/2017,16,9936,784,4031,1220,212,125,16308
3/23/2017,17,9935,788,4688,1196,125,178,16910
3/23/2017,18,9936,789,4905,1204,41,204,17079
3/23/2017,19,9932,992,5214,1077,2,208,17425
3/23/2017,20,9922,1240,4882,1542,1,154,17741
3/23/2017,21,9922,752,4206,1370,1,97,16348
3/23/2017,22,9917,423,3709,1923,0,88,16060
3/23/2017,23,9927,334,3287,2039,0,51,15638
3/23/2017,24,9875,303,3079,1921,0,21,15199
3/24/2017,1,9929,296,2980,2123,0,18,15346
3/24/2017,2,9922,295,2835,2095,0,18,15165
3/24/2017,3,9925,294,2800,1942,0,18,14979
3/24/2017,4,9921,294,2795,2117,0,18,15145
3/24/2017,5,9920,293,3191,1763,0,21,15188
3/24/2017,6,9922,300,3939,2078,1,34,16274
3/24/2017,7,9922,494,4852,1986,1,39,17294
3/24/2017,8,9916,690,4804,2084,7,38,17539
3/24/2017,9,9910,599,4583,2090,20,36,17238
3/24/2017,10,9878,658,4911,2202,42,35,17726
3/24/2017,11,9771,390,4070,2491,87,37,16846
3/24/2017,12,9768,299,3777,2717,85,33,16679
3/24/2017,13,9902,297,4037,2686,116,31,17069
3/24/2017,14,9927,296,3775,2626,123,31,16778
3/24/2017,15,9931,293,3895,2527,106,31,16783
3/24/2017,16,9929,300,4294,2308,88,31,16950
3/24/2017,17,9923,306,4747,2131,46,31,17184
3/24/2017,18,9920,348,4468,2027,14,31,16808
3/24/2017,19,9926,438,4748,1921,1,31,17065
3/24/2017,20,9922,509,5020,1534,0,31,17016
3/24/2017,21,9918,527,5318,1185,0,33,16981
3/24/2017,22,9507,693,4724,1455,0,32,16411
3/24/2017,23,9424,474,3848,1269,0,22,15037
3/24/2017,24,9425,449,3319,796,0,17,14006
3/25/2017,1,9416,451,3274,651,0,12,13804
3/25/2017,2,9417,287,3176,699,0,0,13579
3/25/2017,3,9420,239,3095,643,0,0,13397
3/25/2017,4,9418,239,2927,759,0,0,13343
3/25/2017,5,9415,237,2947,864,0,0,13463
3/25/2017,6,9408,235,3192,839,4,0,13678
3/25/2017,7,9387,231,3692,998,7,0,14315
3/25/2017,8,9391,233,4013,1344,23,0,15004
3/25/2017,9,9408,324,4960,1382,53,3,16130
3/25/2017,10,9412,355,4852,1431,78,5,16133
3/25/2017,11,9410,243,4696,1688,92,7,16136
3/25/2017,12,9413,237,4280,1880,105,0,15915
3/25/2017,13,9409,236,4138,2022,105,0,15910
3/25/2017,14,9412,237,4174,1962,102,0,15887
3/25/2017,15,9414,238,3942,2050,88,0,15732
3/25/2017,16,9417,237,3830,2178,94,4,15760
3/25/2017,17,9422,237,3863,2300,74,0,15896
3/25/2017,18,9414,238,4132,2346,34,0,16164
3/25/2017,19,9411,236,4263,2257,2,0,16169
3/25/2017,20,9408,236,4145,2293,0,0,16082
3/25/2017,21,9403,237,4047,2566,1,0,16254
3/25/2017,22,9401,238,3578,2702,0,0,15919
3/25/2017,23,9402,239,3396,2702,0,0,15739
3/25/2017,24,9401,237,3176,2593,0,0,15407
3/26/2017,1,9398,236,3025,2112,0,0,14771
3/26/2017,2,9410,237,2919,2167,0,0,14733
3/26/2017,3,9409,239,2920,2241,0,0,14809
3/26/2017,4,9413,238,2767,2446,0,0,14864
3/26/2017,5,9421,238,2832,2189,0,0,14680
3/26/2017,6,9418,238,3072,2344,4,0,15076
3/26/2017,7,9419,239,3482,2142,9,0,15291
3/26/2017,8,9416,255,3524,2492,33,0,15720
3/26/2017,9,9413,286,4272,2452,71,10,16504
3/26/2017,10,9409,451,4680,2220,99,10,16869
3/26/2017,11,9410,701,4357,2100,123,2,16693
3/26/2017,12,9407,637,3939,1963,119,0,16065
3/26/2017,13,9405,368,3992,1861,140,0,15766
3/26/2017,14,9405,358,4293,1415,128,0,15599
3/26/2017,15,9405,464,4700,1096,116,3,15784
3/26/2017,16,9407,716,4790,866,74,9,15862
3/26/2017,17,9407,638,4489,934,37,10,15515
3/26/2017,18,9407,487,4074,1123,9,11,15111
3/26/2017,19,9407,241,4567,1346,1,0,15562
3/26/2017,20,9405,242,4260,1559,0,0,15466
3/26/2017,21,9406,241,4144,1749,0,0,15540
3/26/2017,22,9403,242,3884,1654,0,0,15183
3/26/2017,23,9410,243,3554,1523,0,1,14731
3/26/2017,24,9407,266,3006,1527,0,0,14206
3/27/2017,1,9406,287,2844,1255,0,2,13794
3/27/2017,2,9409,296,2880,1176,0,15,13776
3/27/2017,3,9411,398,2872,1200,0,17,13898
3/27/2017,4,9406,467,2840,1065,0,17,13795
3/27/2017,5,9404,547,2927,668,0,41,13587
3/27/2017,6,9400,636,3556,930,1,71,14594
3/27/2017,7,9407,889,4160,872,4,136,15468
3/27/2017,8,9407,1146,4612,716,8,197,16086
3/27/2017,9,9410,1322,4558,756,23,213,16282
3/27/2017,10,9404,1569,4567,886,52,215,16693
3/27/2017,11,9405,1719,4789,848,78,208,17047
3/27/2017,12,9403,1687,4556,1021,85,205,16957
3/27/2017,13,9404,1659,4261,1106,97,200,16727
3/27/2017,14,9396,1675,4006,804,107,201,16189
3/27/2017,15,9416,1725,4037,700,107,206,16191
3/27/2017,16,9406,1816,4202,780,87,204,16495
3/27/2017,17,9407,1830,4391,745,69,202,16644
3/27/2017,18,9412,1834,4475,588,7,172,16488
3/27/2017,19,9414,1832,4792,364,1,169,16572
3/27/2017,20,9411,1833,4807,327,0,203,16581
3/27/2017,21,9406,1331,4579,382,0,205,15903
3/27/2017,22,9403,962,3915,318,0,205,14803
3/27/2017,23,9408,459,3586,301,0,152,13906
3/27/2017,24,9414,307,3372,496,0,120,13709
3/28/2017,1,9417,301,3231,532,0,31,13512
3/28/2017,2,9413,300,3022,629,0,15,13379
3/28/2017,3,9408,299,2928,653,0,14,13302
3/28/2017,4,9416,295,2944,640,0,15,13310
3/28/2017,5,9418,307,3072,741,0,24,13562
3/28/2017,6,9439,328,3677,787,1,67,14299
3/28/2017,7,9452,334,4951,874,3,118,15732
3/28/2017,8,9496,346,4809,929,20,195,15795
3/28/2017,9,9508,371,4645,1062,33,200,15819
3/28/2017,10,9506,486,4332,1220,67,200,15811
3/28/2017,11,9507,487,4338,1469,98,201,16100
3/28/2017,12,9525,487,4343,1502,111,200,16168
3/28/2017,13,9520,487,4208,1428,124,194,15961
3/28/2017,14,9609,484,4013,1336,167,185,15794
3/28/2017,15,9779,500,4035,1461,177,184,16136
3/28/2017,16,9783,329,4342,1624,129,190,16397
3/28/2017,17,9783,391,4279,1783,84,198,16518
3/28/2017,18,9781,516,4368,1755,29,131,16580
3/28/2017,19,9781,715,4527,1614,1,80,16718
3/28/2017,20,9777,720,4981,1426,0,46,16950
3/28/2017,21,9765,733,4798,1193,0,31,16520
3/28/2017,22,9764,806,4296,1230,0,31,16127
3/28/2017,23,9757,717,3317,1020,0,21,14832
3/28/2017,24,9806,710,2980,783,0,15,14294
3/29/2017,1,9845,387,2896,786,0,16,13930
3/29/2017,2,9852,365,2948,956,0,15,14136
3/29/2017,3,9858,418,2818,976,0,17,14087
3/29/2017,4,9860,547,2810,932,0,18,14167
3/29/2017,5,9859,727,3212,758,0,20,14576
3/29/2017,6,9860,1012,4097,518,0,26,15513
3/29/2017,7,9862,1335,4681,418,15,31,16342
3/29/2017,8,9858,1003,4600,306,61,31,15859
3/29/2017,9,9859,891,4915,89,126,31,15911
3/29/2017,10,9858,1003,4819,38,184,31,15933
3/29/2017,11,9854,688,4452,80,211,31,15316
3/29/2017,12,9846,563,4428,187,216,31,15271
3/29/2017,13,9846,779,4472,334,206,32,15669
3/29/2017,14,9851,1225,4007,461,200,32,15776
3/29/2017,15,9847,1218,3885,456,210,32,15648
3/29/2017,16,9844,1247,4338,408,183,33,16053
3/29/2017,17,9842,1238,4418,472,126,32,16128
3/29/2017,18,9843,1312,4737,580,40,32,16544
3/29/2017,19,9847,1315,5028,611,4,32,16837
3/29/2017,20,9842,1195,5284,702,0,32,17055
3/29/2017,21,9840,1164,4682,1073,0,32,16791
3/29/2017,22,9838,786,3895,1211,0,32,15762
3/29/2017,23,9827,491,3216,1136,0,21,14691
3/29/2017,24,9824,393,3193,1077,0,17,14504
3/30/2017,1,9835,392,2789,1441,0,16,14473
3/30/2017,2,9833,406,2766,1368,0,15,14388
3/30/2017,3,9830,419,2757,1386,0,15,14407
3/30/2017,4,9830,422,2812,1494,0,15,14573
3/30/2017,5,9833,423,2852,1546,0,19,14673
3/30/2017,6,9839,423,3312,2016,1,28,15619
3/30/2017,7,9842,445,3868,2410,10,34,16609
3/30/2017,8,9846,458,4048,2891,59,34,17336
3/30/2017,9,9848,501,3975,2787,123,32,17266
3/30/2017,10,9849,637,4045,2835,133,32,17531
3/30/2017,11,9857,636,4159,2957,144,32,17785
3/30/2017,12,9875,634,3923,2988,129,32,17581
3/30/2017,13,9869,614,3796,3098,104,33,17514
3/30/2017,14,9861,635,3748,3023,99,33,17399
3/30/2017,15,9860,635,3785,3067,82,32,17461
3/30/2017,16,9858,634,4188,3098,68,32,17878
3/30/2017,17,9860,501,4816,2947,44,33,18201
3/30/2017,18,9862,782,4451,2852,17,33,17997
3/30/2017,19,9863,740,4318,2855,3,32,17811
3/30/2017,20,9861,544,4051,2975,0,32,17463
3/30/2017,21,9861,451,4150,2799,0,32,17293
3/30/2017,22,9863,454,3793,2839,0,32,16981
3/30/2017,23,9853,448,3224,2839,0,23,16387
3/30/2017,24,9853,419,2853,2708,0,19,15852
3/31/2017,1,9862,428,2785,2240,0,15,15330
3/31/2017,2,9866,432,2795,2190,0,14,15297
3/31/2017,3,9871,497,2795,2115,0,15,15293
3/31/2017,4,9867,567,2785,1751,0,15,14985
3/31/2017,5,9866,690,2970,1369,0,18,14913
3/31/2017,6,9874,838,3640,1562,1,29,15944
3/31/2017,7,9877,914,4738,1633,4,37,17203
3/31/2017,8,9876,1110,5050,1345,17,37,17435
3/31/2017,9,9875,1140,5128,1165,39,36,17383
3/31/2017,10,9877,1338,5083,988,53,37,17376
3/31/2017,11,9876,1321,5166,903,52,35,17353
3/31/2017,12,9873,1161,4957,791,56,33,16871
3/31/2017,13,9874,1076,4966,762,56,32,16766
3/31/2017,14,9874,1097,4652,950,52,32,16657
3/31/2017,15,9875,1203,4639,1245,50,31,17043
3/31/2017,16,9872,1285,4410,1467,47,31,17112
3/31/2017,17,9876,1428,4219,1581,36,32,17172
3/31/2017,18,9879,1381,4186,1625,18,32,17121
3/31/2017,19,9883,1373,4539,1506,2,32,17335
3/31/2017,20,9894,1363,4726,1465,0,32,17480
3/31/2017,21,9888,1023,4394,1471,0,32,16808
3/31/2017,22,9886,726,3648,1565,0,32,15857
3/31/2017,23,9888,543,3383,1398,0,24,15236
3/31/2017,24,9890,450,3195,1396,0,15,14946
4/1/2017,1,9887,420,3324,1164,0,0,14795
4/1/2017,2,9891,263,2989,1217,0,0,14360
4/1/2017,3,9886,235,2965,1045,0,0,14131
4/1/2017,4,9887,228,2981,1093,0,0,14189
4/1/2017,5,9890,228,2966,1014,0,0,14098
4/1/2017,6,9895,227,3197,847,2,0,14168
4/1/2017,7,9898,225,3609,1197,3,6,14938
4/1/2017,8,9894,225,4129,1231,17,8,15504
4/1/2017,9,9896,231,4423,1161,39,1,15751
4/1/2017,10,9889,240,4349,1059,85,1,15623
4/1/2017,11,9891,342,4270,1019,104,1,15627
4/1/2017,12,9893,436,4294,1038,136,1,15798
4/1/2017,13,9898,640,3978,1059,161,1,15737
4/1/2017,14,9900,643,3853,1008,173,1,15578
4/1/2017,15,9909,648,3838,735,167,1,15298
4/1/2017,16,9911,681,3970,549,106,1,15218
4/1/2017,17,9909,836,4460,478,87,1,15771
4/1/2017,18,9907,966,4606,404,45,1,15929
4/1/2017,19,9906,965,4618,348,4,1,15842
4/1/2017,20,9901,962,5050,351,0,1,16265
4/1/2017,21,9898,637,4865,468,0,2,15870
4/1/2017,22,9904,353,4551,615,0,2,15425
4/1/2017,23,9908,233,3757,724,0,1,14623
4/1/2017,24,9912,234,3132,741,0,1,14020
4/2/2017,1,9912,235,3072,950,0,1,14170
4/2/2017,2,9917,235,3085,903,0,1,14141
4/2/2017,3,9916,236,2971,815,0,1,13939
4/2/2017,4,9907,233,2954,611,0,1,13706
4/2/2017,5,9899,233,3025,683,0,1,13841
4/2/2017,6,9897,232,3163,608,0,1,13901
4/2/2017,7,9894,233,3892,465,12,1,14497
4/2/2017,8,9892,233,3918,410,78,1,14532
4/2/2017,9,9885,233,3943,141,165,1,14368
4/2/2017,10,9885,232,4219,93,240,1,14670
4/2/2017,11,9893,230,4243,208,267,1,14842
4/2/2017,12,9896,230,3803,361,249,1,14540
4/2/2017,13,9901,233,3799,555,232,1,14721
4/2/2017,14,9900,235,3728,663,221,1,14748
4/2/2017,15,9861,286,3962,305,185,1,14600
4/2/2017,16,9894,362,4055,255,152,4,14722
4/2/2017,17,9893,436,4118,503,135,3,15088
4/2/2017,18,9894,440,4665,463,46,1,15509
4/2/2017,19,9895,445,5016,466,4,1,15827
4/2/2017,20,9893,476,5359,578,0,1,16307
4/2/2017,21,9898,449,4603,712,0,1,15663
4/2/2017,22,9912,451,4083,789,0,1,15236
4/2/2017,23,9914,284,3743,836,0,1,14778
4/2/2017,24,9910,235,3160,786,0,1,14092
4/3/2017,1,9911,238,2883,411,0,1,13444
4/3/2017,2,9913,236,2933,567,0,1,13650
4/3/2017,3,9910,235,2940,557,0,1,13643
4/3/2017,4,9907,234,2975,695,0,1,13812
4/3/2017,5,9902,234,3146,402,0,1,13685
4/3/2017,6,9911,242,3877,459,3,1,14493
4/3/2017,7,9913,288,4418,1470,8,1,16098
4/3/2017,8,9914,293,4255,1849,46,1,16358
4/3/2017,9,9917,295,4166,1702,87,1,16168
4/3/2017,10,9907,285,4028,1644,111,1,15976
4/3/2017,11,9898,280,4016,1578,162,2,15936
4/3/2017,12,9843,293,4046,1482,196,1,15861
4/3/2017,13,9741,293,4122,1475,159,21,15811
4/3/2017,14,9736,292,4075,1606,109,22,15840
4/3/2017,15,9690,288,4099,1745,97,8,15927
4/3/2017,16,9765,290,4052,2233,62,4,16406
4/3/2017,17,9825,290,4117,2567,34,1,16834
4/3/2017,18,9827,289,4196,2516,9,1,16838
4/3/2017,19,9832,291,4443,2475,1,1,17043
4/3/2017,20,9819,290,4392,2588,0,1,17090
4/3/2017,21,9810,290,4029,2445,0,1,16575
4/3/2017,22,9800,291,4024,1628,0,1,15744
4/3/2017,23,9799,291,3492,1627,0,1,15210
4/3/2017,24,9801,291,3179,1143,0,1,14415
4/4/2017,1,9804,291,2998,873,0,1,13967
4/4/2017,2,9808,289,2796,993,0,1,13887
4/4/2017,3,9813,290,2833,921,0,1,13858
4/4/2017,4,9816,288,2766,917,0,1,13788
4/4/2017,5,9811,293,3181,1275,0,32,14592
4/4/2017,6,9812,292,3831,1859,1,32,15827
4/4/2017,7,9814,294,4408,1939,3,32,16490
4/4/2017,8,9728,303,4402,2142,17,32,16624
4/4/2017,9,9706,324,4327,2346,27,32,16762
4/4/2017,10,9800,323,4227,2470,36,32,16888
4/4/2017,11,9907,323,4244,2350,58,32,16914
4/4/2017,12,9909,323,4256,2451,112,48,17099
4/4/2017,13,9904,290,4605,2143,59,44,17045
4/4/2017,14,9901,275,4920,1886,38,33,17053
4/4/2017,15,9908,265,4325,2208,38,37,16781
4/4/2017,16,9904,264,4578,2213,43,33,17035
4/4/2017,17,9900,265,4487,2671,17,37,17377
4/4/2017,18,9904,262,4966,2455,7,41,17635
4/4/2017,19,9902,264,4480,2661,1,44,17352
4/4/2017,20,9896,271,4881,2720,0,40,17808
4/4/2017,21,9880,265,4704,2598,0,31,17478
4/4/2017,22,9896,244,4047,2241,0,31,16459
4/4/2017,23,9908,236,3627,1853,0,22,15646
4/4/2017,24,9916,234,3265,1533,0,20,14968
4/5/2017,1,9907,235,3376,1171,0,20,14709
4/5/2017,2,9903,235,3274,975,0,20,14407
4/5/2017,3,9903,236,3223,936,0,23,14321
4/5/2017,4,9903,236,3338,944,0,26,14447
4/5/2017,5,9907,238,3540,677,0,72,14434
4/5/2017,6,9907,238,4193,517,4,117,14976
4/5/2017,7,9899,295,4934,455,12,195,15790
4/5/2017,8,9903,314,4768,277,64,242,15568
4/5/2017,9,9905,331,4668,232,132,243,15511
4/5/2017,10,9857,352,4677,147,165,233,15431
4/5/2017,11,9689,369,4858,261,166,248,15591
4/5/2017,12,9717,389,4569,711,173,251,15810
4/5/2017,13,9907,388,4374,906,174,242,15991
4/5/2017,14,9917,427,4362,868,137,237,15948
4/5/2017,15,9914,407,4763,902,150,241,16377
4/5/2017,16,9914,387,4506,1245,147,220,16419
4/5/2017,17,9913,387,4778,1400,70,238,16786
4/5/2017,18,9919,388,4767,1518,28,224,16844
4/5/2017,19,9919,389,4430,1856,4,218,16816
4/5/2017,20,9912,396,4498,2193,1,228,17228
4/5/2017,21,9897,397,4178,2285,1,146,16904
4/5/2017,22,9904,369,3606,2053,1,63,15996
4/5/2017,23,9893,363,3573,1529,1,24,15383
4/5/2017,24,9893,335,3407,1350,1,20,15006
4/6/2017,1,9896,332,3292,1045,1,20,14586
4/6/2017,2,9896,321,3289,807,1,20,14334
4/6/2017,3,9894,315,3254,647,1,19,14130
4/6/2017,4,9890,315,3249,559,1,19,14033
4/6/2017,5,9880,314,3610,1057,1,21,14883
4/6/2017,6,9871,300,4079,1504,3,28,15785
4/6/2017,7,9879,324,4400,2310,5,32,16950
4/6/2017,8,9878,326,4699,2157,14,32,17106
4/6/2017,9,9874,327,5301,1846,18,42,17408
4/6/2017,10,9875,336,5612,1733,25,43,17624
4/6/2017,11,9874,341,5203,1861,53,32,17364
4/6/2017,12,9881,328,4522,1903,75,32,16741
4/6/2017,13,9880,330,4581,1963,48,32,16834
4/6/2017,14,9885,370,5095,2290,44,32,17716
4/6/2017,15,9890,385,4872,2551,33,32,17763
4/6/2017,16,9906,403,4523,2876,24,32,17764
4/6/2017,17,9912,431,4769,2974,16,32,18134
4/6/2017,18,9913,490,4928,2987,6,32,18356
4/6/2017,19,9911,722,4857,2920,1,32,18443
4/6/2017,20,9903,759,4962,2794,1,31,18450
4/6/2017,21,9889,739,4488,2758,1,32,17907
4/6/2017,22,9904,739,4004,2643,0,32,17322
4/6/2017,23,9907,732,3497,2079,0,24,16239
4/6/2017,24,9902,706,3252,1366,0,20,15246
4/7/2017,1,9896,441,3332,1080,0,19,14768
4/7/2017,2,9905,333,3389,872,0,19,14518
4/7/2017,3,9904,330,3408,985,0,19,14646
4/7/2017,4,9907,340,3436,890,0,19,14592
4/7/2017,5,9903,354,3404,1009,0,21,14691
4/7/2017,6,9904,357,3961,1535,2,28,15787
4/7/2017,7,9909,386,4296,2301,7,31,16930
4/7/2017,8,9909,391,4022,2720,26,31,17099
4/7/2017,9,9909,391,4273,2751,55,31,17410
4/7/2017,10,9905,391,4225,2763,78,32,17394
4/7/2017,11,9905,389,4365,2225,108,35,17027
4/7/2017,12,9907,389,4269,1852,143,34,16594
4/7/2017,13,9907,425,4149,1566,142,32,16221
4/7/2017,14,9906,429,4042,1521,148,32,16078
4/7/2017,15,9909,471,4083,1207,133,32,15835
4/7/2017,16,9899,505,4173,1543,154,32,16306
4/7/2017,17,9900,551,4175,2016,127,32,16801
4/7/2017,18,9901,587,4579,1753,58,32,16910
4/7/2017,19,9904,580,4872,1917,7,32,17312
4/7/2017,20,9903,515,5500,2010,0,32,17960
4/7/2017,21,9896,441,5478,1793,0,33,17641
4/7/2017,22,9898,404,5129,1736,0,39,17206
4/7/2017,23,9896,406,4347,688,0,25,15362
4/7/2017,24,9904,250,3803,834,0,9,14800
4/8/2017,1,9902,207,3820,574,0,0,14503
4/8/2017,2,9761,207,3986,441,0,0,14395
4/8/2017,3,9608,207,3938,715,0,0,14468
4/8/2017,4,9600,205,3692,823,0,0,14320
4/8/2017,5,9601,206,3779,985,0,0,14571
4/8/2017,6,9681,206,4102,1091,1,0,15081
4/8/2017,7,9909,206,4396,727,25,0,15263
4/8/2017,8,9907,204,4263,669,108,0,15151
4/8/2017,9,9909,205,4279,274,192,0,14859
4/8/2017,10,9912,227,4438,234,243,0,15054
4/8/2017,11,9912,259,4617,246,268,0,15302
4/8/2017,12,9910,258,4481,271,266,0,15186
4/8/2017,13,9908,256,4354,165,152,0,14835
4/8/2017,14,9908,255,3958,175,60,0,14356
4/8/2017,15,9744,337,3986,210,84,0,14361
4/8/2017,16,9613,407,4097,340,158,0,14615
4/8/2017,17,9702,423,4352,364,83,0,14924
4/8/2017,18,9909,429,4333,667,51,1,15390
4/8/2017,19,9903,430,4584,828,7,0,15752
4/8/2017,20,9906,432,4670,1177,1,0,16186
4/8/2017,21,9892,431,4454,1038,0,0,15815
4/8/2017,22,9888,293,4179,1167,0,0,15527
4/8/2017,23,9875,206,3848,710,0,0,14639
4/8/2017,24,9493,206,3859,492,0,0,14050
4/9/2017,1,9222,206,3840,589,0,0,13857
4/9/2017,2,9061,205,3839,548,0,0,13653
4/9/2017,3,8926,205,3829,440,0,0,13400
4/9/2017,4,8748,206,3830,647,0,0,13431
4/9/2017,5,8478,211,3821,739,1,0,13250
4/9/2017,6,8660,238,3818,917,2,0,13635
4/9/2017,7,8961,237,3869,743,12,0,13822
4/9/2017,8,9015,234,3971,697,26,0,13943
4/9/2017,9,9014,233,4151,652,67,0,14117
4/9/2017,10,9014,233,4160,580,98,0,14085
4/9/2017,11,9013,233,4147,457,125,0,13975
4/9/2017,12,9013,233,4208,421,131,0,14006
4/9/2017,13,9013,210,4186,310,83,0,13802
4/9/2017,14,8972,201,4275,315,60,0,13823
4/9/2017,15,9012,201,4255,554,96,0,14118
4/9/2017,16,9249,201,4286,715,120,0,14571
4/9/2017,17,9539,201,4371,870,105,0,15086
4/9/2017,18,9757,201,4235,1126,45,0,15364
4/9/2017,19,9899,201,4340,1245,9,0,15694
4/9/2017,20,9887,203,4265,1661,0,0,16016
4/9/2017,21,9885,203,4253,1398,0,0,15739
4/9/2017,22,9881,203,4075,1029,0,0,15188
4/9/2017,23,9812,202,4102,494,0,0,14610
4/9/2017,24,9526,203,3952,526,0,4,14211
4/10/2017,1,9297,203,3890,365,0,15,13770
4/10/2017,2,9149,203,3805,606,0,16,13779
4/10/2017,3,9001,206,3645,771,0,16,13639
4/10/2017,4,8981,233,3629,844,0,17,13704
4/10/2017,5,9061,232,3889,839,0,25,14046
4/10/2017,6,9459,231,4012,1200,1,32,14935
4/10/2017,7,9868,231,4068,1857,16,34,16074
4/10/2017,8,9882,233,4079,2084,53,38,16369
4/10/2017,9,9878,233,4183,1491,143,36,15964
4/10/2017,10,9888,233,4197,1098,193,31,15640
4/10/2017,11,9891,233,4279,1119,186,31,15739
4/10/2017,12,9892,233,4320,1151,214,31,15841
4/10/2017,13,9898,232,4275,1375,215,31,16026
4/10/2017,14,9892,233,3839,1083,152,31,15230
4/10/2017,15,9880,233,3753,1462,135,31,15494
4/10/2017,16,9869,233,3845,1826,136,31,15940
4/10/2017,17,9871,233,3935,1893,50,31,16013
4/10/2017,18,9874,233,4252,1873,22,35,16289
4/10/2017,19,9875,237,5005,1779,3,34,16933
4/10/2017,20,9877,372,5380,1879,1,32,17541
4/10/2017,21,9875,259,4904,1454,1,32,16525
4/10/2017,22,9867,205,4045,1601,1,32,15751
4/10/2017,23,9878,205,3855,773,1,26,14738
4/10/2017,24,9886,205,3881,417,1,20,14410
4/11/2017,1,9770,206,3891,365,1,17,14250
4/11/2017,2,9636,217,3970,311,1,14,14149
4/11/2017,3,9636,224,3861,236,1,13,13971
4/11/2017,4,9372,236,3943,498,1,15,14065
4/11/2017,5,9328,264,3994,435,1,20,14042
4/11/2017,6,9434,439,4153,993,1,29,15049
4/11/2017,7,9846,732,4664,712,12,32,15998
4/11/2017,8,9898,780,4878,630,40,31,16257
4/11/2017,9,9899,777,4930,608,60,31,16305
4/11/2017,10,9896,777,5010,587,70,31,16371
4/11/2017,11,9893,774,4975,621,89,31,16383
4/11/2017,12,9892,739,4553,679,103,31,15997
4/11/2017,13,9892,745,4506,821,136,30,16130
4/11/2017,14,9895,741,4518,855,147,31,16187
4/11/2017,15,9909,688,4754,511,107,32,16001
4/11/2017,16,9891,533,4930,623,83,31,16091
4/11/2017,17,9883,531,4839,1103,50,31,16437
4/11/2017,18,9886,321,4962,1060,31,32,16292
4/11/2017,19,9887,204,5209,1317,4,36,16657
4/11/2017,20,9881,204,5455,1477,0,34,17051
4/11/2017,21,9869,204,4957,1453,0,33,16516
4/11/2017,22,9875,204,4535,1180,0,32,15826
4/11/2017,23,9815,210,4463,515,0,25,15028
4/11/2017,24,9384,212,4388,491,0,17,14492
4/12/2017,1,9331,204,4142,751,0,13,14441
4/12/2017,2,9332,204,4180,550,0,13,14279
4/12/2017,3,9333,204,4133,519,0,13,14202
4/12/2017,4,9326,204,4079,494,0,15,14118
4/12/2017,5,9331,202,4198,624,0,23,14378
4/12/2017,6,9630,203,4796,731,1,29,15390
4/12/2017,7,9888,209,5431,485,6,35,16054
4/12/2017,8,9885,332,6012,575,36,39,16879
4/12/2017,9,9883,279,5780,521,84,38,16585
4/12/2017,10,9884,225,5474,669,110,34,16396
4/12/2017,11,9739,263,5384,772,143,32,16333
4/12/2017,12,9842,296,5244,1012,158,32,16584
4/12/2017,13,9894,306,5159,1116,126,32,16633
4/12/2017,14,9892,348,5020,1138,98,32,16528
4/12/2017,15,9886,443,5009,1072,91,34,16535
4/12/2017,16,9884,541,5016,902,92,35,16470
4/12/2017,17,9887,565,5137,920,72,59,16640
4/12/2017,18,9887,565,5449,547,37,62,16547
4/12/2017,19,9890,568,5523,498,7,58,16544
4/12/2017,20,9885,571,5994,534,0,57,17041
4/12/2017,21,9884,571,5861,522,0,33,16871
4/12/2017,22,9890,467,5598,466,0,32,16453
4/12/2017,23,9888,260,5069,356,0,25,15598
4/12/2017,24,9890,210,4547,498,0,19,15164
4/13/2017,1,9883,211,4144,232,0,15,14485
4/13/2017,2,9670,211,4260,209,0,15,14365
4/13/2017,3,9348,211,4226,476,0,15,14276
4/13/2017,4,9342,211,4192,492,0,16,14253
4/13/2017,5,9412,211,4368,618,3,33,14645
4/13/2017,6,9846,212,4986,393,4,73,15514
4/13/2017,7,9893,212,5288,374,32,156,15955
4/13/2017,8,9894,211,5043,131,48,183,15510
4/13/2017,9,9891,211,5121,91,73,187,15574
4/13/2017,10,9891,210,5077,158,192,219,15747
4/13/2017,11,9889,209,5138,158,185,215,15794
4/13/2017,12,9883,223,5024,189,191,208,15718
4/13/2017,13,9879,239,4755,190,203,212,15478
4/13/2017,14,9889,258,4568,204,130,210,15259
4/13/2017,15,9889,392,4639,189,117,207,15433
4/13/2017,16,9894,453,4705,381,190,204,15827
4/13/2017,17,9891,459,4820,337,123,165,15795
4/13/2017,18,9894,472,5200,244,52,141,16003
4/13/2017,19,9892,475,5347,242,6,190,16152
4/13/2017,20,9883,475,5367,267,1,204,16197
4/13/2017,21,9884,474,5188,362,1,205,16114
4/13/2017,22,9886,261,4998,378,0,180,15703
4/13/2017,23,9888,209,4534,303,0,117,15051
4/13/2017,24,9614,210,4147,339,0,20,14330
4/14/2017,1,9270,211,4140,175,0,0,13796
4/14/2017,2,8806,210,4178,255,0,0,13449
4/14/2017,3,8729,211,4205,162,0,0,13307
4/14/2017,4,8732,211,4198,336,0,0,13477
4/14/2017,5,8737,211,4185,561,0,0,13694
4/14/2017,6,8753,210,4189,869,1,0,14022
4/14/2017,7,9167,210,4268,584,16,0,14245
4/14/2017,8,9337,209,4402,215,38,0,14201
4/14/2017,9,9339,209,4442,204,114,0,14308
4/14/2017,10,9339,208,4470,234,139,0,14390
4/14/2017,11,9098,207,4409,280,191,0,14185
4/14/2017,12,9047,207,4407,301,226,0,14188
4/14/2017,13,9044,206,4341,315,205,0,14111
4/14/2017,14,8970,206,4320,245,176,0,13917
4/14/2017,15,8734,206,4418,263,126,0,13747
4/14/2017,16,8734,206,4407,258,70,0,13675
4/14/2017,17,8811,207,4591,771,154,0,14534
4/14/2017,18,9519,207,4648,631,64,0,15069
4/14/2017,19,9635,208,4409,760,9,0,15021
4/14/2017,20,9864,209,4660,758,0,0,15491
4/14/2017,21,9868,210,4690,696,0,0,15464
4/14/2017,22,9876,210,4262,548,0,0,14896
4/14/2017,23,9612,210,4234,443,0,0,14499
4/14/2017,24,9107,210,4172,619,0,0,14108
4/15/2017,1,9031,209,4099,581,0,0,13920
4/15/2017,2,8660,210,4114,257,0,0,13241
4/15/2017,3,8101,209,4189,247,0,0,12746
4/15/2017,4,7924,209,4155,619,0,0,12907
4/15/2017,5,7926,209,4210,890,0,0,13235
4/15/2017,6,8170,209,4343,1165,2,0,13889
4/15/2017,7,8430,209,4269,730,26,0,13664
4/15/2017,8,8425,208,4319,766,59,0,13777
4/15/2017,9,8572,209,4602,1333,93,0,14809
4/15/2017,10,9097,207,4484,1304,96,0,15188
4/15/2017,11,9548,206,4525,1084,83,0,15446
4/15/2017,12,9761,206,4673,833,61,0,15534
4/15/2017,13,9880,208,4547,700,40,0,15375
4/15/2017,14,9820,208,4529,273,30,2,14862
4/15/2017,15,9368,265,4597,195,86,4,14515
4/15/2017,16,8868,269,4672,616,110,1,14536
4/15/2017,17,8825,295,4659,828,92,0,14699
4/15/2017,18,9267,314,4603,758,37,0,14979
4/15/2017,19,9555,314,4368,771,5,0,15013
4/15/2017,20,9632,311,4412,431,0,0,14786
4/15/2017,21,9626,310,4434,683,0,0,15053
4/15/2017,22,9630,245,4241,621,0,0,14737
4/15/2017,23,9407,235,4178,327,0,0,14147
4/15/2017,24,8877,236,4046,315,0,0,13474
4/16/2017,1,8370,214,4072,216,0,0,12872
4/16/2017,2,7727,208,4046,611,0,0,12592
4/16/2017,3,7650,208,4033,329,0,0,12220
4/16/2017,4,7649,209,4015,337,0,1,12211
4/16/2017,5,7647,205,4032,578,0,5,12467
4/16/2017,6,7643,205,4132,486,18,0,12484
4/16/2017,7,7479,208,4247,331,30,0,12295
4/16/2017,8,7475,208,4599,1188,57,0,13527
4/16/2017,9,8077,208,4602,1242,103,0,14232
4/16/2017,10,8350,207,4475,1017,150,2,14201
4/16/2017,11,8344,207,4572,1114,162,0,14399
4/16/2017,12,8438,210,4521,1545,72,0,14786
4/16/2017,13,8797,209,4566,1218,82,0,14872
4/16/2017,14,9081,238,4528,754,98,0,14699
4/16/2017,15,9075,286,4743,415,44,0,14563
4/16/2017,16,9081,305,4586,365,56,0,14393
4/16/2017,17,9089,317,4632,244,12,0,14294
4/16/2017,18,9096,316,4673,299,10,0,14394
4/16/2017,19,9104,288,4427,728,3,0,14550
4/16/2017,20,9102,285,4393,1293,0,0,15073
4/16/2017,21,9102,285,4396,1107,0,1,14891
4/16/2017,22,9094,218,4404,871,0,0,14587
4/16/2017,23,9076,206,4155,497,0,4,13938
4/16/2017,24,8787,205,4068,390,0,15,13465
4/17/2017,1,8557,205,4086,481,0,17,13346
4/17/2017,2,8325,204,4121,393,0,17,13060
4/17/2017,3,8025,204,4091,298,0,17,12635
4/17/2017,4,7969,205,4210,614,0,17,13015
4/17/2017,5,8294,204,4236,570,0,20,13324
4/17/2017,6,8794,205,4486,524,2,27,14038
4/17/2017,7,9064,205,5014,417,24,32,14756
4/17/2017,8,9062,204,5159,310,87,32,14854
4/17/2017,9,9062,205,5173,380,133,31,14984
4/17/2017,10,9064,204,5275,413,143,31,15130
4/17/2017,11,9066,203,5444,676,187,31,15607
4/17/2017,12,9071,204,5308,569,220,31,15403
4/17/2017,13,9073,203,5309,748,224,31,15588
4/17/2017,14,9072,202,5158,379,238,30,15079
4/17/2017,15,9074,206,5106,399,222,31,15038
4/17/2017,16,9066,284,5216,453,196,31,15246
4/17/2017,17,9061,305,5446,483,137,31,15463
4/17/2017,18,9062,322,5544,394,51,31,15404
4/17/2017,19,9069,324,5877,404,11,31,15716
4/17/2017,20,9067,601,5666,487,0,31,15852
4/17/2017,21,9060,622,5424,446,0,36,15588
4/17/2017,22,9062,671,5161,345,0,46,15285
4/17/2017,23,9070,260,4829,427,0,23,14609
4/17/2017,24,9199,202,4424,541,0,19,14385
4/18/2017,1,9308,206,4390,613,0,19,14536
4/18/2017,2,9397,202,4108,529,0,19,14255
4/18/2017,3,9458,203,4062,532,0,19,14274
4/18/2017,4,9473,202,4015,727,0,19,14436
4/18/2017,5,9584,203,3993,844,0,22,14646
4/18/2017,6,9656,203,4428,937,3,28,15255
4/18/2017,7,9660,203,5023,879,39,31,15835
4/18/2017,8,9657,203,5007,458,80,31,15436
4/18/2017,9,9662,227,4740,392,118,31,15170
4/18/2017,10,9662,231,4802,445,168,31,15339
4/18/2017,11,9658,301,4543,658,239,31,15430
4/18/2017,12,9657,353,4516,400,103,31,15060
4/18/2017,13,9650,371,4411,477,263,31,15203
4/18/2017,14,9643,391,4354,430,235,31,15084
4/18/2017,15,9643,366,4410,435,147,31,15032
4/18/2017,16,9643,373,4397,677,218,31,15339
4/18/2017,17,9659,397,4534,935,141,31,15697
4/18/2017,18,9736,398,4627,817,55,31,15664
4/18/2017,19,9734,400,4514,1247,11,31,15937
4/18/2017,20,9725,334,4500,1859,0,31,16449
4/18/2017,21,9724,308,4568,1715,0,31,16346
4/18/2017,22,9732,295,4438,1576,0,31,16072
4/18/2017,23,9733,269,4357,647,0,26,15032
4/18/2017,24,9745,261,4109,438,0,21,14574
4/19/2017,1,9650,259,4056,260,0,20,14245
4/19/2017,2,9184,258,4125,285,0,20,13872
4/19/2017,3,8891,259,4214,565,0,19,13948
4/19/2017,4,8921,271,4145,726,0,18,14081
4/19/2017,5,9186,288,4162,683,0,21,14340
4/19/2017,6,9491,287,4226,1258,1,29,15292
4/19/2017,7,9701,286,4526,1647,7,31,16198
4/19/2017,8,9819,288,4513,1692,17,30,16359
4/19/2017,9,9816,287,4452,1461,38,31,16085
4/19/2017,10,9751,288,4483,1457,51,30,16060
4/19/2017,11,9634,286,4456,2010,35,30,16451
4/19/2017,12,9746,286,4507,1874,46,30,16489
4/19/2017,13,9819,288,4910,1596,66,28,16707
4/19/2017,14,9823,288,5089,1419,51,30,16700
4/19/2017,15,9822,289,4868,1459,55,30,16523
4/19/2017,16,9821,331,4966,1291,73,30,16512
4/19/2017,17,9810,333,4926,1113,56,31,16269
4/19/2017,18,9809,343,4989,447,25,31,15644
4/19/2017,19,9806,339,4944,480,5,31,15605
4/19/2017,20,9793,367,4757,584,0,31,15532
4/19/2017,21,9787,369,4893,622,0,31,15702
4/19/2017,22,9806,331,4806,386,0,31,15360
4/19/2017,23,9744,268,4223,500,0,23,14758
4/19/2017,24,9534,259,4105,578,0,19,14495
4/20/2017,1,9270,259,4052,684,0,18,14283
4/20/2017,2,9044,259,4158,596,0,17,14074
4/20/2017,3,8971,258,4159,945,0,17,14350
4/20/2017,4,8970,258,4078,1129,0,17,14452
4/20/2017,5,9201,258,4090,1058,0,22,14629
4/20/2017,6,9668,258,4067,1447,0,28,15468
4/20/2017,7,9823,260,4748,914,14,31,15790
4/20/2017,8,9818,261,4830,935,38,31,15913
4/20/2017,9,9810,281,4896,1201,57,30,16275
4/20/2017,10,9813,308,4608,1601,80,31,16441
4/20/2017,11,9810,296,4495,1974,95,31,16701
4/20/2017,12,9807,350,4409,2152,86,31,16835
4/20/2017,13,9810,352,4453,2043,84,31,16773
4/20/2017,14,9797,361,4470,2088,76,31,16823
4/20/2017,15,9794,362,4527,2006,60,32,16781
4/20/2017,16,9795,359,4836,2132,48,33,17203
4/20/2017,17,9804,360,5079,2086,33,31,17393
4/20/2017,18,9811,347,4749,1719,13,31,16670
4/20/2017,19,9815,285,4480,2058,4,31,16673
4/20/2017,20,9808,269,4668,2027,0,31,16803
4/20/2017,21,9796,272,4658,1714,0,31,16471
4/20/2017,22,9796,337,4812,1044,0,31,16020
4/20/2017,23,9801,293,4320,650,0,21,15085
4/20/2017,24,9665,239,4115,657,0,18,14694
4/21/2017,1,9548,238,4100,871,0,16,14773
4/21/2017,2,9550,239,4108,738,0,16,14651
4/21/2017,3,9550,239,4042,548,0,16,14395
4/21/2017,4,9554,238,4066,583,0,16,14457
4/21/2017,5,9587,238,4154,615,0,21,14615
4/21/2017,6,9801,256,4222,1311,0,26,15616
4/21/2017,7,9803,257,4498,1463,6,31,16058
4/21/2017,8,9807,282,4433,1442,32,31,16027
4/21/2017,9,9812,275,4553,1133,74,31,15878
4/21/2017,10,9810,266,4497,1079,140,31,15823
4/21/2017,11,9804,267,4573,1334,154,31,16163
4/21/2017,12,9800,262,4636,1340,135,31,16204
4/21/2017,13,9799,268,4636,1358,133,32,16226
4/21/2017,14,9797,263,4594,1578,80,32,16344
4/21/2017,15,9799,258,4636,1537,62,32,16324
4/21/2017,16,9807,258,4709,1321,39,32,16166
4/21/2017,17,9825,259,4708,1358,31,32,16213
4/21/2017,18,9829,259,4776,956,9,32,15861
4/21/2017,19,9826,259,4942,964,4,32,16027
4/21/2017,20,9826,259,5142,1071,0,32,16330
4/21/2017,21,9821,258,4969,1163,0,31,16242
4/21/2017,22,9820,247,5054,1004,0,31,16156
4/21/2017,23,9824,145,4201,995,0,20,15185
4/21/2017,24,9826,138,4111,641,0,14,14730
4/22/2017,1,9714,163,4105,257,0,0,14239
4/22/2017,2,9293,231,4144,620,0,0,14288
4/22/2017,3,9133,275,4106,604,0,1,14119
4/22/2017,4,8977,277,4145,655,0,0,14054
4/22/2017,5,9057,282,4124,1003,0,3,14469
4/22/2017,6,9453,301,4135,692,1,4,14586
4/22/2017,7,9824,322,4421,476,17,16,15076
4/22/2017,8,9830,326,4507,448,70,49,15230
4/22/2017,9,9825,328,4720,344,64,92,15373
4/22/2017,10,9824,329,4738,277,73,91,15332
4/22/2017,11,9827,329,4535,244,81,100,15116
4/22/2017,12,9812,328,4460,223,82,101,15006
4/22/2017,13,9594,230,4446,308,115,101,14794
4/22/2017,14,9586,164,4452,402,127,101,14832
4/22/2017,15,9585,163,4470,518,160,101,14997
4/22/2017,16,9584,162,4477,509,219,101,15052
4/22/2017,17,9571,163,4687,553,152,101,15227
4/22/2017,18,9576,163,4754,542,66,101,15202
4/22/2017,19,9575,163,4896,584,12,101,15331
4/22/2017,20,9574,163,5253,608,0,101,15699
4/22/2017,21,9568,164,5343,568,0,101,15744
4/22/2017,22,9573,165,4796,576,0,87,15197
4/22/2017,23,9572,166,4137,410,0,9,14294
4/22/2017,24,9564,168,4136,463,0,0,14331
4/23/2017,1,9278,142,4175,358,0,0,13953
4/23/2017,2,8993,137,4232,286,0,0,13648
4/23/2017,3,8971,137,4177,279,0,0,13564
4/23/2017,4,8822,137,4161,236,0,0,13356
4/23/2017,5,8694,138,4489,384,0,0,13705
4/23/2017,6,8957,137,4400,515,3,0,14012
4/23/2017,7,8993,137,4423,661,29,26,14269
4/23/2017,8,9252,137,4435,380,91,51,14346
4/23/2017,9,9265,137,4465,412,155,89,14523
4/23/2017,10,9266,137,4450,289,199,94,14435
4/23/2017,11,9271,137,4428,242,231,79,14388
4/23/2017,12,9265,137,4331,351,274,73,14431
4/23/2017,13,9265,138,4355,277,261,71,14367
4/23/2017,14,9263,140,4380,250,186,51,14270
4/23/2017,15,9264,159,4416,276,84,56,14255
4/23/2017,16,9265,225,4402,353,194,58,14497
4/23/2017,17,9270,231,4710,464,171,91,14937
4/23/2017,18,9270,243,5245,408,73,101,15340
4/23/2017,19,9267,248,5602,312,10,101,15540
4/23/2017,20,9259,250,5421,255,0,99,15284
4/23/2017,21,9279,268,5725,291,0,101,15664
4/23/2017,22,9284,213,5387,201,0,87,15172
4/23/2017,23,9277,148,4750,331,0,13,14519
4/23/2017,24,9282,140,4476,347,0,0,14245
4/24/2017,1,9285,140,4180,434,0,0,14039
4/24/2017,2,9291,138,4102,200,0,11,13742
4/24/2017,3,9285,138,4092,180,0,11,13706
4/24/2017,4,9287,138,4142,260,0,12,13839
4/24/2017,5,9284,137,4181,360,0,41,14003
4/24/2017,6,9368,181,4305,1248,3,76,15181
4/24/2017,7,9681,210,4944,1214,28,129,16206
4/24/2017,8,9863,228,4925,581,112,138,15847
4/24/2017,9,9852,256,4896,417,165,138,15724
4/24/2017,10,9854,273,4691,405,226,191,15640
4/24/2017,11,9846,275,4461,551,274,208,15615
4/24/2017,12,9849,295,4448,453,230,198,15473
4/24/2017,13,9849,367,4411,463,290,193,15573
4/24/2017,14,9840,521,4406,392,230,191,15580
4/24/2017,15,9836,641,4453,464,220,197,15811
4/24/2017,16,9840,659,4396,592,182,194,15863
4/24/2017,17,9844,659,4576,714,144,195,16132
4/24/2017,18,9862,659,4568,710,69,196,16064
4/24/2017,19,9858,659,4787,688,11,196,16199
4/24/2017,20,9860,660,4812,1002,0,195,16529
4/24/2017,21,9857,335,4811,1155,0,195,16353
4/24/2017,22,9863,214,4390,1202,0,197,15866
4/24/2017,23,9847,191,4140,977,0,169,15324
4/24/2017,24,9780,192,4131,426,0,87,14616
4/25/2017,1,9382,192,4141,378,0,29,14122
4/25/2017,2,9308,192,4069,447,0,16,14032
4/25/2017,3,9316,192,4026,468,0,15,14017
4/25/2017,4,9316,192,3987,624,0,15,14134
4/25/2017,5,9405,192,4026,1021,0,19,14663
4/25/2017,6,9868,192,4132,1176,2,24,15394
4/25/2017,7,9870,192,4357,1384,23,27,15853
4/25/2017,8,9861,192,4413,1314,78,27,15885
4/25/2017,9,9856,195,4540,1302,110,26,16029
4/25/2017,10,9858,196,4569,1176,89,27,15915
4/25/2017,11,9602,198,4643,1136,133,27,15739
4/25/2017,12,9110,210,5050,1350,170,27,15917
4/25/2017,13,8991,241,5184,1572,176,27,16191
4/25/2017,14,8994,277,4965,1548,195,27,16006
4/25/2017,15,8997,249,4871,1598,188,27,15930
4/25/2017,16,8991,254,5223,1717,147,27,16359
4/25/2017,17,8993,234,5256,1798,100,27,16408
4/25/2017,18,8995,233,5037,1517,54,27,15863
4/25/2017,19,8999,226,5036,1702,17,27,16007
4/25/2017,20,9001,242,5230,2121,0,27,16621
4/25/2017,21,8989,256,5105,2227,0,27,16604
4/25/2017,22,8989,266,4683,1681,0,27,15646
4/25/2017,23,8996,232,4449,1450,0,18,15145
4/25/2017,24,9000,230,3974,1164,0,15,14383
4/26/2017,1,8991,241,3953,699,0,14,13898
4/26/2017,2,8991,258,3935,632,0,13,13829
4/26/2017,3,8993,269,3946,650,0,14,13872
4/26/2017,4,8993,294,3939,685,0,14,13925
4/26/2017,5,8990,297,4137,977,0,18,14419
4/26/2017,6,8992,300,4627,1468,0,22,15409
4/26/2017,7,8995,355,4872,1525,20,26,15793
4/26/2017,8,8993,359,4995,1511,75,26,15959
4/26/2017,9,8999,372,4880,1397,147,26,15821
4/26/2017,10,8995,375,4805,1323,177,26,15701
4/26/2017,11,8996,374,4790,1482,181,27,15850
4/26/2017,12,8995,373,4815,1081,234,26,15524
4/26/2017,13,8997,372,4771,1352,249,26,15767
4/26/2017,14,8997,297,4860,1478,235,26,15893
4/26/2017,15,8995,304,4857,1421,233,26,15836
4/26/2017,16,8992,293,4992,1603,222,26,16128
4/26/2017,17,8988,294,5119,1662,148,26,16237
4/26/2017,18,8988,295,5144,1483,65,26,16001
4/26/2017,19,8993,292,5172,1798,12,27,16294
4/26/2017,20,8990,291,5277,2128,0,27,16713
4/26/2017,21,8984,325,5162,2198,0,27,16696
4/26/2017,22,8984,293,4609,1564,0,27,15477
4/26/2017,23,8980,268,4409,1291,0,22,14970
4/26/2017,24,8976,262,4350,595,0,16,14199
4/27/2017,1,8978,262,4289,661,0,13,14203
4/27/2017,2,8985,262,4303,449,0,12,14011
4/27/2017,3,8989,261,4179,420,0,12,13861
4/27/2017,4,8994,261,4304,290,0,14,13863
4/27/2017,5,8993,261,4322,297,0,18,13891
4/27/2017,6,8995,260,4433,1133,1,22,14844
4/27/2017,7,8997,260,4582,1376,27,26,15268
4/27/2017,8,8993,286,4578,1364,107,27,15355
4/27/2017,9,8993,398,4583,1226,191,27,15418
4/27/2017,10,8993,343,4586,1167,263,27,15379
4/27/2017,11,8992,255,4560,1650,260,28,15745
4/27/2017,12,8993,261,4607,2062,267,27,16217
4/27/2017,13,8988,266,4669,2144,282,27,16376
4/27/2017,14,8990,294,4716,2281,282,26,16589
4/27/2017,15,8985,300,4744,2349,234,27,16639
4/27/2017,16,8988,367,4614,2660,166,27,16822
4/27/2017,17,8988,435,4746,2520,87,27,16803
4/27/2017,18,8985,472,4797,2533,24,27,16838
4/27/2017,19,8981,478,5188,2513,6,27,17193
4/27/2017,20,8978,479,5321,2394,0,27,17199
4/27/2017,21,8972,442,5152,2344,0,27,16937
4/27/2017,22,8976,439,4537,1967,0,27,15946
4/27/2017,23,8977,440,4358,980,0,19,14774
4/27/2017,24,8975,279,4213,497,0,16,13980
4/28/2017,1,8969,233,4167,465,0,15,13849
4/28/2017,2,8754,233,4146,495,0,15,13643
4/28/2017,3,8733,233,4191,425,0,13,13595
4/28/2017,4,8729,234,4145,622,0,13,13743
4/28/2017,5,8729,234,4371,681,0,19,14034
4/28/2017,6,8803,234,4642,870,4,23,14576
4/28/2017,7,8986,235,5135,1034,41,26,15457
4/28/2017,8,8980,250,5671,1013,108,26,16048
4/28/2017,9,8981,268,5443,1174,182,26,16074
4/28/2017,10,8944,244,4901,1397,233,27,15746
4/28/2017,11,8982,238,4640,1008,270,26,15164
4/28/2017,12,8973,238,4550,653,217,26,14657
4/28/2017,13,8978,210,4357,1301,282,27,15155
4/28/2017,14,8974,219,4501,1338,274,26,15332
4/28/2017,15,8976,230,4585,1350,247,26,15414
4/28/2017,16,8987,230,4711,1313,200,26,15467
4/28/2017,17,9117,237,4824,1202,93,17,15490
4/28/2017,18,9152,237,5017,1071,45,31,15553
4/28/2017,19,9162,222,5040,1496,11,26,15957
4/28/2017,20,9164,223,5012,1650,0,26,16075
4/28/2017,21,9158,224,4912,1393,0,26,15713
4/28/2017,22,9164,224,4629,1532,0,26,15575
4/28/2017,23,9170,224,4282,970,0,18,14664
4/28/2017,24,9170,224,4194,591,0,11,14190
4/29/2017,1,8977,223,4221,319,0,0,13740
4/29/2017,2,8551,223,4283,403,0,0,13460
4/29/2017,3,8317,223,4058,811,0,0,13409
4/29/2017,4,8309,223,4190,580,0,0,13302
4/29/2017,5,8270,224,4286,724,0,0,13504
4/29/2017,6,8338,224,4278,871,4,0,13715
4/29/2017,7,8596,224,4342,1150,28,1,14341
4/29/2017,8,9005,231,4448,1269,61,0,15014
4/29/2017,9,9471,238,4599,762,90,0,15160
4/29/2017,10,9663,239,4503,602,113,0,15120
4/29/2017,11,9641,232,4534,497,123,4,15031
4/29/2017,12,9654,226,4495,330,75,2,14782
4/29/2017,13,9655,224,4493,271,64,0,14707
4/29/2017,14,9572,223,4481,250,69,0,14595
4/29/2017,15,9403,223,4583,442,74,4,14729
4/29/2017,16,9500,234,4593,436,71,4,14838
4/29/2017,17,9692,238,4616,438,67,11,15062
4/29/2017,18,9807,223,4533,374,27,27,14991
4/29/2017,19,9808,223,4524,602,11,32,15200
4/29/2017,20,9812,198,4955,626,0,8,15599
4/29/2017,21,9829,195,5021,726,0,7,15778
4/29/2017,22,9832,195,4510,731,0,10,15278
4/29/2017,23,9817,195,4080,771,0,21,14884
4/29/2017,24,9504,196,3983,328,0,32,14043
4/30/2017,1,8858,196,4086,413,0,1,13554
4/30/2017,2,8079,197,4107,408,0,0,12791
4/30/2017,3,7600,220,4238,792,0,0,12850
4/30/2017,4,7574,196,4120,1176,0,0,13066
4/30/2017,5,7809,195,4190,1035,1,0,13230
4/30/2017,6,8013,144,4181,1220,2,0,13560
4/30/2017,7,8306,139,4303,1306,11,0,14065
4/30/2017,8,8697,139,4498,1575,29,0,14938
4/30/2017,9,9324,139,4607,1650,55,1,15776
4/30/2017,10,9357,139,4524,1610,85,0,15715
4/30/2017,11,9350,139,4473,1615,107,0,15684
4/30/2017,12,9339,139,4521,1512,129,1,15641
4/30/2017,13,9344,139,4492,1539,150,0,15664
4/30/2017,14,9341,139,4552,1362,174,0,15568
4/30/2017,15,9345,139,4554,1306,171,0,15515
4/30/2017,16,9350,139,4758,1822,123,0,16192
4/30/2017,17,9351,139,4814,2252,58,0,16614
4/30/2017,18,9355,139,4768,2221,28,0,16511
4/30/2017,19,9356,192,5094,1659,9,0,16310
4/30/2017,20,9357,196,5340,1577,0,0,16470
4/30/2017,21,9356,195,4730,1699,0,0,15980
4/30/2017,22,9364,196,4753,1311,0,0,15624
4/30/2017,23,9360,196,4077,997,0,0,14630
4/30/2017,24,9362,196,4027,301,0,3,13889
5/1/2017,1,9366,195,4038,330,0,12,13941
5/1/2017,2,9373,197,3969,463,0,12,14014
5/1/2017,3,9370,196,4038,434,0,12,14050
5/1/2017,4,9369,197,4043,474,0,12,14095
5/1/2017,5,9363,217,4059,321,1,17,13978
5/1/2017,6,9356,226,4250,1097,1,23,14953
5/1/2017,7,9356,226,4341,1631,16,26,15596
5/1/2017,8,9356,226,4570,2039,32,27,16250
5/1/2017,9,9363,226,4680,2192,40,27,16528
5/1/2017,10,9369,226,4856,2237,41,27,16756
5/1/2017,11,9370,323,5460,2104,56,27,17340
5/1/2017,12,9376,339,5521,1834,72,27,17169
5/1/2017,13,9370,747,5262,1464,83,26,16952
5/1/2017,14,9374,747,5323,1295,56,26,16821
5/1/2017,15,9370,353,4884,1164,37,26,15834
5/1/2017,16,9374,228,4977,1633,32,26,16270
5/1/2017,17,9376,228,4744,2265,35,26,16674
5/1/2017,18,9376,228,4842,1809,31,27,16313
5/1/2017,19,9377,228,4791,1844,13,27,16280
5/1/2017,20,9361,229,4758,2113,0,27,16488
5/1/2017,21,9359,229,4693,2161,0,27,16469
5/1/2017,22,9363,229,4436,1840,0,27,15895
5/1/2017,23,9368,229,4296,723,0,15,14631
5/1/2017,24,9026,229,4178,686,0,12,14131
5/2/2017,1,8442,202,4163,469,0,11,13287
5/2/2017,2,8210,199,4198,498,0,11,13116
5/2/2017,3,8217,199,4065,511,0,12,13004
5/2/2017,4,8221,199,4071,517,0,13,13021
5/2/2017,5,8240,200,4138,1013,0,14,13605
5/2/2017,6,8916,210,4261,1222,2,20,14631
5/2/2017,7,9366,229,4356,1155,18,26,15150
5/2/2017,8,9374,229,4766,891,26,27,15313
5/2/2017,9,9372,227,4730,1027,53,27,15436
5/2/2017,10,9383,226,4735,1209,97,27,15677
5/2/2017,11,9375,226,4721,1362,110,27,15821
5/2/2017,12,9364,226,4664,1269,138,27,15688
5/2/2017,13,9369,224,4703,1341,166,28,15831
5/2/2017,14,9367,224,4578,1458,116,24,15767
5/2/2017,15,9368,224,4642,1504,110,6,15854
5/2/2017,16,9367,224,4629,1861,80,29,16190
5/2/2017,17,9361,224,4646,2131,48,28,16438
5/2/2017,18,9359,224,4492,2041,27,27,16170
5/2/2017,19,9358,224,4451,2409,8,27,16477
5/2/2017,20,9356,224,4472,2600,0,27,16679
5/2/2017,21,9343,196,4372,2405,0,27,16343
5/2/2017,22,9350,194,4333,1857,0,27,15761
5/2/2017,23,9355,194,4070,1189,0,16,14824
5/2/2017,24,9353,194,4058,710,0,14,14329
5/3/2017,1,9166,193,4050,483,0,14,13906
5/3/2017,2,8796,193,4066,453,0,14,13522
5/3/2017,3,8519,194,4165,757,0,14,13649
5/3/2017,4,8521,194,4204,814,0,14,13747
5/3/2017,5,8807,195,4150,1107,1,15,14275
5/3/2017,6,9317,196,4666,996,6,23,15204
5/3/2017,7,9369,208,5161,892,45,36,15711
5/3/2017,8,9368,219,4848,699,134,36,15304
5/3/2017,9,9368,242,4765,320,221,27,14943
5/3/2017,10,9367,272,4676,284,290,27,14916
5/3/2017,11,9373,355,4734,431,307,27,15227
5/3/2017,12,9362,366,4783,260,283,27,15081
5/3/2017,13,9134,365,4925,311,273,27,15035
5/3/2017,14,8895,328,4931,213,264,28,14659
5/3/2017,15,8813,387,4820,292,312,28,14652
5/3/2017,16,8818,434,5067,266,281,27,14893
5/3/2017,17,8997,432,5181,328,195,27,15160
5/3/2017,18,9369,434,5111,270,85,27,15296
5/3/2017,19,9372,435,5123,402,19,27,15378
5/3/2017,20,9363,436,5303,310,1,27,15440
5/3/2017,21,9360,434,5683,279,0,27,15783
5/3/2017,22,9363,292,5503,303,0,27,15488
5/3/2017,23,9366,194,5019,213,0,18,14810
5/3/2017,24,9375,194,4679,178,0,15,14441
5/4/2017,1,9368,194,4338,247,0,13,14160
5/4/2017,2,9369,194,4103,210,0,12,13888
5/4/2017,3,9179,194,4027,532,0,12,13944
5/4/2017,4,9120,194,4059,620,0,13,14006
5/4/2017,5,9327,194,4210,717,0,17,14465
5/4/2017,6,9384,196,4640,679,6,24,14929
5/4/2017,7,9383,218,5133,919,32,27,15712
5/4/2017,8,9384,194,5234,902,69,27,15810
5/4/2017,9,9384,194,5145,822,106,27,15678
5/4/2017,10,9417,221,5006,593,122,27,15386
5/4/2017,11,9471,223,5099,795,110,27,15725
5/4/2017,12,9479,222,5215,913,109,27,15965
5/4/2017,13,9479,264,5356,929,94,27,16149
5/4/2017,14,9541,311,4988,1067,69,27,16003
5/4/2017,15,9592,260,4955,1188,49,27,16071
5/4/2017,16,9634,251,4880,1398,32,27,16222
5/4/2017,17,9635,266,4745,1576,17,27,16266
5/4/2017,18,9629,268,4653,1625,10,27,16212
5/4/2017,19,9631,269,4756,1770,3,27,16456
5/4/2017,20,9629,271,5117,1849,0,27,16893
5/4/2017,21,9625,271,5062,1852,0,27,16837
5/4/2017,22,9629,243,4348,1654,0,27,15901
5/4/2017,23,9612,250,4101,1089,0,19,15071
5/4/2017,24,9709,245,4087,520,0,14,14575
5/5/2017,1,9743,240,4080,395,0,13,14471
5/5/2017,2,9560,240,4056,324,0,13,14193
5/5/2017,3,9544,240,4049,263,0,13,14109
5/5/2017,4,9550,238,4035,346,0,14,14183
5/5/2017,5,9684,237,4148,578,0,17,14664
5/5/2017,6,9803,238,4155,1168,1,23,15388
5/5/2017,7,9795,239,4494,1402,3,25,15958
5/5/2017,8,9789,265,4727,1435,15,25,16256
5/5/2017,9,9800,267,4702,1483,34,25,16311
5/5/2017,10,9798,267,4711,1577,61,25,16439
5/5/2017,11,9790,267,4831,2033,72,25,17018
5/5/2017,12,9787,238,4700,2026,69,26,16846
5/5/2017,13,9779,236,4567,2198,93,26,16899
5/5/2017,14,9775,237,4471,2099,78,26,16686
5/5/2017,15,9765,237,4547,1912,58,26,16545
5/5/2017,16,9784,237,4510,2089,55,26,16701
5/5/2017,17,9803,236,4526,1963,39,26,16593
5/5/2017,18,9856,236,4685,1147,20,27,15971
5/5/2017,19,9861,235,4727,1216,6,27,16072
5/5/2017,20,9851,238,4812,1409,1,27,16338
5/5/2017,21,9851,236,4717,1204,0,27,16035
5/5/2017,22,9876,237,4348,1199,0,27,15687
5/5/2017,23,9875,185,4251,696,0,20,15027
5/5/2017,24,9692,183,4152,654,0,8,14689
5/6/2017,1,9389,184,4035,512,0,0,14120
5/6/2017,2,9053,181,4089,467,0,0,13790
5/6/2017,3,9039,180,4025,348,0,0,13592
5/6/2017,4,8823,182,4081,491,0,0,13577
5/6/2017,5,8732,182,4151,725,0,0,13790
5/6/2017,6,8739,210,4137,1184,2,0,14272
5/6/2017,7,8906,214,4509,1366,11,0,15006
5/6/2017,8,8776,389,4986,1259,47,0,15457
5/6/2017,9,8989,290,4809,1690,88,0,15866
5/6/2017,10,8988,253,4779,1544,96,0,15660
5/6/2017,11,8989,265,4786,1634,105,0,15779
5/6/2017,12,8985,257,4817,1521,116,0,15696
5/6/2017,13,8980,264,4850,1339,127,0,15560
5/6/2017,14,8986,257,4848,1207,124,0,15422
5/6/2017,15,8985,285,4769,1178,114,0,15331
5/6/2017,16,8983,304,4828,1265,95,0,15475
5/6/2017,17,8984,308,4775,1619,70,1,15757
5/6/2017,18,8985,311,4946,1494,41,0,15777
5/6/2017,19,8985,293,4917,1576,11,0,15782
5/6/2017,20,8984,274,4936,1799,1,0,15994
5/6/2017,21,8981,259,4774,1876,0,0,15890
5/6/2017,22,8982,286,4389,1486,0,0,15143
5/6/2017,23,8986,295,4140,1126,0,0,14547
5/6/2017,24,8987,295,4051,769,0,0,14102
5/7/2017,1,8989,255,4041,841,0,0,14126
5/7/2017,2,8986,252,3983,730,0,0,13951
5/7/2017,3,8983,252,4055,532,0,0,13822
5/7/2017,4,8976,252,4059,540,0,0,13827
5/7/2017,5,8828,260,3867,792,0,0,13747
5/7/2017,6,8727,282,4215,726,3,0,13953
5/7/2017,7,8732,282,4525,669,28,0,14236
5/7/2017,8,8814,237,4524,514,38,0,14127
5/7/2017,9,8970,283,4564,264,40,0,14121
5/7/2017,10,8966,283,4656,245,40,0,14190
5/7/2017,11,8754,283,4619,449,77,0,14182
5/7/2017,12,8673,283,4546,775,240,0,14517
5/7/2017,13,8674,282,4523,674,205,0,14358
5/7/2017,14,8646,283,4412,755,173,0,14269
5/7/2017,15,8681,281,4390,788,163,0,14303
5/7/2017,16,8681,252,4418,837,155,0,14343
5/7/2017,17,8904,250,4530,1074,130,0,14888
5/7/2017,18,8979,250,4510,1383,63,0,15185
5/7/2017,19,8981,252,4731,1450,18,0,15432
5/7/2017,20,8979,280,5351,1215,1,0,15826
5/7/2017,21,8975,445,5489,1234,0,0,16143
5/7/2017,22,8975,267,4855,1176,0,0,15273
5/7/2017,23,8977,252,4141,1195,0,0,14565
5/7/2017,24,8995,252,4006,739,0,0,13992
5/8/2017,1,8914,253,3982,540,0,1,13690
5/8/2017,2,8735,253,3986,710,0,5,13689
5/8/2017,3,8736,262,4052,554,0,9,13613
5/8/2017,4,8737,262,4072,588,0,19,13678
5/8/2017,5,8788,310,4055,1157,0,34,14344
5/8/2017,6,8987,336,4453,987,6,67,14836
5/8/2017,7,8989,430,5190,749,35,100,15493
5/8/2017,8,8991,481,5391,569,95,77,15604
5/8/2017,9,8987,624,5106,400,157,82,15356
5/8/2017,10,8989,754,4802,242,96,80,14963
5/8/2017,11,8981,754,4873,263,71,32,14974
5/8/2017,12,8985,755,4742,433,148,27,15090
5/8/2017,13,8981,755,4693,353,121,27,14930
5/8/2017,14,8988,753,4453,573,186,27,14980
5/8/2017,15,8988,752,4549,366,93,27,14775
5/8/2017,16,8985,566,4565,923,199,45,15283
5/8/2017,17,8919,518,4803,805,143,76,15264
5/8/2017,18,8487,518,4880,650,69,80,14684
5/8/2017,19,8485,523,5367,486,17,93,14971
5/8/2017,20,8481,529,5779,345,0,96,15230
5/8/2017,21,8479,696,5826,289,0,87,15377
5/8/2017,22,8476,625,5373,251,0,41,14766
5/8/2017,23,8483,328,5000,364,0,19,14194
5/8/2017,24,8485,308,4901,392,0,14,14100
5/9/2017,1,8488,320,4617,397,0,11,13833
5/9/2017,2,8482,334,4523,311,0,10,13660
5/9/2017,3,8485,338,4529,242,0,10,13604
5/9/2017,4,8489,343,4619,208,0,12,13671
5/9/2017,5,8486,455,4579,152,0,54,13726
5/9/2017,6,8495,614,4906,144,3,84,14246
5/9/2017,7,8495,814,5739,141,33,84,15306
5/9/2017,8,8492,841,5587,37,112,78,15147
5/9/2017,9,8491,948,5574,72,187,82,15354
5/9/2017,10,8482,949,5614,87,248,109,15489
5/9/2017,11,8487,1015,5484,98,247,84,15415
5/9/2017,12,8488,1091,4956,92,225,103,14955
5/9/2017,13,8639,1129,4928,99,239,101,15135
5/9/2017,14,8715,1167,4915,164,225,103,15289
5/9/2017,15,8678,1240,5064,104,204,120,15410
5/9/2017,16,8675,1209,5235,82,169,146,15516
5/9/2017,17,8673,1340,5401,48,87,131,15680
5/9/2017,18,8670,1364,5425,42,38,133,15672
5/9/2017,19,8672,1309,5296,73,14,148,15512
5/9/2017,20,8668,1125,5602,139,1,165,15700
5/9/2017,21,8770,1141,5596,175,0,184,15866
5/9/2017,22,9084,880,4912,141,0,165,15182
5/9/2017,23,9146,485,4567,252,0,138,14588
5/9/2017,24,9155,315,4273,443,0,76,14262
5/10/2017,1,9156,289,3948,468,0,62,13923
5/10/2017,2,8963,287,3923,399,0,57,13629
5/10/2017,3,8908,288,3939,501,0,57,13693
5/10/2017,4,8911,296,3944,592,0,60,13803
5/10/2017,5,8928,302,4028,948,1,69,14276
5/10/2017,6,9149,416,4328,780,9,74,14756
5/10/2017,7,9158,679,4683,762,53,96,15431
5/10/2017,8,9156,903,4716,589,123,86,15573
5/10/2017,9,9269,1004,4670,377,171,86,15577
5/10/2017,10,9315,1278,4743,243,70,91,15740
5/10/2017,11,9318,1291,4496,364,265,99,15833
5/10/2017,12,9321,1327,4455,230,160,101,15594
5/10/2017,13,9321,1381,4469,220,82,98,15571
5/10/2017,14,9319,1300,4582,161,19,86,15467
5/10/2017,15,9309,1179,4751,182,59,95,15575
5/10/2017,16,9302,1148,4695,342,228,148,15863
5/10/2017,17,9303,1148,4802,391,166,191,16001
5/10/2017,18,9306,1150,4804,247,35,184,15726
5/10/2017,19,9318,1151,4806,570,20,186,16051
5/10/2017,20,9319,706,5351,652,1,196,16225
5/10/2017,21,9309,529,5582,723,0,179,16322
5/10/2017,22,9352,325,4888,793,0,131,15489
5/10/2017,23,9344,362,4275,842,0,76,14899
5/10/2017,24,9332,453,3940,528,0,32,14285
5/11/2017,1,9122,539,3915,559,0,17,14152
5/11/2017,2,9101,558,3909,580,0,15,14163
5/11/2017,3,9102,572,3913,592,0,15,14194
5/11/2017,4,9112,575,3913,333,0,16,13949
5/11/2017,5,9110,705,3934,536,0,18,14303
5/11/2017,6,9316,875,4241,839,5,25,15301
5/11/2017,7,9371,996,4575,685,30,63,15720
5/11/2017,8,9370,1000,4496,609,83,89,15647
5/11/2017,9,9326,1009,4519,454,133,94,15535
5/11/2017,10,9206,1053,4601,400,117,87,15464
5/11/2017,11,9208,1053,4682,615,160,107,15825
5/11/2017,12,9206,1054,4754,562,195,95,15866
5/11/2017,13,9200,1046,4724,516,266,87,15839
5/11/2017,14,9197,1038,4708,529,287,117,15876
5/11/2017,15,9272,1033,4643,423,243,141,15755
5/11/2017,16,9360,1025,4969,260,100,141,15855
5/11/2017,17,9356,986,5099,229,75,140,15885
5/11/2017,18,9357,991,5086,468,75,94,16071
5/11/2017,19,9361,954,5175,595,21,106,16212
5/11/2017,20,9394,925,5231,607,2,173,16332
5/11/2017,21,9420,902,5201,765,0,188,16476
5/11/2017,22,9448,898,4873,780,0,156,16155
5/11/2017,23,9442,434,4452,717,0,78,15123
5/11/2017,24,9447,254,4109,655,0,22,14487
5/12/2017,1,9456,255,4018,300,0,15,14044
5/12/2017,2,9368,255,4014,396,0,15,14048
5/12/2017,3,9411,255,3983,417,0,15,14081
5/12/2017,4,9414,255,4035,531,0,15,14250
5/12/2017,5,9417,255,4111,495,1,19,14298
5/12/2017,6,9611,254,4466,582,6,43,14962
5/12/2017,7,9654,254,4832,515,48,93,15396
5/12/2017,8,9658,254,4832,154,126,118,15142
5/12/2017,9,9686,261,4724,137,203,108,15119
5/12/2017,10,9777,276,4979,100,236,109,15477
5/12/2017,11,9779,257,5005,213,269,117,15640
5/12/2017,12,9963,254,4997,278,249,122,15863
5/12/2017,13,10022,254,4667,467,248,111,15769
5/12/2017,14,9906,254,4711,269,231,90,15461
5/12/2017,15,9991,254,4723,267,196,81,15512
5/12/2017,16,10200,254,4716,507,116,82,15875
5/12/2017,17,10221,253,4986,464,69,82,16075
5/12/2017,18,10219,254,4851,233,31,80,15668
5/12/2017,19,10230,254,4872,318,9,81,15764
5/12/2017,20,10226,254,5150,261,0,111,16002
5/12/2017,21,10223,257,5102,206,0,132,15920
5/12/2017,22,9661,405,4997,167,0,120,15350
5/12/2017,23,9475,219,4589,96,0,101,14480
5/12/2017,24,9441,196,4071,58,0,92,13858
5/13/2017,1,9135,180,4205,97,0,34,13651
5/13/2017,2,8980,197,4174,60,0,0,13411
5/13/2017,3,8974,217,4133,88,0,0,13412
5/13/2017,4,8973,225,4041,104,0,3,13346
5/13/2017,5,8971,229,4166,72,0,3,13441
5/13/2017,6,8980,230,4370,75,2,8,13665
5/13/2017,7,9265,229,4633,103,21,37,14288
5/13/2017,8,9502,229,4894,37,72,72,14806
5/13/2017,9,9496,229,4878,33,137,70,14843
5/13/2017,10,9481,228,5155,52,187,64,15167
5/13/2017,11,9487,246,5049,81,180,73,15116
5/13/2017,12,9489,253,4949,188,185,68,15132
5/13/2017,13,9504,254,4794,331,164,55,15102
5/13/2017,14,9524,255,4471,417,151,51,14869
5/13/2017,15,9482,255,4461,431,177,50,14856
5/13/2017,16,9510,255,4490,503,154,48,14960
5/13/2017,17,9517,257,4970,422,86,48,15300
5/13/2017,18,9521,283,5109,434,41,48,15436
5/13/2017,19,9524,259,5162,430,17,48,15440
5/13/2017,20,9529,256,5391,403,1,52,15632
5/13/2017,21,9524,259,5458,432,0,52,15725
5/13/2017,22,9516,255,5059,586,0,51,15467
5/13/2017,23,9519,256,4208,384,0,15,14382
5/13/2017,24,9244,255,4109,381,0,0,13989
5/14/2017,1,8754,229,4156,394,0,0,13533
5/14/2017,2,8676,227,4051,319,0,0,13273
5/14/2017,3,8620,227,4045,182,0,0,13074
5/14/2017,4,8394,225,4104,290,0,0,13013
5/14/2017,5,8392,228,4166,468,1,0,13255
5/14/2017,6,8392,228,4156,514,3,0,13293
5/14/2017,7,8549,228,4517,496,31,0,13821
5/14/2017,8,8835,228,4759,588,72,2,14484
5/14/2017,9,9217,228,4581,691,122,32,14871
5/14/2017,10,9246,228,4440,727,155,55,14851
5/14/2017,11,9246,228,4504,799,147,107,15031
5/14/2017,12,9239,228,4481,739,102,100,14889
5/14/2017,13,9235,229,4479,613,53,118,14727
5/14/2017,14,9231,297,4572,324,11,127,14562
5/14/2017,15,9229,313,4641,352,9,120,14664
5/14/2017,16,9227,384,4647,501,44,138,14941
5/14/2017,17,9227,551,4656,631,60,157,15282
5/14/2017,18,9237,675,4736,581,31,165,15425
5/14/2017,19,9241,679,4686,694,10,164,15474
5/14/2017,20,9237,677,4749,1101,0,165,15929
5/14/2017,21,9243,680,4979,1072,0,166,16140
5/14/2017,22,9245,661,4410,883,0,136,15335
5/14/2017,23,9249,643,4184,707,0,56,14839
5/14/2017,24,9036,315,4175,575,0,12,14113
5/15/2017,1,8733,229,4124,527,0,12,13625
5/15/2017,2,8825,229,4132,287,0,17,13490
5/15/2017,3,8607,230,4078,290,0,15,13220
5/15/2017,4,8552,229,4199,409,0,17,13406
5/15/2017,5,8622,228,4338,734,0,20,13942
5/15/2017,6,9094,229,4573,566,6,25,14493
5/15/2017,7,9568,230,4790,465,44,30,15127
5/15/2017,8,9709,229,5106,320,135,47,15546
5/15/2017,9,9710,229,4956,302,200,86,15483
5/15/2017,10,9705,246,4863,268,220,130,15432
5/15/2017,11,9718,284,4629,443,317,98,15489
5/15/2017,12,9720,282,4578,276,294,89,15239
5/15/2017,13,9732,280,4604,333,270,89,15308
5/15/2017,14,9746,278,4455,303,280,89,15151
5/15/2017,15,9762,278,4483,363,266,88,15240
5/15/2017,16,9748,277,4873,264,204,88,15454
5/15/2017,17,9738,277,4967,389,178,88,15637
5/15/2017,18,9745,277,5007,349,90,89,15557
5/15/2017,19,9747,279,5307,255,17,90,15695
5/15/2017,20,9748,280,5513,232,1,99,15873
5/15/2017,21,9748,299,5794,181,0,88,16110
5/15/2017,22,9744,297,5336,195,0,87,15659
5/15/2017,23,9756,284,4463,185,0,44,14732
5/15/2017,24,9617,286,4168,156,0,17,14244
5/16/2017,1,9326,284,4110,146,0,15,13881
5/16/2017,2,8935,285,4140,179,0,15,13554
5/16/2017,3,8696,288,4152,260,0,16,13412
5/16/2017,4,8632,289,4189,448,0,16,13574
5/16/2017,5,8893,314,4256,418,0,21,13902
5/16/2017,6,9252,316,4368,936,6,27,14905
5/16/2017,7,9707,349,4597,516,32,31,15232
5/16/2017,8,9755,359,4607,905,66,31,15723
5/16/2017,9,9753,368,4691,836,125,31,15804
5/16/2017,10,9749,404,4780,736,179,31,15879
5/16/2017,11,9753,432,4626,904,197,36,15948
5/16/2017,12,9742,433,4635,891,207,69,15977
5/16/2017,13,9741,431,4586,921,230,138,16047
5/16/2017,14,9749,429,4533,726,252,126,15815
5/16/2017,15,9740,428,4616,504,226,83,15597
5/16/2017,16,9745,428,4973,453,149,106,15854
5/16/2017,17,9746,432,4984,578,127,97,15964
5/16/2017,18,9746,460,4963,553,55,83,15860
5/16/2017,19,9743,387,4832,976,20,95,16053
5/16/2017,20,9748,398,4972,1176,2,31,16327
5/16/2017,21,9751,393,4941,1186,0,27,16298
5/16/2017,22,9746,374,4398,1176,0,27,15721
5/16/2017,23,9262,460,4386,776,0,19,14903
5/16/2017,24,9042,372,4133,452,0,13,14012
5/17/2017,1,8772,283,4115,527,0,11,13708
5/17/2017,2,8525,283,4120,375,0,11,13314
5/17/2017,3,8234,285,4128,523,0,11,13181
5/17/2017,4,8148,285,4270,527,0,12,13242
5/17/2017,5,8156,285,4323,881,2,18,13665
5/17/2017,6,8537,285,4281,1032,5,48,14188
5/17/2017,7,9004,295,4537,812,23,80,14751
5/17/2017,8,9062,297,4745,800,68,79,15051
5/17/2017,9,9063,339,4819,741,126,106,15194
5/17/2017,10,8992,406,4714,798,173,91,15174
5/17/2017,11,8989,424,4666,1456,267,86,15888
5/17/2017,12,8987,470,4543,1529,286,87,15902
5/17/2017,13,8981,490,4483,1942,293,87,16276
5/17/2017,14,8973,535,4551,1955,286,42,16342
5/17/2017,15,8971,620,4745,1862,257,27,16482
5/17/2017,16,8968,673,4816,2248,192,27,16924
5/17/2017,17,9000,673,5048,2437,143,27,17328
5/17/2017,18,9045,675,4996,2118,71,27,16932
5/17/2017,19,9049,676,4836,2404,20,27,17012
5/17/2017,20,9043,677,4847,2431,2,27,17027
5/17/2017,21,9038,664,5049,2427,0,27,17205
5/17/2017,22,9043,457,4751,2499,0,27,16777
5/17/2017,23,9053,391,4221,1886,0,15,15566
5/17/2017,24,9058,358,4151,1346,0,13,14926
5/18/2017,1,9308,358,4066,583,0,12,14327
5/18/2017,2,9052,358,4063,364,0,13,13850
5/18/2017,3,8513,357,4095,385,0,13,13363
5/18/2017,4,8529,357,4071,709,0,13,13679
5/18/2017,5,8621,357,4130,987,0,15,14110
5/18/2017,6,8691,359,4201,1406,3,24,14684
5/18/2017,7,9463,423,4388,1752,35,36,16097
5/18/2017,8,9767,430,4499,1275,85,57,16113
5/18/2017,9,9756,428,4534,1346,170,99,16333
5/18/2017,10,9763,437,4505,1523,243,103,16574
5/18/2017,11,9762,454,4413,2075,261,99,17064
5/18/2017,12,9764,460,4416,1953,287,101,16981
5/18/2017,13,9771,479,4508,1973,280,100,17111
5/18/2017,14,9773,508,4434,2271,266,53,17305
5/18/2017,15,9778,494,4613,2214,251,51,17401
5/18/2017,16,9774,450,4746,2989,212,42,18213
5/18/2017,17,9766,512,4863,3083,152,40,18416
5/18/2017,18,9765,579,4683,3238,69,33,18367
5/18/2017,19,9767,579,4901,2988,15,31,18281
5/18/2017,20,9764,541,4769,2986,2,76,18138
5/18/2017,21,9765,526,4817,2751,0,128,17987
5/18/2017,22,9772,527,4657,2135,0,125,17216
5/18/2017,23,9775,491,4304,1350,0,139,16059
5/18/2017,24,9710,443,4081,957,0,170,15361
5/19/2017,1,9097,420,3953,427,0,180,14077
5/19/2017,2,8663,384,3943,653,0,183,13826
5/19/2017,3,8636,385,3924,457,0,187,13589
5/19/2017,4,8649,359,3957,566,0,187,13718
5/19/2017,5,8804,337,3937,1080,0,189,14347
5/19/2017,6,9109,338,4103,813,3,197,14563
5/19/2017,7,9502,390,4243,1121,25,194,15475
5/19/2017,8,9643,455,4474,471,49,146,15238
5/19/2017,9,9674,454,4471,470,105,105,15279
5/19/2017,10,9686,429,4409,500,166,96,15286
5/19/2017,11,9674,392,4309,774,237,109,15495
5/19/2017,12,9677,371,4372,465,244,127,15256
5/19/2017,13,9701,362,4333,520,196,116,15228
5/19/2017,14,9734,359,4665,324,133,112,15327
5/19/2017,15,9877,336,4697,195,66,109,15280
5/19/2017,16,9883,323,4748,252,69,119,15394
5/19/2017,17,9909,330,4739,381,105,98,15562
5/19/2017,18,9909,350,4487,472,67,91,15376
5/19/2017,19,9907,353,4469,814,20,104,15667
5/19/2017,20,9906,338,4709,769,2,138,15862
5/19/2017,21,9901,291,4681,1003,0,158,16034
5/19/2017,22,9899,289,4655,755,0,156,15754
5/19/2017,23,9835,153,4175,419,0,167,14749
5/19/2017,24,9573,144,4008,563,0,168,14456
5/20/2017,1,9071,143,3900,613,0,166,13893
5/20/2017,2,8829,144,3892,421,0,168,13454
5/20/2017,3,8741,144,3907,425,0,157,13374
5/20/2017,4,8557,145,3887,352,0,93,13034
5/20/2017,5,8256,145,3944,594,0,77,13016
5/20/2017,6,8247,145,3954,502,4,66,12918
5/20/2017,7,8250,145,4032,909,40,60,13436
5/20/2017,8,8245,145,4100,978,83,56,13607
5/20/2017,9,8244,145,4065,1150,227,47,13878
5/20/2017,10,8251,144,4194,1153,281,40,14063
5/20/2017,11,8268,144,4117,1330,331,24,14214
5/20/2017,12,8268,144,4128,1186,333,0,14059
5/20/2017,13,8269,144,4155,1055,329,0,13952
5/20/2017,14,8226,144,4208,1011,277,0,13866
5/20/2017,15,8502,144,4360,722,207,0,13935
5/20/2017,16,8622,144,4501,868,194,0,14329
5/20/2017,17,8929,144,4453,1197,162,0,14885
5/20/2017,18,9078,143,4418,1455,75,0,15169
5/20/2017,19,9374,144,4479,1315,24,0,15336
5/20/2017,20,9783,144,4366,1258,3,0,15554
5/20/2017,21,9890,144,4294,957,0,0,15285
5/20/2017,22,9891,144,4181,835,0,0,15051
5/20/2017,23,9504,144,4065,498,0,0,14211
5/20/2017,24,8966,144,3964,640,0,0,13714
5/21/2017,1,8500,144,3867,803,0,11,13325
5/21/2017,2,8219,144,3867,570,0,10,12810
5/21/2017,3,8079,142,3913,537,0,4,12675
5/21/2017,4,7934,144,3907,574,0,0,12559
5/21/2017,5,7933,144,3857,715,0,0,12649
5/21/2017,6,7935,143,3914,711,2,0,12705
5/21/2017,7,7945,145,3937,1312,16,0,13355
5/21/2017,8,8180,144,4067,1644,48,0,14083
5/21/2017,9,8524,145,4145,1826,89,0,14729
5/21/2017,10,8892,144,4300,1774,122,1,15233
5/21/2017,11,9316,145,4297,1694,103,0,15555
5/21/2017,12,9629,145,4211,1322,67,0,15374
5/21/2017,13,9853,145,4265,946,58,0,15267
5/21/2017,14,9859,144,4274,775,55,0,15107
5/21/2017,15,9859,146,4509,615,58,0,15187
5/21/2017,16,9859,147,4491,666,31,0,15194
5/21/2017,17,9856,151,4524,871,23,0,15425
5/21/2017,18,9861,144,4485,726,16,3,15235
5/21/2017,19,9853,140,4428,562,6,1,14990
5/21/2017,20,9850,140,4352,643,1,0,14986
5/21/2017,21,9843,140,4152,648,0,0,14783
5/21/2017,22,9760,141,4282,429,0,0,14612
5/21/2017,23,9102,140,4060,654,0,0,13956
5/21/2017,24,8716,140,3995,538,0,0,13389
5/22/2017,1,8403,139,3961,371,0,0,12874
5/22/2017,2,8083,138,3991,442,0,0,12654
5/22/2017,3,7901,137,3955,540,0,0,12533
5/22/2017,4,7896,137,4013,546,0,0,12592
5/22/2017,5,7892,137,4030,769,0,0,12828
5/22/2017,6,7893,133,3924,1099,0,0,13049
5/22/2017,7,8078,139,4033,1132,12,1,13395
5/22/2017,8,8369,144,4065,1473,29,0,14080
5/22/2017,9,8784,144,4038,1643,53,0,14662
5/22/2017,10,9205,145,4044,1508,69,0,14971
5/22/2017,11,9578,145,4060,1166,93,0,15042
5/22/2017,12,9828,176,4132,840,76,0,15052
5/22/2017,13,9821,168,4391,599,62,0,15041
5/22/2017,14,9822,160,4581,356,4,0,14923
5/22/2017,15,9569,176,4634,356,0,0,14735
5/22/2017,16,9319,179,4864,386,0,0,14748
5/22/2017,17,9312,179,4956,860,11,0,15318
5/22/2017,18,9303,158,4856,858,31,0,15206
5/22/2017,19,9346,143,4524,1198,21,0,15232
5/22/2017,20,9684,144,4435,1229,2,0,15494
5/22/2017,21,9795,144,4394,1063,0,0,15396
5/22/2017,22,9801,144,4319,786,0,0,15050
5/22/2017,23,9666,144,4034,646,0,0,14490
5/22/2017,24,9131,144,3907,374,0,0,13556
5/23/2017,1,8691,144,3873,677,0,0,13385
5/23/2017,2,8576,144,3879,290,0,8,12897
5/23/2017,3,8318,144,3988,371,0,18,12839
5/23/2017,4,8309,146,3994,654,0,19,13122
5/23/2017,5,8408,145,3950,1071,0,29,13603
5/23/2017,6,8619,183,4117,1045,9,36,14009
5/23/2017,7,9273,286,4328,1229,52,41,15209
5/23/2017,8,9773,293,4550,709,113,41,15479
5/23/2017,9,9805,300,4709,452,160,38,15464
5/23/2017,10,9822,300,4918,326,190,38,15594
5/23/2017,11,9821,337,5379,243,264,38,16082
5/23/2017,12,9821,375,5047,214,260,40,15757
5/23/2017,13,9817,377,5205,285,260,40,15984
5/23/2017,14,9814,393,5406,210,248,38,16109
5/23/2017,15,9813,402,5357,166,256,39,16033
5/23/2017,16,9811,437,5391,151,219,38,16047
5/23/2017,17,9813,397,5834,99,123,36,16302
5/23/2017,18,9815,405,5634,76,52,30,16012
5/23/2017,19,9813,440,5247,104,21,30,15655
5/23/2017,20,9805,441,5272,193,3,30,15744
5/23/2017,21,9808,441,5342,330,0,30,15951
5/23/2017,22,9812,439,4858,473,0,29,15611
5/23/2017,23,9520,441,4379,561,0,20,14921
5/23/2017,24,9210,438,4020,577,0,15,14260
5/24/2017,1,8848,275,4059,663,0,12,13857
5/24/2017,2,8829,227,4041,437,0,13,13547
5/24/2017,3,8735,226,4041,380,0,12,13394
5/24/2017,4,8618,227,3991,571,0,14,13421
5/24/2017,5,8845,227,4023,819,1,18,13933
5/24/2017,6,9275,253,4074,945,6,24,14577
5/24/2017,7,9938,256,4289,826,37,27,15373
5/24/2017,8,10069,256,4591,578,76,27,15597
5/24/2017,9,10066,252,4559,548,122,26,15573
5/24/2017,10,10065,239,4572,548,144,26,15594
5/24/2017,11,9941,226,4678,770,215,26,15856
5/24/2017,12,9913,229,4943,808,211,27,16131
5/24/2017,13,10054,273,4741,649,210,27,15954
5/24/2017,14,10055,278,4790,412,222,27,15784
5/24/2017,15,10055,277,4767,529,187,26,15841
5/24/2017,16,10046,294,5013,621,149,27,16150
5/24/2017,17,10045,315,5081,816,81,27,16365
5/24/2017,18,10103,319,4938,658,46,27,16091
5/24/2017,19,10222,319,4791,839,17,26,16214
5/24/2017,20,10083,319,5413,1066,2,27,16910
5/24/2017,21,10164,288,4969,1324,0,25,16770
5/24/2017,22,10338,283,4205,1048,0,26,15900
5/24/2017,23,10083,282,4090,543,0,16,15014
5/24/2017,24,9632,284,4007,415,0,14,14352
5/25/2017,1,9150,284,3816,546,0,14,13810
5/25/2017,2,8722,285,3758,701,0,14,13480
5/25/2017,3,8702,285,3755,538,0,14,13294
5/25/2017,4,8701,289,3783,564,0,14,13351
5/25/2017,5,8863,288,3840,977,0,19,13987
5/25/2017,6,9428,290,4020,766,3,22,14529
5/25/2017,7,9932,289,4431,985,17,26,15680
5/25/2017,8,10308,288,4573,859,31,26,16085
5/25/2017,9,10384,288,4605,968,51,28,16324
5/25/2017,10,10393,288,4636,1021,64,26,16428
5/25/2017,11,10392,286,4348,959,70,26,16081
5/25/2017,12,10374,286,4479,970,78,26,16213
5/25/2017,13,10342,286,4645,859,70,26,16228
5/25/2017,14,10316,285,4725,335,63,27,15751
5/25/2017,15,10288,285,4791,449,96,26,15935
5/25/2017,16,10285,285,4953,489,84,27,16123
5/25/2017,17,10288,285,5238,379,62,27,16279
5/25/2017,18,10284,285,5043,312,29,27,15980
5/25/2017,19,10292,285,5164,258,14,26,16039
5/25/2017,20,10293,285,5160,244,1,26,16009
5/25/2017,21,10288,285,5123,352,0,26,16074
5/25/2017,22,10291,286,4834,298,0,26,15735
5/25/2017,23,10273,292,4155,180,0,18,14918
5/25/2017,24,9878,286,4003,396,0,14,14577
5/26/2017,1,9378,285,3974,450,0,14,14101
5/26/2017,2,9246,285,3840,413,0,13,13797
5/26/2017,3,9233,284,3825,351,0,12,13705
5/26/2017,4,8968,283,3786,580,0,12,13629
5/26/2017,5,9093,284,4044,713,1,18,14153
5/26/2017,6,9509,285,4405,453,3,22,14677
5/26/2017,7,9902,295,4765,620,32,26,15640
5/26/2017,8,10164,283,4707,649,56,27,15886
5/26/2017,9,10425,282,4497,630,89,26,15949
5/26/2017,10,10375,281,4643,570,122,26,16017
5/26/2017,11,10255,281,5006,508,170,27,16247
5/26/2017,12,10333,279,5001,299,162,27,16101
5/26/2017,13,10352,273,5026,413,164,27,16255
5/26/2017,14,10491,271,4932,303,148,27,16172
5/26/2017,15,10539,270,5016,169,74,27,16095
5/26/2017,16,10588,274,5048,186,49,27,16172
5/26/2017,17,10594,280,5056,253,68,27,16278
5/26/2017,18,10603,281,4972,142,31,27,16056
5/26/2017,19,10604,282,5029,107,11,27,16060
5/26/2017,20,10602,282,5393,94,1,27,16399
5/26/2017,21,10598,279,5414,88,0,27,16406
5/26/2017,22,10572,278,4909,67,0,27,15853
5/26/2017,23,10249,147,4411,91,0,13,14911
5/26/2017,24,10004,136,4032,95,0,8,14275
5/27/2017,1,9498,136,3892,91,0,0,13617
5/27/2017,2,9091,137,3800,88,0,0,13116
5/27/2017,3,8691,137,3804,60,0,0,12692
5/27/2017,4,8667,137,3904,30,0,0,12738
5/27/2017,5,8736,137,3903,21,0,0,12797
5/27/2017,6,9119,137,3879,6,3,0,13144
5/27/2017,7,9187,137,4213,19,46,0,13602
5/27/2017,8,9518,139,4478,4,108,0,14247
5/27/2017,9,9726,144,4541,2,173,0,14586
5/27/2017,10,9728,199,4648,1,246,0,14822
5/27/2017,11,9725,177,4761,15,241,0,14919
5/27/2017,12,9725,193,4744,48,238,0,14948
5/27/2017,13,9717,185,4698,86,211,0,14897
5/27/2017,14,9721,167,4548,123,197,0,14756
5/27/2017,15,9716,170,4444,163,200,0,14693
5/27/2017,16,9723,164,4588,170,210,0,14855
5/27/2017,17,9945,169,4753,120,156,0,15143
5/27/2017,18,10025,204,4842,65,84,0,15220
5/27/2017,19,10031,177,4908,36,24,0,15176
5/27/2017,20,10279,147,4634,44,4,0,15108
5/27/2017,21,10308,139,4810,132,0,0,15389
5/27/2017,22,10332,139,4465,103,0,0,15039
5/27/2017,23,10197,141,4012,248,0,0,14598
5/27/2017,24,9705,143,3788,183,0,0,13819
5/28/2017,1,9246,144,3762,314,0,0,13466
5/28/2017,2,9153,143,3737,144,0,0,13177
5/28/2017,3,8938,143,3707,178,0,0,12966
5/28/2017,4,8716,143,3732,197,0,0,12788
5/28/2017,5,8716,142,3717,126,0,0,12701
5/28/2017,6,8722,142,3764,167,10,1,12806
5/28/2017,7,8721,144,3939,127,33,1,12965
5/28/2017,8,8733,144,4314,213,122,3,13529
5/28/2017,9,8911,164,4401,202,184,14,13876
5/28/2017,10,9084,152,4246,255,246,5,13988
5/28/2017,11,9204,175,4214,327,296,0,14216
5/28/2017,12,9208,180,4336,283,277,0,14284
5/28/2017,13,9207,156,4480,271,260,0,14374
5/28/2017,14,9209,140,4488,242,261,0,14340
5/28/2017,15,9172,152,4771,235,267,0,14597
5/28/2017,16,9695,213,4854,191,182,0,15135
5/28/2017,17,10342,245,4954,166,126,0,15833
5/28/2017,18,10644,242,4603,190,64,0,15743
5/28/2017,19,10639,200,4733,290,21,0,15883
5/28/2017,20,10628,158,5011,347,2,0,16146
5/28/2017,21,10629,144,4902,481,0,0,16156
5/28/2017,22,10631,144,4616,703,0,0,16094
5/28/2017,23,10567,143,3854,347,0,0,14911
5/28/2017,24,10019,143,3746,277,0,5,14190
5/29/2017,1,9492,143,3740,263,0,6,13644
5/29/2017,2,9209,144,3712,279,0,9,13353
5/29/2017,3,9212,145,3713,212,0,10,13292
5/29/2017,4,9219,145,3710,212,0,11,13297
5/29/2017,5,9296,144,3724,568,0,12,13744
5/29/2017,6,9798,170,3965,716,1,19,14669
5/29/2017,7,10261,279,4483,625,13,30,15691
5/29/2017,8,10632,282,4488,774,58,30,16264
5/29/2017,9,10637,282,4589,721,103,27,16359
5/29/2017,10,10617,284,4492,894,161,27,16475
5/29/2017,11,10631,282,4695,659,182,27,16476
5/29/2017,12,10621,284,4716,611,73,27,16332
5/29/2017,13,10627,283,4837,635,57,26,16465
5/29/2017,14,10624,279,4909,557,39,27,16435
5/29/2017,15,10629,264,4973,808,50,26,16750
5/29/2017,16,10617,279,5071,804,84,27,16882
5/29/2017,17,10628,278,5126,1061,145,27,17265
5/29/2017,18,10637,279,5099,1196,67,27,17305
5/29/2017,19,10643,288,5028,1328,26,27,17340
5/29/2017,20,10636,289,4981,1091,3,27,17027
5/29/2017,21,10631,291,4874,1179,0,27,17002
5/29/2017,22,10629,291,4271,993,0,27,16211
5/29/2017,23,10408,288,4036,631,0,18,15381
5/29/2017,24,10101,288,3883,713,0,14,14999
5/30/2017,1,9800,289,3755,296,0,13,14153
5/30/2017,2,9359,289,3750,427,0,13,13838
5/30/2017,3,9320,291,3782,311,0,13,13717
5/30/2017,4,9073,289,3891,345,0,14,13612
5/30/2017,5,9155,289,4092,478,1,19,14034
5/30/2017,6,9789,290,4272,634,7,24,15016
5/30/2017,7,10137,290,4331,879,29,27,15693
5/30/2017,8,10506,289,4256,849,84,27,16011
5/30/2017,9,10654,290,4276,573,116,27,15936
5/30/2017,10,10644,288,4280,531,143,27,15913
5/30/2017,11,10643,289,4392,761,225,27,16337
5/30/2017,12,10642,293,4444,718,230,27,16354
5/30/2017,13,10634,295,4577,558,69,27,16160
5/30/2017,14,10638,294,4593,614,143,27,16309
5/30/2017,15,10643,293,4614,647,200,27,16424
5/30/2017,16,10646,294,4635,661,192,28,16456
5/30/2017,17,10651,293,4586,674,73,29,16306
5/30/2017,18,10662,294,4944,536,15,26,16477
5/30/2017,19,10664,295,5025,576,17,27,16604
5/30/2017,20,10657,296,4941,878,4,27,16803
5/30/2017,21,10648,297,4798,988,0,27,16758
5/30/2017,22,10635,296,4415,596,0,27,15969
5/30/2017,23,10307,301,4094,447,0,17,15166
5/30/2017,24,9838,302,4049,406,0,14,14609
5/31/2017,1,9275,303,4033,245,0,13,13869
5/31/2017,2,8775,302,3972,357,0,13,13419
5/31/2017,3,8699,303,3976,361,0,13,13352
5/31/2017,4,8701,303,3900,317,0,13,13234
5/31/2017,5,8883,302,3906,802,0,17,13910
5/31/2017,6,9515,302,4072,782,5,24,14700
5/31/2017,7,10119,302,4072,781,48,26,15348
5/31/2017,8,10624,302,4192,620,91,26,15855
5/31/2017,9,10629,300,4162,524,86,26,15727
5/31/2017,10,10639,299,4173,730,195,26,16062
5/31/2017,11,10653,299,4163,1005,206,26,16352
5/31/2017,12,10651,299,4268,849,239,26,16332
5/31/2017,13,10641,299,4539,573,65,26,16143
5/31/2017,14,10633,300,4520,681,64,26,16224
5/31/2017,15,10629,300,4660,700,50,26,16365
5/31/2017,16,10628,299,4619,886,135,26,16593
5/31/2017,17,10631,298,4576,1102,136,27,16770
5/31/2017,18,10629,297,4766,859,67,27,16645
5/31/2017,19,10630,299,5065,902,16,27,16939
5/31/2017,20,10628,300,4988,731,2,27,16676
5/31/2017,21,10628,301,5096,558,0,27,16610
5/31/2017,22,10636,301,4436,639,0,27,16039
5/31/2017,23,10446,298,4106,315,0,19,15184
5/31/2017,24,9492,298,4055,300,0,13,14158
6/1/2017,1,8991,298,4108,433,0,11,13841
6/1/2017,2,8718,298,4062,544,0,11,13633
6/1/2017,3,8710,299,3922,493,0,10,13434
6/1/2017,4,8709,299,3877,656,0,11,13552
6/1/2017,5,8872,300,3972,758,1,28,13931
6/1/2017,6,9534,301,4293,732,6,44,14910
6/1/2017,7,10188,301,4450,565,34,39,15577
6/1/2017,8,10623,301,4419,140,1,45,15529
6/1/2017,9,10518,301,4588,193,53,46,15699
6/1/2017,10,10464,300,4633,218,118,49,15782
6/1/2017,11,10462,300,4633,296,111,44,15846
6/1/2017,12,10462,299,4571,377,131,39,15879
6/1/2017,13,10504,298,4385,523,237,32,15979
6/1/2017,14,10626,298,4385,442,163,32,15946
6/1/2017,15,10628,297,4353,356,117,32,15783
6/1/2017,16,10625,297,4443,458,51,31,15905
6/1/2017,17,10629,296,4833,456,37,29,16280
6/1/2017,18,10636,296,4911,470,46,30,16389
6/1/2017,19,10635,297,4911,476,24,28,16371
6/1/2017,20,10623,300,5085,398,4,28,16438
6/1/2017,21,10622,298,5105,424,0,27,16476
6/1/2017,22,10351,299,4747,462,0,27,15886
6/1/2017,23,10071,299,4244,457,0,19,15090
6/1/2017,24,9777,298,4006,378,0,13,14472
6/2/2017,1,9312,299,3967,508,0,11,14097
6/2/2017,2,9050,299,3910,495,0,11,13765
6/2/2017,3,8979,299,3974,257,0,11,13520
6/2/2017,4,8830,299,4014,302,0,11,13456
6/2/2017,5,8695,299,4233,763,0,15,14005
6/2/2017,6,9278,299,4470,684,8,22,14761
6/2/2017,7,10000,299,4705,342,45,25,15416
6/2/2017,8,10557,297,4510,155,101,25,15645
6/2/2017,9,10595,294,4317,109,2,25,15342
6/2/2017,10,10100,291,4513,252,191,26,15373
6/2/2017,11,10092,291,4579,389,250,27,15628
6/2/2017,12,10388,292,4677,344,167,26,15894
6/2/2017,13,10640,290,4642,327,97,26,16022
6/2/2017,14,10619,290,4583,341,72,25,15930
6/2/2017,15,10626,290,4623,292,36,26,15893
6/2/2017,16,10628,288,4642,226,39,26,15849
6/2/2017,17,10643,287,4711,216,18,26,15901
6/2/2017,18,10639,287,4691,207,7,26,15857
6/2/2017,19,10637,288,4931,274,8,26,16164
6/2/2017,20,10631,290,5318,209,4,26,16478
6/2/2017,21,10486,292,5307,322,0,26,16433
6/2/2017,22,10184,294,5035,338,0,26,15877
6/2/2017,23,9975,187,4572,372,0,15,15121
6/2/2017,24,9447,180,4366,338,0,7,14338
6/3/2017,1,9142,181,4163,293,0,0,13779
6/3/2017,2,8982,181,4179,282,0,0,13624
6/3/2017,3,8726,181,4448,275,0,0,13630
6/3/2017,4,8647,181,4308,302,1,0,13439
6/3/2017,5,8650,181,4074,305,1,0,13211
6/3/2017,6,8715,181,4174,311,6,0,13387
6/3/2017,7,9220,181,4202,187,29,0,13819
6/3/2017,8,9526,180,4448,106,37,0,14297
6/3/2017,9,9752,179,4546,148,119,1,14745
6/3/2017,10,9747,179,4526,165,33,1,14651
6/3/2017,11,9750,178,4503,108,0,0,14539
6/3/2017,12,9621,178,4461,106,0,0,14366
6/3/2017,13,9446,178,4502,117,0,0,14243
6/3/2017,14,9440,178,4520,136,0,0,14274
6/3/2017,15,9440,178,4659,140,6,0,14423
6/3/2017,16,9439,179,4732,231,155,0,14736
6/3/2017,17,9310,182,4868,286,133,0,14779
6/3/2017,18,9507,181,4989,294,91,0,15062
6/3/2017,19,9895,195,4947,318,27,0,15382
6/3/2017,20,10047,177,4734,371,5,0,15334
6/3/2017,21,10054,180,4582,598,0,0,15414
6/3/2017,22,9976,176,4549,606,0,0,15307
6/3/2017,23,9565,175,4169,265,0,0,14174
6/3/2017,24,8730,175,4080,596,0,0,13581
6/4/2017,1,8398,176,4017,424,0,0,13015
6/4/2017,2,8061,180,3896,507,0,0,12644
6/4/2017,3,7879,180,3859,593,0,0,12511
6/4/2017,4,7881,180,3904,692,0,0,12657
6/4/2017,5,7881,181,4042,660,0,0,12764
6/4/2017,6,7881,185,4102,808,7,0,12983
6/4/2017,7,8085,184,4333,756,20,0,13378
6/4/2017,8,8592,183,4709,616,49,0,14149
6/4/2017,9,8943,183,4707,833,74,1,14741
6/4/2017,10,9335,184,4679,904,124,0,15226
6/4/2017,11,9591,184,4601,667,180,0,15223
6/4/2017,12,9815,185,4537,423,124,0,15084
6/4/2017,13,9812,185,4602,405,161,0,15165
6/4/2017,14,9813,191,4557,643,172,0,15376
6/4/2017,15,9802,188,4641,740,167,0,15538
6/4/2017,16,9807,185,4816,745,167,0,15720
6/4/2017,17,9814,197,5224,741,88,0,16064
6/4/2017,18,9840,185,5426,750,54,0,16255
6/4/2017,19,9838,185,5706,389,20,1,16139
6/4/2017,20,9833,185,5769,250,5,7,16049
6/4/2017,21,9853,185,5722,278,0,12,16050
6/4/2017,22,9870,192,5281,312,0,0,15655
6/4/2017,23,9788,185,4334,240,0,0,14547
6/4/2017,24,9458,185,4574,220,0,0,14437
6/5/2017,1,9167,185,4161,300,0,0,13813
6/5/2017,2,9014,184,3982,311,0,1,13492
6/5/2017,3,9014,184,3896,337,0,7,13438
6/5/2017,4,9009,185,3825,535,0,12,13566
6/5/2017,5,9156,185,3942,380,0,22,13685
6/5/2017,6,9319,205,4408,572,4,29,14537
6/5/2017,7,9732,296,4884,592,22,38,15564
6/5/2017,8,9908,298,5295,534,39,41,16115
6/5/2017,9,9913,296,5182,592,77,48,16108
6/5/2017,10,9925,295,5225,583,103,46,16177
6/5/2017,11,9970,293,5112,630,97,32,16134
6/5/2017,12,9984,288,5167,873,139,27,16478
6/5/2017,13,9993,286,5023,1141,135,39,16617
6/5/2017,14,10039,287,5014,1067,117,44,16568
6/5/2017,15,10038,285,4900,1162,110,49,16544
6/5/2017,16,10069,283,4924,1151,102,41,16570
6/5/2017,17,10085,285,5163,1134,71,27,16765
6/5/2017,18,10084,286,5131,924,55,27,16507
6/5/2017,19,10083,286,5059,1114,20,26,16588
6/5/2017,20,10083,287,5057,1235,3,26,16691
6/5/2017,21,10076,287,5022,1126,0,26,16537
6/5/2017,22,10081,287,4766,846,0,26,16006
6/5/2017,23,9930,287,4263,410,0,14,14904
6/5/2017,24,9373,287,4113,766,0,14,14553
6/6/2017,1,9018,289,3931,795,0,14,14047
6/6/2017,2,8999,289,3990,363,0,14,13655
6/6/2017,3,9003,289,3890,342,0,14,13538
6/6/2017,4,9005,289,3912,425,1,14,13646
6/6/2017,5,9022,289,3928,643,1,17,13900
6/6/2017,6,9327,290,4012,783,3,22,14437
6/6/2017,7,9854,290,4267,997,27,28,15463
6/6/2017,8,10080,280,4252,670,66,27,15375
6/6/2017,9,10213,270,4324,461,65,27,15360
6/6/2017,10,10328,269,4436,911,124,27,16095
6/6/2017,11,10147,270,4512,1372,150,27,16478
6/6/2017,12,10187,279,4509,1127,146,27,16275
6/6/2017,13,10522,292,4499,1076,149,27,16565
6/6/2017,14,10614,271,4438,1034,129,27,16513
6/6/2017,15,10622,269,4422,973,123,27,16436
6/6/2017,16,10632,268,4426,1008,105,27,16466
6/6/2017,17,10649,268,4447,1248,80,27,16719
6/6/2017,18,10665,269,4463,795,47,27,16266
6/6/2017,19,10676,269,4567,782,23,26,16343
6/6/2017,20,10664,270,4589,1080,3,27,16633
6/6/2017,21,10686,272,4485,1126,0,26,16595
6/6/2017,22,10396,272,4453,871,0,27,16019
6/6/2017,23,9745,273,4254,895,0,16,15183
6/6/2017,24,9310,273,4093,786,0,15,14477
6/7/2017,1,9046,273,3988,763,0,14,14084
6/7/2017,2,9045,275,3959,573,0,15,13867
6/7/2017,3,9064,276,3935,526,0,15,13816
6/7/2017,4,9084,276,3924,536,1,14,13835
6/7/2017,5,9162,276,3968,649,1,15,14071
6/7/2017,6,9528,277,4211,500,7,23,14546
6/7/2017,7,10209,278,4564,533,46,27,15657
6/7/2017,8,10832,279,4521,155,10,27,15824
6/7/2017,9,10617,276,4445,136,28,27,15529
6/7/2017,10,10345,273,4523,305,292,27,15765
6/7/2017,11,10343,273,4601,329,329,27,15902
6/7/2017,12,10342,272,4486,350,330,27,15807
6/7/2017,13,10349,270,4595,386,328,27,15955
6/7/2017,14,10338,268,4585,441,330,26,15988
6/7/2017,15,10577,269,4506,377,322,27,16078
6/7/2017,16,10810,284,4526,406,278,26,16330
6/7/2017,17,10943,269,4615,349,199,27,16402
6/7/2017,18,10956,264,4834,386,105,27,16572
6/7/2017,19,10969,274,5098,324,24,27,16716
6/7/2017,20,10972,285,5276,204,5,27,16769
6/7/2017,21,10964,288,5148,209,0,28,16637
6/7/2017,22,10957,290,4875,190,0,27,16339
6/7/2017,23,10680,291,4217,201,0,19,15408
6/7/2017,24,10190,290,4081,233,0,15,14809
6/8/2017,1,9893,293,3909,66,0,13,14174
6/8/2017,2,9402,295,3832,87,0,13,13629
6/8/2017,3,9065,296,3928,116,0,13,13418
6/8/2017,4,8814,296,4130,127,1,14,13382
6/8/2017,5,9047,296,4445,151,1,18,13958
6/8/2017,6,9722,296,4486,141,10,26,14681
6/8/2017,7,10778,294,4440,87,46,27,15672
6/8/2017,8,11107,290,4296,36,135,27,15891
6/8/2017,9,11101,291,4205,20,137,39,15793
6/8/2017,10,11119,289,4191,21,228,40,15888
6/8/2017,11,11119,290,4210,38,174,29,15860
6/8/2017,12,11104,354,4154,50,57,27,15746
6/8/2017,13,11102,314,4313,59,219,26,16033
6/8/2017,14,11114,310,4386,145,308,27,16290
6/8/2017,15,11109,311,4619,145,297,27,16508
6/8/2017,16,11110,322,4845,110,223,27,16637
6/8/2017,17,11106,383,4900,154,183,27,16753
6/8/2017,18,11110,499,5061,120,86,27,16903
6/8/2017,19,11117,499,5329,140,22,27,17134
6/8/2017,20,11129,501,5395,244,5,27,17301
6/8/2017,21,11121,503,5345,358,0,27,17354
6/8/2017,22,11079,502,4847,256,0,27,16711
6/8/2017,23,11025,485,4003,150,0,18,15681
6/8/2017,24,10453,313,3949,189,0,15,14919
6/9/2017,1,9763,292,3901,203,0,17,14176
6/9/2017,2,9270,292,3926,259,0,14,13761
6/9/2017,3,8941,292,3852,278,0,13,13376
6/9/2017,4,8911,291,3901,474,1,14,13592
6/9/2017,5,9138,293,3870,545,1,19,13866
6/9/2017,6,9731,293,4058,544,12,25,14663
6/9/2017,7,10480,295,4367,418,41,27,15628
6/9/2017,8,11129,294,4679,166,2,26,16296
6/9/2017,9,11138,295,4904,145,26,26,16534
6/9/2017,10,11059,294,5102,176,53,27,16711
6/9/2017,11,10944,294,5077,255,239,26,16835
6/9/2017,12,10942,292,5056,225,219,26,16760
6/9/2017,13,11046,291,5025,388,239,27,17016
6/9/2017,14,11107,283,5007,363,195,26,16981
6/9/2017,15,11110,279,4984,402,152,26,16953
6/9/2017,16,11114,289,5005,375,166,27,16976
6/9/2017,17,11123,285,5051,336,107,27,16929
6/9/2017,18,11133,285,5087,344,64,27,16940
6/9/2017,19,11141,288,5081,356,23,27,16916
6/9/2017,20,11150,286,5167,404,4,27,17038
6/9/2017,21,11141,289,5193,382,0,27,17032
6/9/2017,22,11134,289,4993,212,0,27,16655
6/9/2017,23,11056,162,4140,147,0,17,15522
6/9/2017,24,10530,152,3999,128,0,10,14819
6/10/2017,1,9840,152,3988,174,0,0,14154
6/10/2017,2,9503,153,3907,232,0,0,13795
6/10/2017,3,9255,153,3883,291,0,0,13582
6/10/2017,4,9171,154,3952,213,0,0,13490
6/10/2017,5,9169,154,3958,480,0,0,13761
6/10/2017,6,9148,154,4017,434,7,1,13761
6/10/2017,7,9498,154,4280,465,54,1,14452
6/10/2017,8,10157,154,4425,237,125,0,15098
6/10/2017,9,10568,156,4559,216,215,0,15714
6/10/2017,10,10948,160,4691,221,188,1,16209
6/10/2017,11,11004,176,4595,370,190,1,16336
6/10/2017,12,11007,185,4592,398,121,1,16304
6/10/2017,13,11002,183,4590,464,79,10,16328
6/10/2017,14,11013,185,4323,751,152,26,16450
6/10/2017,15,11018,183,4343,901,167,15,16627
6/10/2017,16,11030,183,4318,1341,216,7,17095
6/10/2017,17,11117,181,4529,1432,149,0,17408
6/10/2017,18,11109,182,4786,1441,77,0,17595
6/10/2017,19,11108,181,4857,1423,21,0,17590
6/10/2017,20,11093,182,4472,1802,5,0,17554
6/10/2017,21,11078,181,4330,1911,0,1,17501
6/10/2017,22,11081,182,4262,1405,0,0,16930
6/10/2017,23,11077,182,4045,1053,0,0,16357
6/10/2017,24,10929,181,3861,478,0,0,15449
6/11/2017,1,10131,154,3736,392,0,2,14415
6/11/2017,2,9177,153,3749,521,0,2,13602
6/11/2017,3,8866,152,3676,600,0,2,13296
6/11/2017,4,8872,152,3682,383,0,0,13089
6/11/2017,5,8841,151,3613,365,0,0,12970
6/11/2017,6,8811,152,3748,358,4,0,13073
6/11/2017,7,8868,151,4098,431,25,0,13573
6/11/2017,8,9165,151,4190,952,74,0,14532
6/11/2017,9,10047,156,4510,664,133,0,15510
6/11/2017,10,10900,156,4457,723,178,0,16414
6/11/2017,11,11004,196,4651,829,203,0,16883
6/11/2017,12,11007,197,4774,1148,311,0,17437
6/11/2017,13,11003,195,4977,1351,317,0,17843
6/11/2017,14,11001,202,5098,1597,313,0,18211
6/11/2017,15,11093,199,5292,1816,289,0,18689
6/11/2017,16,11066,167,5644,1933,224,0,19034
6/11/2017,17,11115,163,5561,2068,161,0,19068
6/11/2017,18,11123,170,5481,1861,76,1,18712
6/11/2017,19,11124,173,5599,1721,23,1,18641
6/11/2017,20,11125,202,5519,1798,6,1,18651
6/11/2017,21,11124,210,5463,1772,0,1,18570
6/11/2017,22,11126,210,4956,1808,0,0,18100
6/11/2017,23,11128,211,4385,1566,0,0,17290
6/11/2017,24,11133,209,4042,1151,0,0,16535
6/12/2017,1,11065,256,3860,515,0,6,15702
6/12/2017,2,10723,264,3744,472,0,9,15212
6/12/2017,3,10517,309,3719,412,0,9,14966
6/12/2017,4,10255,331,3794,355,0,10,14745
6/12/2017,5,10282,354,3906,420,1,17,14980
6/12/2017,6,10678,447,4185,735,7,25,16077
6/12/2017,7,11139,629,4242,1042,49,35,17136
6/12/2017,8,11147,933,4390,1228,110,44,17852
6/12/2017,9,11149,1043,4785,987,178,41,18183
6/12/2017,10,11172,1112,5253,1366,238,42,19183
6/12/2017,11,11177,1337,5130,1155,275,40,19114
6/12/2017,12,11175,1623,5266,1462,287,44,19857
6/12/2017,13,11141,2026,5223,1582,280,43,20295
6/12/2017,14,11138,2141,5138,1581,271,26,20295
6/12/2017,15,11143,2155,5031,1735,296,27,20387
6/12/2017,16,11152,2178,5217,1925,239,27,20738
6/12/2017,17,11165,2318,5818,1818,160,32,21311
6/12/2017,18,11173,2196,5979,1417,85,51,20901
6/12/2017,19,11178,2248,6189,1039,30,45,20729
6/12/2017,20,11173,2212,6110,859,7,40,20401
6/12/2017,21,11164,2495,6010,828,0,41,20538
6/12/2017,22,11157,1929,5809,885,0,30,19810
6/12/2017,23,11160,929,5357,819,0,21,18286
6/12/2017,24,11168,335,5033,742,0,19,17297
6/13/2017,1,11153,295,4485,639,0,19,16591
6/13/2017,2,10472,415,4906,402,0,19,16214
6/13/2017,3,10340,380,4522,782,0,19,16043
6/13/2017,4,10341,327,3629,503,0,18,14818
6/13/2017,5,10334,391,3774,475,0,21,14995
6/13/2017,6,10345,552,4163,822,5,27,15914
6/13/2017,7,10356,959,5335,537,42,30,17259
6/13/2017,8,10365,1419,5393,487,98,31,17793
6/13/2017,9,10363,1902,4891,389,170,31,17746
6/13/2017,10,10363,2133,5160,296,192,30,18174
6/13/2017,11,10210,2174,5196,334,201,30,18145
6/13/2017,12,10286,2270,5105,296,195,31,18183
6/13/2017,13,10366,2467,4991,390,202,31,18447
6/13/2017,14,10383,2403,4791,334,220,30,18161
6/13/2017,15,10391,2277,4849,327,131,30,18005
6/13/2017,16,10382,2167,4988,322,116,35,18010
6/13/2017,17,10386,2164,4870,818,178,35,18451
6/13/2017,18,10388,2155,5254,862,102,27,18788
6/13/2017,19,10386,2118,5707,645,28,27,18911
6/13/2017,20,10372,2048,5774,500,6,27,18727
6/13/2017,21,10354,1791,5689,481,0,26,18341
6/13/2017,22,10370,1038,5011,618,0,26,17063
6/13/2017,23,10363,449,4433,660,0,19,15924
6/13/2017,24,10358,295,3989,615,0,15,15272
6/14/2017,1,10362,294,3478,1050,0,16,15200
6/14/2017,2,10362,295,3405,879,0,15,14956
6/14/2017,3,10358,295,3413,586,0,15,14667
6/14/2017,4,10360,295,3333,700,0,15,14703
6/14/2017,5,10368,295,3324,913,1,18,14919
6/14/2017,6,10369,295,3591,909,8,23,15195
6/14/2017,7,10374,296,3972,1150,53,27,15872
6/14/2017,8,10366,307,4530,1183,145,27,16558
6/14/2017,9,10363,319,4431,1292,229,27,16661
6/14/2017,10,10306,319,4728,1137,288,27,16805
6/14/2017,11,10217,322,4971,1222,302,27,17061
6/14/2017,12,10283,409,4976,1021,319,27,17035
6/14/2017,13,10372,490,5244,718,320,28,17172
6/14/2017,14,10369,652,5520,848,296,28,17713
6/14/2017,15,10360,636,5143,957,297,27,17420
6/14/2017,16,10320,728,5267,934,248,28,17525
6/14/2017,17,10319,728,5370,979,188,27,17611
6/14/2017,18,10327,728,5020,1321,98,27,17521
6/14/2017,19,10328,731,5025,1554,28,27,17693
6/14/2017,20,10322,708,4990,1646,5,27,17698
6/14/2017,21,10312,530,4842,1808,0,27,17519
6/14/2017,22,10306,381,4702,1859,0,27,17275
6/14/2017,23,10317,291,3954,1621,0,20,16203
6/14/2017,24,10326,292,3617,954,0,16,15205
6/15/2017,1,10329,293,3574,471,0,15,14682
6/15/2017,2,10179,291,3413,424,0,15,14322
6/15/2017,3,10026,292,3436,488,0,14,14256
6/15/2017,4,10009,292,3454,456,0,13,14224
6/15/2017,5,10006,291,3521,601,0,17,14436
6/15/2017,6,10225,291,3795,795,9,24,15139
6/15/2017,7,10299,293,4045,751,39,27,15454
6/15/2017,8,10293,331,4208,543,95,27,15497
6/15/2017,9,10254,398,4736,318,148,27,15881
6/15/2017,10,10245,550,4692,286,187,27,15987
6/15/2017,11,10372,748,4797,265,159,27,16368
6/15/2017,12,10547,1199,4643,207,71,27,16694
6/15/2017,13,10540,1272,4606,412,141,27,16998
6/15/2017,14,10490,1311,4676,400,153,27,17057
6/15/2017,15,10512,1401,4582,217,84,27,16823
6/15/2017,16,10600,1517,4794,236,94,27,17268
6/15/2017,17,10752,1522,5063,400,110,27,17874
6/15/2017,18,10954,1418,5002,381,59,27,17841
6/15/2017,19,10989,1154,5210,341,25,27,17746
6/15/2017,20,10979,974,5284,253,6,27,17523
6/15/2017,21,10982,600,4945,339,0,27,16893
6/15/2017,22,10988,327,4809,487,0,27,16638
6/15/2017,23,10988,285,4201,453,0,15,15942
6/15/2017,24,10964,287,3700,419,0,13,15383
6/16/2017,1,10551,290,3475,374,0,14,14704
6/16/2017,2,10382,290,3389,345,0,13,14419
6/16/2017,3,10387,289,3318,206,0,12,14212
6/16/2017,4,10400,291,3267,188,0,14,14160
6/16/2017,5,10410,291,3473,347,1,19,14541
6/16/2017,6,10760,293,3703,458,3,29,15246
6/16/2017,7,11104,297,3864,341,27,49,15682
6/16/2017,8,11104,298,4208,382,72,51,16115
6/16/2017,9,11104,329,4602,442,130,51,16658
6/16/2017,10,11110,417,4555,479,158,52,16771
6/16/2017,11,11101,655,4800,360,168,51,17135
6/16/2017,12,11101,731,4867,346,201,55,17301
6/16/2017,13,11102,852,4789,317,141,50,17251
6/16/2017,14,11090,1004,4833,357,180,30,17494
6/16/2017,15,11082,1061,4890,641,233,30,17937
6/16/2017,16,11088,1044,5249,617,186,27,18211
6/16/2017,17,11089,1159,5600,761,144,32,18785
6/16/2017,18,11100,1233,5370,721,78,33,18535
6/16/2017,19,11117,1280,5322,690,27,27,18463
6/16/2017,20,11109,1286,5105,591,7,27,18125
6/16/2017,21,11096,1014,5150,608,0,27,17895
6/16/2017,22,11101,766,5005,566,0,27,17465
6/16/2017,23,11104,458,4387,570,0,19,16538
6/16/2017,24,11104,410,3880,491,0,11,15896
6/17/2017,1,10816,245,3340,1025,0,1,15427
6/17/2017,2,10434,200,3351,833,0,0,14818
6/17/2017,3,10208,200,3260,953,0,0,14621
6/17/2017,4,10208,201,3233,761,0,0,14403
6/17/2017,5,10202,201,3153,868,1,0,14425
6/17/2017,6,10212,205,3283,691,8,0,14399
6/17/2017,7,10475,205,3594,696,48,0,15018
6/17/2017,8,11079,254,4215,905,86,0,16539
6/17/2017,9,11094,281,4480,1046,141,0,17042
6/17/2017,10,11097,396,4548,1058,176,0,17275
6/17/2017,11,11093,627,5203,760,208,0,17891
6/17/2017,12,11096,812,4778,927,214,0,17827
6/17/2017,13,11094,978,4906,731,205,0,17914
6/17/2017,14,11058,1232,4743,905,250,0,18188
6/17/2017,15,11105,1596,4534,593,210,0,18038
6/17/2017,16,11099,1580,4663,589,81,0,18012
6/17/2017,17,11097,1588,4634,1381,98,0,18798
6/17/2017,18,11097,1585,4657,1523,67,0,18929
6/17/2017,19,11096,1487,4887,1366,23,0,18859
6/17/2017,20,11094,1196,4872,1455,5,0,18622
6/17/2017,21,11092,837,4508,1297,0,0,17734
6/17/2017,22,11093,292,4436,1260,0,2,17083
6/17/2017,23,11082,196,4002,1300,0,1,16581
6/17/2017,24,11096,197,3492,1329,0,3,16117
6/18/2017,1,11097,196,3304,865,0,1,15463
6/18/2017,2,11093,197,3264,721,0,1,15276
6/18/2017,3,10911,196,3265,756,0,0,15128
6/18/2017,4,10775,196,3317,630,1,1,14920
6/18/2017,5,10553,196,3354,730,1,0,14834
6/18/2017,6,10551,196,3416,596,3,0,14762
6/18/2017,7,10713,222,3717,754,37,1,15444
6/18/2017,8,11085,226,3714,1592,92,0,16709
6/18/2017,9,11087,225,3812,1949,147,0,17220
6/18/2017,10,11081,224,3890,3014,192,0,18401
6/18/2017,11,11067,236,4309,3240,206,0,19058
6/18/2017,12,11051,232,4235,3148,148,0,18814
6/18/2017,13,11044,293,4405,3037,220,0,18999
6/18/2017,14,11033,368,4697,3051,220,0,19369
6/18/2017,15,10988,429,4830,2839,200,0,19286
6/18/2017,16,11037,429,4665,2765,163,0,19059
6/18/2017,17,11045,429,4518,2695,101,0,18788
6/18/2017,18,11062,429,4709,2243,59,0,18502
6/18/2017,19,11064,431,4805,2638,16,0,18954
6/18/2017,20,11062,404,4828,2736,10,0,19040
6/18/2017,21,11073,401,4988,2296,0,0,18758
6/18/2017,22,11074,403,5059,1958,0,0,18494
6/18/2017,23,11072,245,4051,1789,0,0,17157
6/18/2017,24,11074,195,3509,1075,0,0,15853
6/19/2017,1,10970,197,3505,619,0,3,15294
6/19/2017,2,10680,208,3531,906,0,11,15336
6/19/2017,3,10539,222,3475,883,0,12,15131
6/19/2017,4,10551,367,3439,621,0,13,14991
6/19/2017,5,10559,600,3507,352,0,17,15035
6/19/2017,6,10642,852,3685,578,5,24,15786
6/19/2017,7,11060,1078,4166,664,47,27,17042
6/19/2017,8,11110,1210,4785,483,97,27,17712
6/19/2017,9,11112,1222,4854,364,145,27,17724
6/19/2017,10,11066,1225,5030,453,215,27,18016
6/19/2017,11,11033,1536,4721,702,246,27,18265
6/19/2017,12,11029,1552,4645,789,221,27,18263
6/19/2017,13,11019,1532,5003,1028,240,34,18856
6/19/2017,14,11017,1642,5093,1048,263,33,19096
6/19/2017,15,11015,1760,5310,958,203,34,19280
6/19/2017,16,11026,1773,5536,1246,182,27,19790
6/19/2017,17,11030,1599,5674,1284,143,26,19756
6/19/2017,18,11034,1523,5801,953,70,27,19408
6/19/2017,19,11036,1444,5703,573,23,26,18805
6/19/2017,20,11028,1245,5615,482,4,27,18401
6/19/2017,21,11024,643,5441,810,0,26,17944
6/19/2017,22,11023,400,4622,833,0,26,16904
6/19/2017,23,11035,369,3978,507,0,20,15909
6/19/2017,24,11040,287,3749,482,0,17,15575
6/20/2017,1,10924,283,3519,433,0,18,15177
6/20/2017,2,10805,284,3573,371,0,18,15051
6/20/2017,3,10657,284,3523,351,0,18,14833
6/20/2017,4,10506,283,3593,404,0,16,14802
6/20/2017,5,10512,282,3825,402,0,17,15038
6/20/2017,6,10589,282,3810,662,5,25,15373
6/20/2017,7,11008,283,4165,746,29,26,16257
6/20/2017,8,11047,283,4475,894,85,27,16811
6/20/2017,9,11043,282,4343,859,169,27,16723
6/20/2017,10,11037,293,4453,889,199,27,16898
6/20/2017,11,11029,313,4701,1194,229,27,17493
6/20/2017,12,11038,313,4910,980,193,27,17461
6/20/2017,13,11043,312,4852,1449,168,27,17851
6/20/2017,14,11040,312,4922,1245,197,27,17743
6/20/2017,15,11033,312,4883,1310,221,27,17786
6/20/2017,16,11032,312,4923,1694,200,27,18188
6/20/2017,17,11025,311,5002,1783,115,27,18263
6/20/2017,18,11027,306,4909,1857,45,32,18176
6/20/2017,19,11022,282,5319,1423,23,75,18144
6/20/2017,20,11019,260,5508,956,2,26,17771
6/20/2017,21,11014,264,5551,545,0,26,17400
6/20/2017,22,11025,266,4870,407,0,26,16594
6/20/2017,23,11037,269,4049,366,0,16,15737
6/20/2017,24,10908,284,3775,254,0,14,15235
6/21/2017,1,10419,290,3802,151,0,15,14677
6/21/2017,2,10013,294,3640,260,0,14,14221
6/21/2017,3,10003,289,3565,217,0,14,14088
6/21/2017,4,10005,292,3573,234,0,14,14118
6/21/2017,5,10163,292,3624,306,0,19,14404
6/21/2017,6,10355,292,3867,314,6,23,14857
6/21/2017,7,10767,291,4305,294,49,26,15732
6/21/2017,8,11106,303,4218,154,95,27,15903
6/21/2017,9,11100,323,4505,136,194,27,16285
6/21/2017,10,11059,321,4825,199,226,27,16657
6/21/2017,11,10947,325,5154,248,217,27,16918
6/21/2017,12,10944,364,5130,234,234,27,16933
6/21/2017,13,10992,389,5180,192,187,28,16968
6/21/2017,14,11095,448,4999,232,213,27,17014
6/21/2017,15,11103,524,4979,321,214,27,17168
6/21/2017,16,11051,525,5005,416,230,27,17254
6/21/2017,17,11049,523,5188,497,180,27,17464
6/21/2017,18,11051,520,5318,512,97,27,17525
6/21/2017,19,11059,521,5538,394,28,23,17563
6/21/2017,20,11048,526,5847,210,7,26,17664
6/21/2017,21,11046,534,5668,182,0,27,17457
6/21/2017,22,11057,373,4999,193,0,27,16649
6/21/2017,23,11073,286,4401,206,0,19,15985
6/21/2017,24,10851,289,3719,414,0,16,15289
6/22/2017,1,10383,291,3839,573,0,15,15101
6/22/2017,2,10040,291,3901,673,0,15,14920
6/22/2017,3,9731,288,3684,899,0,15,14617
6/22/2017,4,9727,290,3575,983,0,15,14590
6/22/2017,5,9932,290,3627,918,1,19,14787
6/22/2017,6,10393,289,3851,944,7,24,15508
6/22/2017,7,10975,288,3980,1165,49,27,16484
6/22/2017,8,11056,295,4203,1246,101,27,16928
6/22/2017,9,11073,293,4560,1184,144,27,17281
6/22/2017,10,11069,291,5008,1252,156,27,17803
6/22/2017,11,11068,289,5185,1220,103,27,17892
6/22/2017,12,11051,286,4752,1169,165,27,17450
6/22/2017,13,11042,286,4799,1054,255,27,17463
6/22/2017,14,11029,289,5002,1250,263,27,17860
6/22/2017,15,11026,284,5264,1283,265,26,18148
6/22/2017,16,11024,286,5460,1262,171,27,18230
6/22/2017,17,11031,286,5285,1516,101,27,18246
6/22/2017,18,11030,286,5174,1395,69,27,17981
6/22/2017,19,11038,287,4932,1335,32,27,17651
6/22/2017,20,11044,287,4981,1567,7,27,17913
6/22/2017,21,11043,289,5522,1523,0,27,18404
6/22/2017,22,11052,290,4850,1395,0,27,17614
6/22/2017,23,11060,288,4008,1507,0,21,16884
6/22/2017,24,11055,287,3886,830,0,14,16072
6/23/2017,1,10966,285,3810,840,0,14,15915
6/23/2017,2,10509,285,3573,1134,0,14,15515
6/23/2017,3,10480,282,3474,1099,0,14,15349
6/23/2017,4,10480,283,3484,1055,1,14,15317
6/23/2017,5,10701,283,3584,730,1,16,15315
6/23/2017,6,10859,282,4167,697,2,20,16027
6/23/2017,7,11028,289,4687,685,16,26,16731
6/23/2017,8,11026,325,5218,921,52,27,17569
6/23/2017,9,11044,313,4820,982,72,27,17258
6/23/2017,10,11052,393,4816,1009,52,27,17349
6/23/2017,11,11073,407,5197,827,84,27,17615
6/23/2017,12,11085,501,5394,426,111,27,17544
6/23/2017,13,11077,525,5407,339,174,27,17549
6/23/2017,14,11076,589,4954,434,148,27,17228
6/23/2017,15,11070,606,4977,632,90,27,17402
6/23/2017,16,11098,615,5290,878,105,27,18013
6/23/2017,17,11103,621,5396,931,79,27,18157
6/23/2017,18,11110,610,5341,630,58,27,17776
6/23/2017,19,11108,436,5550,506,26,27,17653
6/23/2017,20,11110,345,5684,354,5,27,17525
6/23/2017,21,11105,423,5799,337,0,27,17691
6/23/2017,22,11114,419,5331,470,0,27,17361
6/23/2017,23,11119,238,4646,629,0,17,16649
6/23/2017,24,11116,153,3677,659,0,3,15608
6/24/2017,1,11050,152,3222,507,0,0,14931
6/24/2017,2,10869,152,3178,685,0,0,14884
6/24/2017,3,10875,153,3233,662,0,0,14923
6/24/2017,4,10874,151,3156,562,0,0,14743
6/24/2017,5,10873,151,3169,603,0,0,14796
6/24/2017,6,10876,152,3433,441,7,0,14909
6/24/2017,7,10884,152,3737,486,44,0,15303
6/24/2017,8,11102,154,4145,409,136,0,15946
6/24/2017,9,11124,155,4190,530,210,0,16209
6/24/2017,10,11124,155,4445,558,287,0,16569
6/24/2017,11,11127,152,4373,609,309,0,16570
6/24/2017,12,11130,145,4515,899,286,0,16975
6/24/2017,13,11132,155,4457,961,233,0,16938
6/24/2017,14,11135,154,4113,1136,234,0,16772
6/24/2017,15,11139,155,4139,1138,211,0,16782
6/24/2017,16,11163,154,4279,1276,188,0,17060
6/24/2017,17,11164,154,4866,1265,117,0,17566
6/24/2017,18,11163,161,5282,1026,85,0,17717
6/24/2017,19,11168,159,5401,764,31,0,17523
6/24/2017,20,11164,157,5281,667,4,0,17273
6/24/2017,21,11162,157,5139,668,0,0,17126
6/24/2017,22,11167,151,4727,580,0,0,16625
6/24/2017,23,11178,152,3851,621,0,0,15802
6/24/2017,24,11113,153,3363,555,0,0,15184
6/25/2017,1,10848,152,3180,537,0,0,14717
6/25/2017,2,10389,152,3195,818,0,0,14554
6/25/2017,3,10303,153,3185,520,0,0,14161
6/25/2017,4,10234,151,3191,465,0,0,14041
6/25/2017,5,10001,150,3212,532,1,0,13896
6/25/2017,6,10010,152,3278,435,9,0,13884
6/25/2017,7,10084,153,3568,340,28,0,14173
6/25/2017,8,10377,153,3767,711,114,0,15122
6/25/2017,9,10767,154,3777,835,199,0,15732
6/25/2017,10,11125,154,3835,591,178,0,15883
6/25/2017,11,11128,154,3998,814,126,0,16220
6/25/2017,12,11119,153,4031,867,152,6,16328
6/25/2017,13,11109,153,4108,682,76,5,16133
6/25/2017,14,11110,153,4194,652,55,11,16175
6/25/2017,15,11084,152,4270,619,111,17,16253
6/25/2017,16,11134,179,4474,613,195,19,16614
6/25/2017,17,11138,181,4526,690,124,16,16675
6/25/2017,18,11153,180,4627,705,89,4,16758
6/25/2017,19,11167,160,4875,641,31,0,16874
6/25/2017,20,11169,151,5010,589,8,0,16927
6/25/2017,21,11157,151,4764,650,0,0,16722
6/25/2017,22,11157,151,4443,470,0,0,16221
6/25/2017,23,11162,150,3866,322,0,0,15500
6/25/2017,24,11093,151,3560,394,0,0,15198
6/26/2017,1,10919,151,3387,408,0,0,14865
6/26/2017,2,10918,151,3296,343,0,0,14708
6/26/2017,3,10920,151,3310,297,0,2,14680
6/26/2017,4,10931,153,3317,263,0,9,14673
6/26/2017,5,10924,156,3355,475,0,16,14926
6/26/2017,6,11003,165,3583,400,10,22,15183
6/26/2017,7,11130,294,3924,420,50,27,15845
6/26/2017,8,11128,296,4278,487,125,27,16341
6/26/2017,9,10992,295,4263,687,215,27,16479
6/26/2017,10,10944,294,4175,1013,247,27,16700
6/26/2017,11,10972,294,4185,1180,267,27,16925
6/26/2017,12,11114,292,4297,1104,247,27,17081
6/26/2017,13,11110,292,4476,1215,239,27,17359
6/26/2017,14,11099,293,4295,1339,237,12,17275
6/26/2017,15,11100,310,4386,1103,254,24,17177
6/26/2017,16,11106,302,4439,1156,227,27,17257
6/26/2017,17,11104,295,4458,1423,138,27,17445
6/26/2017,18,11098,294,4553,1464,62,25,17496
6/26/2017,19,11091,293,4839,1181,26,26,17456
6/26/2017,20,11092,309,5291,671,11,26,17400
6/26/2017,21,11087,292,5127,494,0,26,17026
6/26/2017,22,11094,290,4338,652,0,26,16400
6/26/2017,23,11064,291,3773,417,0,16,15561
6/26/2017,24,10816,289,3536,279,0,13,14933
6/27/2017,1,10435,290,3347,315,0,11,14398
6/27/2017,2,10131,293,3223,378,0,11,14036
6/27/2017,3,9873,293,3262,439,0,12,13879
6/27/2017,4,9690,296,3370,451,0,15,13822
6/27/2017,5,9697,295,3540,334,1,25,13892
6/27/2017,6,10226,295,3664,514,16,34,14749
6/27/2017,7,10975,295,3952,218,13,43,15496
6/27/2017,8,11105,292,4109,230,48,46,15830
6/27/2017,9,11102,292,4006,258,106,45,15809
6/27/2017,10,11115,292,4199,479,155,44,16284
6/27/2017,11,11116,290,4192,840,144,38,16620
6/27/2017,12,11112,290,4121,884,167,42,16616
6/27/2017,13,11116,288,4119,744,204,45,16516
6/27/2017,14,11118,288,4089,582,230,45,16352
6/27/2017,15,11128,289,4211,469,206,46,16349
6/27/2017,16,11141,291,4509,535,154,37,16667
6/27/2017,17,11156,312,4627,656,171,36,16958
6/27/2017,18,11233,317,4731,648,79,26,17034
6/27/2017,19,11392,316,4742,784,30,27,17291
6/27/2017,20,11385,305,4914,665,7,26,17302
6/27/2017,21,11350,288,5099,659,0,26,17422
6/27/2017,22,11414,288,4234,594,0,26,16556
6/27/2017,23,11473,290,3676,523,0,17,15979
6/27/2017,24,10829,290,3572,228,0,13,14932
6/28/2017,1,9906,290,3598,227,0,13,14034
6/28/2017,2,9607,291,3485,306,0,11,13700
6/28/2017,3,9386,292,3509,429,0,11,13627
6/28/2017,4,9385,293,3446,515,0,13,13652
6/28/2017,5,9400,293,3474,647,0,16,13830
6/28/2017,6,9973,293,3763,562,7,24,14622
6/28/2017,7,10768,291,4114,396,37,26,15632
6/28/2017,8,11338,290,4095,319,109,27,16178
6/28/2017,9,11423,290,4103,336,195,27,16374
6/28/2017,10,11547,289,4101,219,106,26,16288
6/28/2017,11,11427,288,4373,266,97,26,16477
6/28/2017,12,11510,287,4471,293,219,26,16806
6/28/2017,13,11610,286,4443,550,259,26,17174
6/28/2017,14,11610,287,4271,840,258,27,17293
6/28/2017,15,11609,286,4497,676,236,27,17331
6/28/2017,16,11605,285,4514,1077,199,26,17706
6/28/2017,17,11601,285,4468,1470,128,26,17978
6/28/2017,18,11587,260,4701,1169,59,26,17802
6/28/2017,19,11580,235,4725,1166,26,26,17758
6/28/2017,20,11561,233,4679,1292,4,26,17795
6/28/2017,21,11557,235,4553,1435,0,27,17807
6/28/2017,22,11568,235,3960,1296,0,26,17085
6/28/2017,23,11488,233,3537,798,0,16,16072
6/28/2017,24,10662,233,3224,1010,0,12,15141
6/29/2017,1,9830,234,3161,1017,0,12,14254
6/29/2017,2,9587,234,3080,855,0,12,13768
6/29/2017,3,9367,235,3116,1023,0,13,13754
6/29/2017,4,9369,235,3078,959,0,13,13654
6/29/2017,5,9381,236,3196,997,0,16,13826
6/29/2017,6,9777,238,3482,1226,0,23,14746
6/29/2017,7,10604,237,3959,1239,11,26,16076
6/29/2017,8,11531,248,4019,990,37,26,16851
6/29/2017,9,11615,269,4162,1184,45,26,17301
6/29/2017,10,11610,310,4273,1016,61,26,17296
6/29/2017,11,11609,324,4235,1024,89,26,17307
6/29/2017,12,11609,324,4085,1158,108,26,17310
6/29/2017,13,11605,325,4128,1210,108,26,17402
6/29/2017,14,11601,325,4082,1189,122,26,17345
6/29/2017,15,11592,266,4282,1228,133,26,17527
6/29/2017,16,11595,235,4278,1829,70,26,18033
6/29/2017,17,11584,235,4365,2260,71,26,18541
6/29/2017,18,11584,236,4835,2098,56,26,18835
6/29/2017,19,11585,236,4935,1928,24,26,18734
6/29/2017,20,11570,235,4752,1697,4,26,18284
6/29/2017,21,11573,236,4740,1789,0,25,18363
6/29/2017,22,11583,236,4183,1843,0,25,17870
6/29/2017,23,11594,235,3788,1083,0,16,16716
6/29/2017,24,11432,236,3514,437,0,13,15632
6/30/2017,1,10782,235,3315,873,0,15,15220
6/30/2017,2,10737,234,3176,590,0,12,14749
6/30/2017,3,10577,234,3212,424,0,13,14460
6/30/2017,4,10173,235,3279,770,0,12,14469
6/30/2017,5,10157,234,3446,939,0,15,14791
6/30/2017,6,10532,237,3687,680,4,41,15181
6/30/2017,7,11324,237,3874,793,23,80,16331
6/30/2017,8,11585,262,4069,994,25,143,17078
6/30/2017,9,11579,301,4379,904,46,165,17374
6/30/2017,10,11591,414,4664,917,90,191,17867
6/30/2017,11,11607,462,4945,932,124,193,18263
6/30/2017,12,11617,523,4617,1077,170,191,18195
6/30/2017,13,11615,565,4616,1255,183,169,18403
6/30/2017,14,11611,595,4635,1116,194,117,18268
6/30/2017,15,11615,680,5114,1119,223,129,18880
6/30/2017,16,11620,683,5355,1007,162,130,18957
6/30/2017,17,11618,684,5493,1160,130,150,19235
6/30/2017,18,11615,682,5171,1199,66,175,18908
6/30/2017,19,11610,517,5021,1131,17,186,18482
6/30/2017,20,11614,477,5030,1158,3,192,18474
6/30/2017,21,11605,333,5054,1222,0,194,18408
6/30/2017,22,11609,232,4784,1379,0,156,18160
6/30/2017,23,11617,156,4091,1439,0,73,17376
6/30/2017,24,11615,149,3523,748,0,16,16051
7/1/2017,1,11468,150,3409,397,0,0,15424
7/1/2017,2,10920,150,3326,495,0,0,14891
7/1/2017,3,10500,151,3274,559,1,0,14485
7/1/2017,4,10276,148,3278,634,0,0,14336
7/1/2017,5,10055,151,3400,684,0,0,14290
7/1/2017,6,9970,151,3624,564,0,0,14309
7/1/2017,7,10137,151,3882,503,6,0,14679
7/1/2017,8,10679,150,4102,615,34,0,15580
7/1/2017,9,11208,151,4385,654,53,0,16451
7/1/2017,10,11591,150,4283,627,109,0,16760
7/1/2017,11,11582,151,4365,1057,124,0,17279
7/1/2017,12,11584,151,4454,1037,148,0,17374
7/1/2017,13,11590,152,4343,1078,184,0,17347
7/1/2017,14,11586,150,4427,906,193,0,17262
7/1/2017,15,11582,151,4428,711,145,0,17017
7/1/2017,16,11574,151,4519,509,120,0,16873
7/1/2017,17,11556,150,4672,434,19,4,16835
7/1/2017,18,11541,151,4795,465,24,5,16981
7/1/2017,19,11550,148,4623,610,28,0,16959
7/1/2017,20,11553,149,4466,438,3,0,16609
7/1/2017,21,11567,150,4157,515,0,0,16389
7/1/2017,22,11565,150,3875,294,0,0,15884
7/1/2017,23,11554,152,3867,219,0,0,15792
7/1/2017,24,11554,152,3867,219,0,0,15792
7/2/2017,1,9978,151,3651,468,0,0,14248
7/2/2017,2,9946,151,3455,378,0,0,13930
7/2/2017,3,9685,151,3457,311,0,0,13604
7/2/2017,4,9440,151,3485,236,0,0,13312
7/2/2017,5,9356,151,3510,179,0,0,13196
7/2/2017,6,9292,150,3580,54,0,0,13076
7/2/2017,7,9293,150,3901,94,15,0,13453
7/2/2017,8,9583,151,4153,334,81,0,14302
7/2/2017,9,10619,150,3870,417,133,0,15189
7/2/2017,10,11082,150,3903,444,170,0,15749
7/2/2017,11,11277,151,4006,441,227,0,16102
7/2/2017,12,11274,151,3934,746,260,0,16365
7/2/2017,13,11261,151,3959,832,256,0,16459
7/2/2017,14,11227,150,3905,638,214,0,16134
7/2/2017,15,11260,151,4089,679,183,0,16362
7/2/2017,16,11290,151,4256,1098,173,0,16968
7/2/2017,17,11562,151,4474,1544,122,0,17853
7/2/2017,18,11573,150,4591,1462,73,0,17849
7/2/2017,19,11575,150,4466,1147,32,0,17370
7/2/2017,20,11579,151,4437,905,15,0,17087
7/2/2017,21,11583,151,4322,1006,10,0,17072
7/2/2017,22,11589,151,4015,724,10,3,16492
7/2/2017,23,11040,151,3785,722,10,17,15725
7/2/2017,24,10520,150,3794,727,10,41,15242
7/3/2017,1,9830,151,3861,606,9,49,14506
7/3/2017,2,9652,150,3738,539,0,49,14128
7/3/2017,3,9654,151,4064,358,0,50,14277
7/3/2017,4,9653,150,4028,256,0,49,14136
7/3/2017,5,9655,151,4041,241,0,49,14137
7/3/2017,6,9434,151,4064,283,3,49,13984
7/3/2017,7,9734,151,4522,193,40,55,14695
7/3/2017,8,10783,151,3878,79,43,56,14990
7/3/2017,9,11043,151,3806,85,139,61,15285
7/3/2017,10,11131,151,4001,122,257,65,15727
7/3/2017,11,11499,111,4017,123,260,68,16078
7/3/2017,12,11627,49,4308,93,56,70,16203
7/3/2017,13,11573,130,4368,97,96,69,16333
7/3/2017,14,11335,151,4381,264,253,68,16452
7/3/2017,15,11346,152,4517,308,238,61,16622
7/3/2017,16,11347,153,5154,395,231,53,17333
7/3/2017,17,11345,173,5773,379,162,49,17881
7/3/2017,18,11499,208,5256,355,111,49,17478
7/3/2017,19,11650,152,5092,339,54,49,17336
7/3/2017,20,11657,151,5077,252,34,49,17220
7/3/2017,21,11648,149,4826,180,30,49,16882
7/3/2017,22,11642,148,4539,191,30,9,16559
7/3/2017,23,11577,149,3834,205,30,0,15795
7/3/2017,24,11240,149,3633,223,30,0,15275
7/4/2017,1,10618,149,3554,179,30,15,14545
7/4/2017,2,9887,150,3731,396,30,18,14212
7/4/2017,3,9704,150,3621,415,30,18,13938
7/4/2017,4,9715,150,3648,480,30,18,14041
7/4/2017,5,10053,149,3710,576,30,21,14539
7/4/2017,6,10845,163,3847,346,32,31,15264
7/4/2017,7,11487,288,3948,224,65,31,16043
7/4/2017,8,11656,288,4464,90,147,31,16676
7/4/2017,9,11659,287,4826,79,226,31,17108
7/4/2017,10,11666,291,4819,125,285,31,17217
7/4/2017,11,11671,331,5045,116,306,31,17500
7/4/2017,12,11670,411,4928,133,291,32,17465
7/4/2017,13,11666,450,5106,193,287,33,17735
7/4/2017,14,11654,483,5275,269,275,33,17989
7/4/2017,15,11642,502,5329,333,264,68,18138
7/4/2017,16,11632,678,5275,384,255,68,18292
7/4/2017,17,11620,769,5569,384,197,64,18603
7/4/2017,18,11616,770,6083,322,120,65,18976
7/4/2017,19,11630,825,5948,254,56,68,18781
7/4/2017,20,11638,651,5616,222,10,58,18195
7/4/2017,21,11644,584,5336,324,0,44,17932
7/4/2017,22,11654,590,4787,320,0,57,17408
7/4/2017,23,11684,448,4059,259,0,37,16487
7/4/2017,24,11483,347,3497,283,0,23,15633
7/5/2017,1,10808,340,3482,605,0,21,15256
7/5/2017,2,10464,341,3425,375,0,22,14627
7/5/2017,3,10231,342,3454,350,0,22,14399
7/5/2017,4,10176,343,3462,309,0,19,14309
7/5/2017,5,10143,380,3593,347,0,23,14486
7/5/2017,6,10668,389,3868,337,5,30,15297
7/5/2017,7,11339,418,4002,134,9,31,15933
7/5/2017,8,11652,466,4412,130,87,31,16778
7/5/2017,9,11647,526,4617,112,145,31,17078
7/5/2017,10,11633,555,4688,237,217,31,17361
7/5/2017,11,11487,645,4988,323,241,30,17714
7/5/2017,12,11503,843,4979,376,284,30,18015
7/5/2017,13,11631,1062,4929,202,263,47,18134
7/5/2017,14,11622,1126,4860,278,289,80,18255
7/5/2017,15,11636,1135,5200,285,278,147,18681
7/5/2017,16,11324,1191,5742,342,234,208,19041
7/5/2017,17,10449,1855,6056,232,105,207,18904
7/5/2017,18,10510,1666,6020,225,91,209,18721
7/5/2017,19,10507,1617,5952,162,24,210,18472
7/5/2017,20,10916,1243,5552,124,5,210,18050
7/5/2017,21,11495,1007,5485,136,0,210,18333
7/5/2017,22,11630,853,5125,166,0,185,17959
7/5/2017,23,11621,439,4539,157,0,81,16837
7/5/2017,24,11613,356,3800,184,0,26,15979
7/6/2017,1,11549,365,3360,181,0,12,15467
7/6/2017,2,11173,373,3191,199,0,12,14948
7/6/2017,3,10899,393,3173,133,0,13,14611
7/6/2017,4,10623,412,3243,253,0,12,14543
7/6/2017,5,10501,433,3211,510,0,18,14673
7/6/2017,6,10768,452,3604,238,3,24,15089
7/6/2017,7,11131,488,3877,418,38,202,16154
7/6/2017,8,11616,661,4066,234,94,117,16788
7/6/2017,9,11608,864,4421,164,175,160,17392
7/6/2017,10,11594,1074,4819,153,219,159,18018
7/6/2017,11,11582,1248,5186,177,247,130,18570
7/6/2017,12,11556,1406,5427,192,263,159,19003
7/6/2017,13,11563,1780,5366,332,261,174,19476
7/6/2017,14,11593,1883,5591,504,249,185,20005
7/6/2017,15,11581,1981,5575,529,223,201,20090
7/6/2017,16,11567,2163,5413,523,205,179,20050
7/6/2017,17,11567,2202,5903,436,138,124,20370
7/6/2017,18,11567,2491,5780,503,80,125,20546
7/6/2017,19,11566,2521,5488,446,26,150,20197
7/6/2017,20,11568,2255,5450,526,4,172,19975
7/6/2017,21,11555,2070,5528,599,0,178,19930
7/6/2017,22,11564,1209,5108,772,0,128,18781
7/6/2017,23,11588,273,4922,964,0,38,17785
7/6/2017,24,11589,193,4066,973,0,13,16834
7/7/2017,1,11579,213,3296,866,0,12,15966
7/7/2017,2,11565,233,3215,530,0,12,15555
7/7/2017,3,11551,264,3198,473,0,13,15499
7/7/2017,4,11530,281,3151,472,0,14,15448
7/7/2017,5,11524,281,3152,407,0,20,15384
7/7/2017,6,11525,281,3654,361,8,28,15857
7/7/2017,7,11525,281,4140,620,29,55,16650
7/7/2017,8,11517,306,5556,349,59,93,17880
7/7/2017,9,11518,378,6013,224,128,185,18446
7/7/2017,10,11519,585,5515,263,155,208,18245
7/7/2017,11,11513,733,5374,252,190,208,18270
7/7/2017,12,11506,592,5243,313,203,209,18066
7/7/2017,13,11500,587,5378,448,231,209,18353
7/7/2017,14,11509,695,5750,573,223,198,18948
7/7/2017,15,11508,1001,5998,661,208,157,19533
7/7/2017,16,11506,995,5604,793,205,173,19276
7/7/2017,17,11506,940,5521,936,147,154,19204
7/7/2017,18,11506,585,5097,1180,66,185,18619
7/7/2017,19,11497,535,5152,866,28,194,18272
7/7/2017,20,11494,492,5462,530,4,198,18180
7/7/2017,21,11488,343,6013,483,0,193,18520
7/7/2017,22,11501,315,5484,450,0,121,17871
7/7/2017,23,11524,161,4609,647,0,34,16975
7/7/2017,24,11532,146,4189,394,0,11,16272
7/8/2017,1,11496,147,3651,415,0,0,15709
7/8/2017,2,10872,169,3827,325,0,0,15193
7/8/2017,3,10539,174,3741,617,0,0,15071
7/8/2017,4,10541,177,3715,475,0,0,14908
7/8/2017,5,10546,178,3717,330,0,0,14771
7/8/2017,6,10558,176,3767,417,1,0,14919
7/8/2017,7,10342,175,4019,482,23,0,15041
7/8/2017,8,10570,176,4225,730,90,0,15791
7/8/2017,9,11317,173,4086,713,146,0,16435
7/8/2017,10,11333,162,4012,555,191,1,16254
7/8/2017,11,11332,162,4039,499,174,0,16206
7/8/2017,12,11335,171,4050,575,176,0,16307
7/8/2017,13,11328,147,3883,591,205,0,16154
7/8/2017,14,11309,148,3766,838,192,0,16253
7/8/2017,15,11269,147,3871,804,212,0,16303
7/8/2017,16,11308,147,4054,954,190,0,16653
7/8/2017,17,11311,148,4399,830,138,0,16826
7/8/2017,18,11312,148,4706,678,93,0,16937
7/8/2017,19,11313,148,4836,588,26,0,16911
7/8/2017,20,11323,149,4876,396,4,0,16748
7/8/2017,21,11341,149,4828,357,0,0,16675
7/8/2017,22,11360,149,4238,417,0,0,16164
7/8/2017,23,11364,148,3591,496,0,0,15599
7/8/2017,24,11098,149,3409,612,0,0,15268
7/9/2017,1,10427,148,3342,725,0,0,14642
7/9/2017,2,9877,149,2993,992,0,0,14011
7/9/2017,3,9687,148,2972,724,0,0,13531
7/9/2017,4,9610,151,2999,385,0,0,13145
7/9/2017,5,9393,151,3028,409,0,0,12981
7/9/2017,6,9405,152,3285,387,3,0,13232
7/9/2017,7,9327,152,3675,176,22,0,13352
7/9/2017,8,9340,152,3747,558,109,0,13906
7/9/2017,9,9703,152,3903,683,131,0,14572
7/9/2017,10,10120,152,3791,780,201,0,15044
7/9/2017,11,10654,152,3861,554,247,0,15468
7/9/2017,12,10972,152,3950,699,250,0,16023
7/9/2017,13,11397,152,3863,803,238,0,16453
7/9/2017,14,11645,152,3795,712,236,0,16540
7/9/2017,15,11647,151,3927,570,122,0,16417
7/9/2017,16,11657,152,3927,1399,224,0,17359
7/9/2017,17,11644,152,4320,1581,152,0,17849
7/9/2017,18,11638,152,4329,1556,99,0,17774
7/9/2017,19,11626,149,4325,1752,34,0,17886
7/9/2017,20,11601,152,4427,1563,6,0,17749
7/9/2017,21,11598,151,4303,1420,2,0,17474
7/9/2017,22,11587,150,3863,1318,1,0,16919
7/9/2017,23,11526,149,3545,812,1,0,16033
7/9/2017,24,11141,150,3564,689,1,0,15545
7/10/2017,1,10766,150,3555,757,1,0,15229
7/10/2017,2,10767,151,3504,450,1,2,14875
7/10/2017,3,10766,152,3335,446,1,8,14708
7/10/2017,4,10388,152,3273,559,1,11,14384
7/10/2017,5,10319,150,3370,750,1,14,14604
7/10/2017,6,10556,158,3715,847,1,21,15298
7/10/2017,7,11344,331,3826,702,26,27,16256
7/10/2017,8,11678,420,3883,491,96,27,16595
7/10/2017,9,11680,498,3831,475,160,28,16672
7/10/2017,10,11673,546,4169,525,194,32,17139
7/10/2017,11,11671,736,4720,808,151,30,18116
7/10/2017,12,11669,801,4904,953,176,48,18551
7/10/2017,13,11667,1028,4928,916,159,34,18732
7/10/2017,14,11666,1473,4723,765,151,46,18824
7/10/2017,15,11650,1731,4589,292,79,87,18428
7/10/2017,16,11649,1839,4574,156,47,180,18445
7/10/2017,17,11640,1853,4794,262,121,205,18875
7/10/2017,18,11637,1852,4835,299,69,206,18898
7/10/2017,19,11648,1855,5011,291,27,206,19038
7/10/2017,20,11647,1651,4905,240,5,210,18658
7/10/2017,21,11683,892,5225,317,0,210,18327
7/10/2017,22,11686,367,5063,370,0,181,17667
7/10/2017,23,11711,285,4432,409,0,81,16918
7/10/2017,24,11721,285,3441,319,0,24,15790
7/11/2017,1,11353,285,3345,391,0,13,15387
7/11/2017,2,11026,286,3361,240,0,13,14926
7/11/2017,3,10877,288,3323,334,0,12,14834
7/11/2017,4,10880,287,3386,193,0,12,14758
7/11/2017,5,11046,288,3640,138,0,14,15126
7/11/2017,6,11401,290,3530,147,9,24,15401
7/11/2017,7,11711,291,4053,91,28,59,16233
7/11/2017,8,11711,403,4247,39,53,84,16537
7/11/2017,9,11718,736,4683,18,120,79,17354
7/11/2017,10,11708,1158,4825,9,201,75,17976
7/11/2017,11,11705,1675,4675,28,196,84,18363
7/11/2017,12,11704,1816,4736,35,254,119,18664
7/11/2017,13,11696,1876,5022,89,237,130,19050
7/11/2017,14,11698,2003,5226,244,274,124,19569
7/11/2017,15,11704,2019,5002,339,265,127,19456
7/11/2017,16,11718,2456,5498,191,227,129,20219
7/11/2017,17,11715,2694,5484,131,168,187,20379
7/11/2017,18,11708,2617,5554,163,98,236,20376
7/11/2017,19,11715,2476,5455,84,46,228,20004
7/11/2017,20,11709,2289,5656,86,28,212,19980
7/11/2017,21,11709,2213,5589,137,3,210,19861
7/11/2017,22,11712,1642,5343,170,0,183,19050
7/11/2017,23,11713,510,4940,207,0,82,17452
7/11/2017,24,11711,286,4217,277,0,27,16518
7/12/2017,1,11703,285,3760,406,0,14,16168
7/12/2017,2,11696,286,3197,398,0,14,15591
7/12/2017,3,11689,303,3060,287,0,14,15353
7/12/2017,4,11690,327,3121,253,0,14,15405
7/12/2017,5,11710,392,3208,194,0,19,15523
7/12/2017,6,11720,436,3678,423,2,27,16286
7/12/2017,7,11723,444,4139,524,20,53,16903
7/12/2017,8,11703,535,4645,792,61,78,17814
7/12/2017,9,11692,715,4915,637,120,76,18155
7/12/2017,10,11685,1094,5140,577,161,78,18735
7/12/2017,11,11683,1677,5209,713,164,76,19522
7/12/2017,12,11681,1804,5213,941,113,126,19878
7/12/2017,13,11673,1849,4769,1376,136,186,19989
7/12/2017,14,11657,1767,4477,1407,122,212,19642
7/12/2017,15,11632,1759,4771,1274,130,222,19788
7/12/2017,16,11628,1762,4827,1318,137,223,19895
7/12/2017,17,11645,1439,5324,1223,87,224,19942
7/12/2017,18,11660,1389,5215,1401,56,224,19945
7/12/2017,19,11666,1043,5451,1142,34,208,19544
7/12/2017,20,11668,1185,5544,973,19,207,19596
7/12/2017,21,11668,988,5411,1112,2,184,19365
7/12/2017,22,11692,428,4626,1197,0,111,18054
7/12/2017,23,11692,235,4030,980,0,32,16969
7/12/2017,24,11680,238,3591,643,0,14,16166
7/13/2017,1,11552,239,3485,528,0,13,15817
7/13/2017,2,11112,238,3197,570,0,12,15129
7/13/2017,3,11103,238,3093,681,0,12,15127
7/13/2017,4,11098,238,3265,623,0,12,15236
7/13/2017,5,11107,238,3241,1060,0,15,15661
7/13/2017,6,11294,239,3428,919,6,22,15908
7/13/2017,7,11659,242,3515,802,17,37,16272
7/13/2017,8,11649,240,3994,743,30,67,16723
7/13/2017,9,11645,265,4116,886,39,77,17028
7/13/2017,10,11646,303,4459,827,55,75,17365
7/13/2017,11,11645,407,4233,555,103,75,17018
7/13/2017,12,11647,643,4372,764,115,114,17655
7/13/2017,13,11643,935,4405,620,121,161,17885
7/13/2017,14,11644,1067,4413,498,136,162,17920
7/13/2017,15,11641,1068,4535,396,137,161,17938
7/13/2017,16,11644,1070,4611,284,48,202,17859
7/13/2017,17,11638,1073,4606,215,22,224,17778
7/13/2017,18,11628,1075,4690,168,14,221,17796
7/13/2017,19,11628,738,4643,317,12,221,17559
7/13/2017,20,11625,447,4687,570,5,198,17532
7/13/2017,21,11612,285,4716,595,0,105,17313
7/13/2017,22,11623,286,4413,584,0,48,16954
7/13/2017,23,11635,285,3832,557,0,18,16327
7/13/2017,24,11447,287,3218,518,0,14,15484
7/14/2017,1,11068,286,3242,646,0,11,15253
7/14/2017,2,10794,287,3263,469,0,11,14824
7/14/2017,3,10780,288,3162,394,0,11,14635
7/14/2017,4,10785,288,3294,319,0,12,14698
7/14/2017,5,10785,288,3641,339,0,29,15082
7/14/2017,6,10790,287,3921,361,0,25,15384
7/14/2017,7,11077,286,4406,306,15,27,16117
7/14/2017,8,11512,285,4310,263,32,26,16428
7/14/2017,9,11626,286,4365,271,65,26,16639
7/14/2017,10,11623,284,4529,441,101,27,17005
7/14/2017,11,11525,288,4587,565,109,27,17101
7/14/2017,12,11375,293,4460,451,134,26,16739
7/14/2017,13,11411,305,4353,428,161,27,16685
7/14/2017,14,11616,329,4356,839,166,26,17332
7/14/2017,15,11605,332,4640,933,172,27,17709
7/14/2017,16,11600,330,4553,1051,119,26,17679
7/14/2017,17,11596,329,4847,977,73,27,17849
7/14/2017,18,11599,328,4833,905,50,27,17742
7/14/2017,19,11599,327,4713,828,26,26,17519
7/14/2017,20,11594,331,4608,792,3,27,17355
7/14/2017,21,11580,334,4515,794,0,26,17249
7/14/2017,22,11588,334,4501,562,0,27,17012
7/14/2017,23,11594,239,3967,568,0,17,16385
7/14/2017,24,11405,208,3296,403,0,7,15319
7/15/2017,1,11155,221,3303,450,0,0,15129
7/15/2017,2,10937,221,3091,399,0,0,14648
7/15/2017,3,10567,233,3104,361,0,0,14265
7/15/2017,4,10490,300,3073,271,0,0,14134
7/15/2017,5,10493,450,3115,146,0,0,14204
7/15/2017,6,10496,218,3238,331,2,0,14285
7/15/2017,7,10500,199,3781,310,29,0,14819
7/15/2017,8,10950,198,3761,294,71,0,15274
7/15/2017,9,11609,198,3560,171,120,0,15658
7/15/2017,10,11663,197,3644,155,206,0,15865
7/15/2017,11,11674,196,4199,223,211,0,16503
7/15/2017,12,11672,196,4519,307,223,0,16917
7/15/2017,13,11684,195,4782,373,187,0,17221
7/15/2017,14,11644,197,4282,424,198,0,16745
7/15/2017,15,11688,197,4225,574,223,0,16907
7/15/2017,16,11694,197,4321,575,202,0,16989
7/15/2017,17,11681,196,4551,796,160,0,17384
7/15/2017,18,11657,197,4802,825,80,0,17561
7/15/2017,19,11646,199,5058,676,25,0,17604
7/15/2017,20,11629,224,4778,596,3,0,17230
7/15/2017,21,11625,225,4444,695,0,0,16989
7/15/2017,22,11638,220,4115,876,0,0,16849
7/15/2017,23,11648,198,3381,994,0,0,16221
7/15/2017,24,11581,199,3099,563,0,0,15442
7/16/2017,1,11178,199,3091,471,0,0,14939
7/16/2017,2,10768,201,3037,524,0,0,14530
7/16/2017,3,10319,201,3016,636,0,0,14172
7/16/2017,4,10230,200,3075,444,0,0,13949
7/16/2017,5,10226,200,3214,404,0,2,14046
7/16/2017,6,10225,200,3333,308,5,1,14072
7/16/2017,7,10237,200,3544,330,31,4,14346
7/16/2017,8,10732,199,4004,312,98,8,15353
7/16/2017,9,11499,199,3771,255,111,1,15836
7/16/2017,10,11641,199,4038,482,165,5,16530
7/16/2017,11,11647,199,4413,534,224,1,17018
7/16/2017,12,11648,198,4309,575,204,0,16934
7/16/2017,13,11656,198,4134,677,165,0,16830
7/16/2017,14,11680,198,4201,905,167,0,17151
7/16/2017,15,11704,197,4281,907,78,0,17167
7/16/2017,16,11730,197,4422,836,73,17,17275
7/16/2017,17,11736,197,4442,856,62,45,17338
7/16/2017,18,11740,198,4122,881,62,49,17052
7/16/2017,19,11735,197,4216,1050,25,49,17272
7/16/2017,20,11728,199,3972,1154,8,49,17110
7/16/2017,21,11349,220,4383,1031,4,49,17036
7/16/2017,22,10947,227,4745,708,1,23,16651
7/16/2017,23,10950,204,3846,503,0,0,15503
7/16/2017,24,10955,206,3596,436,0,0,15193
7/17/2017,1,10944,264,3228,394,0,1,14831
7/17/2017,2,10878,333,3217,317,0,22,14767
7/17/2017,3,10701,361,3315,334,0,32,14743
7/17/2017,4,10698,452,3280,376,0,23,14829
7/17/2017,5,10696,544,3252,210,0,21,14723
7/17/2017,6,10833,679,3728,265,0,24,15529
7/17/2017,7,10946,977,3914,305,11,37,16190
7/17/2017,8,10944,1086,3813,284,70,36,16233
7/17/2017,9,10938,1197,3944,183,114,28,16404
7/17/2017,10,10936,1343,4645,130,174,47,17275
7/17/2017,11,10933,1350,4897,128,191,87,17586
7/17/2017,12,10925,1480,4899,207,206,144,17861
7/17/2017,13,10911,2010,4821,358,206,126,18432
7/17/2017,14,10924,2199,4802,383,246,79,18633
7/17/2017,15,10915,2317,4879,301,246,107,18765
7/17/2017,16,10907,2460,5021,274,239,189,19090
7/17/2017,17,10907,2778,5176,248,171,193,19473
7/17/2017,18,10904,2927,5185,241,110,193,19560
7/17/2017,19,10903,2822,5358,237,49,193,19562
7/17/2017,20,10901,2782,5399,218,29,199,19528
7/17/2017,21,10898,2402,5312,166,25,202,19005
7/17/2017,22,10904,1943,4552,178,25,174,17776
7/17/2017,23,10915,897,3894,204,25,77,16012
7/17/2017,24,10925,344,3657,234,25,31,15216
7/18/2017,1,10930,284,3352,259,25,15,14865
7/18/2017,2,10934,289,3385,246,25,13,14892
7/18/2017,3,10943,309,3050,229,25,13,14569
7/18/2017,4,10940,391,2889,129,25,13,14387
7/18/2017,5,10956,497,3102,181,25,17,14778
7/18/2017,6,10950,603,3778,109,27,22,15489
7/18/2017,7,10949,933,4054,114,56,34,16140
7/18/2017,8,10960,1389,3932,94,127,65,16567
7/18/2017,9,10961,1525,4221,79,193,120,17099
7/18/2017,10,10953,1608,4363,62,226,198,17410
7/18/2017,11,10950,1965,4494,71,233,197,17910
7/18/2017,12,10952,2192,4471,117,243,212,18187
7/18/2017,13,10940,2443,4440,199,281,215,18518
7/18/2017,14,10929,2537,4445,229,282,216,18638
7/18/2017,15,10915,2686,4749,233,276,223,19082
7/18/2017,16,10904,2949,4956,274,238,230,19551
7/18/2017,17,10871,2986,5191,336,177,200,19761
7/18/2017,18,10863,3222,5386,379,99,183,20132
7/18/2017,19,10874,3218,5546,379,34,176,20227
7/18/2017,20,10887,3022,5488,448,16,185,20046
7/18/2017,21,10885,2581,5516,576,12,195,19765
7/18/2017,22,10905,1629,5187,724,12,176,18633
7/18/2017,23,10911,893,4329,857,12,83,17085
7/18/2017,24,10922,357,3398,884,12,64,15637
7/19/2017,1,10936,274,3205,488,12,65,14980
7/19/2017,2,10950,284,3060,577,12,63,14946
7/19/2017,3,10945,361,3124,310,12,62,14814
7/19/2017,4,10911,630,3028,161,12,63,14805
7/19/2017,5,10668,993,3112,245,12,65,15095
7/19/2017,6,10644,1312,3449,389,13,71,15878
7/19/2017,7,10764,1516,3771,494,39,78,16662
7/19/2017,8,10872,1587,3936,263,106,123,16887
7/19/2017,9,10871,1644,4253,142,147,124,17181
7/19/2017,10,10871,1919,4702,183,204,99,17978
7/19/2017,11,10870,2568,4790,187,236,112,18763
7/19/2017,12,10872,2851,4752,218,198,81,18972
7/19/2017,13,10873,2902,4666,328,237,78,19084
7/19/2017,14,10874,2908,4735,469,226,89,19301
7/19/2017,15,10872,2646,4852,655,225,95,19345
7/19/2017,16,10863,2617,4799,627,212,98,19216
7/19/2017,17,10863,2713,5034,784,171,100,19665
7/19/2017,18,10871,2650,5202,666,90,102,19581
7/19/2017,19,10872,3167,5377,364,38,100,19918
7/19/2017,20,10877,3056,5262,250,17,99,19561
7/19/2017,21,10882,2915,5296,263,12,92,19460
7/19/2017,22,10889,2305,4817,225,12,82,18330
7/19/2017,23,10894,1530,4476,178,12,38,17128
7/19/2017,24,10895,909,3821,240,12,17,15894
7/20/2017,1,10902,366,3312,249,12,15,14856
7/20/2017,2,10891,274,3060,196,12,14,14447
7/20/2017,3,10897,274,3020,143,1,14,14349
7/20/2017,4,10903,282,3115,171,0,13,14484
7/20/2017,5,10913,298,3189,213,0,16,14629
7/20/2017,6,10919,467,3493,255,2,23,15159
7/20/2017,7,10912,799,3546,280,21,27,15585
7/20/2017,8,10898,1079,3582,813,94,27,16493
7/20/2017,9,10759,1222,4077,1025,113,27,17223
7/20/2017,10,10725,1375,4258,1323,127,28,17836
7/20/2017,11,10735,1541,3912,1409,110,27,17734
7/20/2017,12,10865,1667,3984,1000,136,27,17679
7/20/2017,13,10914,1697,4503,848,119,27,18108
7/20/2017,14,10923,1652,4471,618,157,27,17848
7/20/2017,15,10924,1744,4722,453,193,26,18062
7/20/2017,16,10934,1888,4751,480,208,26,18287
7/20/2017,17,10927,2093,5249,454,175,26,18924
7/20/2017,18,10915,2283,5625,353,99,27,19302
7/20/2017,19,10907,2155,5632,301,34,27,19056
7/20/2017,20,10899,2147,5147,328,11,27,18559
7/20/2017,21,10902,1874,5073,370,2,27,18248
7/20/2017,22,10914,1585,4425,447,0,27,17398
7/20/2017,23,10912,875,4054,491,0,18,16350
7/20/2017,24,10913,358,3793,454,0,14,15532
7/21/2017,1,10912,270,3274,416,0,12,14884
7/21/2017,2,10925,266,3102,400,0,12,14705
7/21/2017,3,10920,267,3069,362,0,12,14630
7/21/2017,4,10924,281,3014,146,0,12,14377
7/21/2017,5,10930,458,3057,262,0,16,14723
7/21/2017,6,10951,775,3366,188,5,22,15307
7/21/2017,7,10953,1049,3806,192,27,26,16053
7/21/2017,8,10934,1127,4157,193,90,26,16527
7/21/2017,9,10935,1306,4878,214,186,26,17545
7/21/2017,10,10950,1725,5060,220,224,26,18205
7/21/2017,11,10836,2012,5033,166,272,26,18345
7/21/2017,12,10885,2054,5039,228,291,26,18523
7/21/2017,13,10945,2122,5078,304,310,26,18785
7/21/2017,14,10952,2323,5377,339,294,26,19311
7/21/2017,15,10956,2339,5440,339,285,30,19389
7/21/2017,16,10980,2589,5453,301,233,51,19607
7/21/2017,17,10992,2840,5676,253,160,55,19976
7/21/2017,18,10997,2462,5690,264,107,55,19575
7/21/2017,19,11010,2457,5651,216,61,54,19449
7/21/2017,20,11011,2395,5284,155,12,33,18890
7/21/2017,21,11007,2547,5019,168,2,27,18770
7/21/2017,22,10994,2089,4520,152,0,28,17783
7/21/2017,23,10999,1333,4235,134,0,19,16720
7/21/2017,24,10996,473,3775,140,0,9,15393
7/22/2017,1,10999,216,3521,202,0,0,14938
7/22/2017,2,11010,215,3182,338,0,0,14745
7/22/2017,3,10996,214,2843,357,0,0,14410
7/22/2017,4,10962,213,2851,449,0,0,14475
7/22/2017,5,10968,213,2797,345,0,0,14323
7/22/2017,6,10975,208,2925,463,5,0,14576
7/22/2017,7,10973,180,3123,240,10,0,14526
7/22/2017,8,10971,186,3399,388,46,0,14990
7/22/2017,9,10979,195,3913,435,77,0,15599
7/22/2017,10,11011,276,4353,308,104,0,16052
7/22/2017,11,11021,426,4832,266,126,0,16671
7/22/2017,12,11007,560,4559,277,159,0,16562
7/22/2017,13,11003,445,4582,307,182,0,16519
7/22/2017,14,10998,492,4657,374,139,0,16660
7/22/2017,15,10989,614,4590,419,105,0,16717
7/22/2017,16,10977,832,4684,553,111,0,17157
7/22/2017,17,10979,925,4501,534,105,0,17044
7/22/2017,18,10984,982,4758,429,82,0,17235
7/22/2017,19,10983,999,4651,500,24,0,17157
7/22/2017,20,10965,851,4685,586,5,0,17092
7/22/2017,21,10945,765,4671,601,0,0,16982
7/22/2017,22,10963,600,4113,651,0,0,16327
7/22/2017,23,10987,433,3314,549,0,0,15283
7/22/2017,24,11001,255,3040,513,0,0,14809
7/23/2017,1,11011,213,2895,473,0,1,14593
7/23/2017,2,11025,213,2875,444,0,0,14557
7/23/2017,3,10891,213,2709,461,0,0,14274
7/23/2017,4,10777,211,2759,453,0,0,14200
7/23/2017,5,10778,208,2764,446,0,0,14196
7/23/2017,6,10767,211,2935,404,0,0,14317
7/23/2017,7,10753,211,3283,301,16,0,14564
7/23/2017,8,10922,211,3558,313,76,0,15080
7/23/2017,9,10945,211,3575,292,94,0,15117
7/23/2017,10,10926,223,3964,312,156,0,15581
7/23/2017,11,10922,325,4195,351,221,0,16014
7/23/2017,12,10921,353,4393,331,197,14,16209
7/23/2017,13,10907,401,4574,283,174,12,16351
7/23/2017,14,10897,407,4844,313,148,0,16609
7/23/2017,15,10828,468,4836,367,134,0,16633
7/23/2017,16,10855,439,4857,416,120,0,16687
7/23/2017,17,10846,489,5227,360,89,0,17011
7/23/2017,18,10845,550,5171,422,67,0,17055
7/23/2017,19,10830,664,4703,458,24,0,16679
7/23/2017,20,10840,662,4434,754,3,0,16693
7/23/2017,21,10856,659,4437,492,0,0,16444
7/23/2017,22,10854,240,4151,501,0,0,15746
7/23/2017,23,10845,219,3585,398,0,0,15047
7/23/2017,24,10846,219,2817,354,0,6,14242
7/24/2017,1,10845,218,2794,360,0,12,14229
7/24/2017,2,10848,218,2836,483,0,12,14397
7/24/2017,3,10835,218,2603,648,0,12,14316
7/24/2017,4,10815,219,2634,556,0,13,14237
7/24/2017,5,10796,219,2680,519,0,16,14230
7/24/2017,6,10800,227,2783,654,0,24,14488
7/24/2017,7,10800,271,3111,1242,10,26,15460
7/24/2017,8,10803,268,3593,1879,43,26,16612
7/24/2017,9,10808,268,4097,1854,58,26,17111
7/24/2017,10,10832,268,4261,1899,73,26,17359
7/24/2017,11,10864,266,4082,1954,60,26,17252
7/24/2017,12,10882,266,4026,2004,47,27,17252
7/24/2017,13,10885,265,4284,2119,62,27,17642
7/24/2017,14,10892,294,4193,2070,80,26,17555
7/24/2017,15,10898,291,4134,1775,97,26,17221
7/24/2017,16,10916,291,4281,1311,75,26,16900
7/24/2017,17,10929,292,4424,1362,50,26,17083
7/24/2017,18,10938,295,4172,1893,19,26,17343
7/24/2017,19,10935,292,4165,1506,8,27,16933
7/24/2017,20,10942,300,4133,1496,1,26,16898
7/24/2017,21,10941,307,4245,1358,0,27,16878
7/24/2017,22,10945,279,3492,1239,0,27,15982
7/24/2017,23,10948,270,3058,1085,0,20,15381
7/24/2017,24,10952,272,2687,757,0,14,14682
7/25/2017,1,10952,273,2706,438,0,12,14381
7/25/2017,2,10949,273,2631,387,0,11,14251
7/25/2017,3,10945,272,2651,349,0,12,14229
7/25/2017,4,10924,273,2699,317,0,12,14225
7/25/2017,5,10700,273,2811,391,0,15,14190
7/25/2017,6,10699,302,3220,690,0,27,14938
7/25/2017,7,10865,303,3579,653,9,29,15438
7/25/2017,8,10939,375,3538,478,54,35,15419
7/25/2017,9,10937,560,3543,481,114,32,15667
7/25/2017,10,10935,614,3637,477,177,29,15869
7/25/2017,11,10929,668,3956,384,214,28,16179
7/25/2017,12,10934,707,4195,356,255,30,16477
7/25/2017,13,10937,823,4518,338,289,33,16938
7/25/2017,14,10946,978,4295,379,269,31,16898
7/25/2017,15,10946,1006,4394,413,251,30,17040
7/25/2017,16,10946,987,4819,379,250,27,17408
7/25/2017,17,10942,996,4982,316,182,27,17445
7/25/2017,18,10941,1018,5192,248,127,27,17553
7/25/2017,19,10935,742,5224,225,44,27,17197
7/25/2017,20,10926,566,5156,203,10,27,16888
7/25/2017,21,10914,476,5088,285,0,27,16790
7/25/2017,22,10916,323,4319,513,0,27,16098
7/25/2017,23,10917,263,3369,720,0,17,15286
7/25/2017,24,10916,262,2673,580,0,12,14443
7/26/2017,1,10929,261,2598,513,0,11,14312
7/26/2017,2,10931,261,2649,524,0,11,14376
7/26/2017,3,10931,261,2646,454,0,12,14304
7/26/2017,4,10939,259,2665,383,0,12,14258
7/26/2017,5,10956,269,2636,564,0,17,14442
7/26/2017,6,10967,290,2943,794,5,25,15024
7/26/2017,7,10968,333,3485,742,32,26,15586
7/26/2017,8,10966,419,4061,581,79,26,16132
7/26/2017,9,10951,586,4099,426,132,26,16220
7/26/2017,10,10946,600,4347,395,147,26,16461
7/26/2017,11,10915,682,4208,600,160,26,16591
7/26/2017,12,10901,873,4093,773,178,26,16844
7/26/2017,13,10902,1055,4343,871,185,26,17382
7/26/2017,14,10900,1224,4115,825,202,25,17291
7/26/2017,15,10901,1252,4149,821,170,26,17319
7/26/2017,16,10899,1392,4349,800,86,29,17555
7/26/2017,17,10916,1385,5027,421,63,29,17841
7/26/2017,18,10930,1041,5108,473,39,27,17618
7/26/2017,19,10937,923,4980,573,19,27,17459
7/26/2017,20,10949,784,4924,595,6,27,17285
7/26/2017,21,10931,734,4789,626,4,27,17111
7/26/2017,22,10923,372,3924,700,4,27,15950
7/26/2017,23,10899,268,3401,725,4,18,15315
7/26/2017,24,10896,271,3187,618,4,15,14991
7/27/2017,1,10889,271,2935,563,4,14,14676
7/27/2017,2,10893,272,2679,566,4,14,14428
7/27/2017,3,10890,273,2652,318,4,14,14151
7/27/2017,4,10893,282,2770,315,4,15,14279
7/27/2017,5,10905,382,2881,215,4,17,14404
7/27/2017,6,10924,476,3005,227,4,25,14661
7/27/2017,7,10933,582,3679,195,9,26,15424
7/27/2017,8,10941,664,4235,111,46,27,16024
7/27/2017,9,10968,767,4215,51,127,27,16155
7/27/2017,10,10975,958,4092,47,180,45,16297
7/27/2017,11,11005,1335,3995,39,203,66,16643
7/27/2017,12,11031,1578,4505,53,208,75,17450
7/27/2017,13,11027,1752,4653,166,231,76,17905
7/27/2017,14,11000,1862,4548,251,205,76,17942
7/27/2017,15,10972,2011,4521,272,243,75,18094
7/27/2017,16,10970,2037,4968,364,180,76,18595
7/27/2017,17,10990,1974,4940,499,160,75,18638
7/27/2017,18,11008,1961,4999,622,79,76,18745
7/27/2017,19,11023,1808,5063,686,23,75,18678
7/27/2017,20,11025,1659,4984,659,6,75,18408
7/27/2017,21,11029,1641,4980,769,4,77,18500
7/27/2017,22,11030,1426,4221,834,4,83,17598
7/27/2017,23,11047,549,3535,866,4,42,16043
7/27/2017,24,11054,354,3140,611,4,16,15179
7/28/2017,1,11057,356,2869,453,4,15,14754
7/28/2017,2,11074,356,2669,336,4,14,14453
7/28/2017,3,10944,358,2617,518,4,16,14457
7/28/2017,4,10851,359,2616,470,4,17,14317
7/28/2017,5,10846,370,2662,535,4,25,14442
7/28/2017,6,10845,423,2686,1178,8,32,15172
7/28/2017,7,11066,504,3132,1144,32,47,15925
7/28/2017,8,11069,568,3317,993,70,51,16068
7/28/2017,9,10908,567,3634,1026,135,53,16323
7/28/2017,10,10850,565,3972,1058,177,53,16675
7/28/2017,11,10851,565,4340,1059,204,54,17073
7/28/2017,12,10918,562,4414,913,264,44,17115
7/28/2017,13,11071,561,4749,916,264,46,17607
7/28/2017,14,11199,560,4347,1109,250,35,17500
7/28/2017,15,11257,532,4095,1260,228,34,17406
7/28/2017,16,11217,529,4136,1250,225,37,17394
7/28/2017,17,11204,526,4230,1208,190,31,17389
7/28/2017,18,11210,362,4236,1492,110,29,17439
7/28/2017,19,11213,320,4329,1610,55,27,17554
7/28/2017,20,11208,323,4166,1313,38,27,17075
7/28/2017,21,11206,325,4619,1312,34,26,17522
7/28/2017,22,11203,327,3831,1407,34,27,16829
7/28/2017,23,11224,251,3031,1047,5,17,15575
7/28/2017,24,10974,246,2721,641,0,4,14586
7/29/2017,1,10338,246,2699,1145,0,0,14428
7/29/2017,2,10293,247,2727,701,0,0,13968
7/29/2017,3,10436,247,2603,496,0,0,13782
7/29/2017,4,10442,247,2598,388,0,0,13675
7/29/2017,5,10440,246,2599,386,0,0,13671
7/29/2017,6,10449,244,2576,572,2,0,13843
7/29/2017,7,10602,245,2775,710,45,0,14377
7/29/2017,8,10973,244,3159,562,111,0,15049
7/29/2017,9,11336,242,3324,445,195,0,15542
7/29/2017,10,11588,239,3441,548,263,0,16079
7/29/2017,11,11588,237,3580,670,295,0,16370
7/29/2017,12,11583,239,3537,489,276,0,16124
7/29/2017,13,11581,239,3373,508,293,0,15994
7/29/2017,14,11587,239,3450,793,328,0,16397
7/29/2017,15,11628,239,3583,952,319,0,16721
7/29/2017,16,11690,240,4006,966,249,0,17151
7/29/2017,17,11672,238,4467,1024,172,0,17573
7/29/2017,18,11670,250,4993,921,85,0,17919
7/29/2017,19,11675,261,5432,715,20,0,18103
7/29/2017,20,11679,262,4770,669,3,0,17383
7/29/2017,21,11688,263,4004,730,0,0,16685
7/29/2017,22,11696,263,3561,760,0,2,16282
7/29/2017,23,11718,253,3112,752,0,20,15855
7/29/2017,24,11534,244,2633,612,0,43,15066
7/30/2017,1,11428,245,2637,388,0,55,14753
7/30/2017,2,10894,244,2681,301,0,56,14176
7/30/2017,3,10416,243,2621,557,0,56,13893
7/30/2017,4,10295,243,2640,490,0,56,13724
7/30/2017,5,10304,243,2648,376,0,56,13627
7/30/2017,6,10315,243,2592,415,1,56,13622
7/30/2017,7,10309,245,2808,709,29,56,14156
7/30/2017,8,10522,265,3802,336,106,56,15087
7/30/2017,9,10897,319,3929,222,173,56,15596
7/30/2017,10,11193,304,3706,211,224,56,15694
7/30/2017,11,11462,385,3784,192,254,56,16133
7/30/2017,12,11746,452,3609,246,262,56,16371
7/30/2017,13,11742,588,3911,267,244,56,16808
7/30/2017,14,11690,781,3875,257,211,56,16870
7/30/2017,15,11726,915,4377,264,180,76,17538
7/30/2017,16,11717,1086,4642,324,216,58,18043
7/30/2017,17,11713,1112,5323,301,124,56,18629
7/30/2017,18,11731,1089,5164,298,97,56,18435
7/30/2017,19,11739,1091,5158,300,43,56,18387
7/30/2017,20,11747,1092,4970,329,19,56,18213
7/30/2017,21,11738,1094,4877,385,16,56,18166
7/30/2017,22,11725,1094,4081,431,2,56,17389
7/30/2017,23,11728,749,3309,319,0,56,16161
7/30/2017,24,11665,645,2766,279,0,56,15411
7/31/2017,1,11489,647,2635,470,0,39,15280
7/31/2017,2,11319,650,2560,222,0,15,14766
7/31/2017,3,10898,649,2689,432,0,14,14682
7/31/2017,4,10916,648,2622,394,0,15,14595
7/31/2017,5,10923,650,2604,440,0,17,14634
7/31/2017,6,11099,672,2830,523,0,22,15146
7/31/2017,7,11650,857,3124,340,29,27,16027
7/31/2017,8,11772,1063,3320,95,96,27,16373
7/31/2017,9,11760,1297,3641,51,173,27,16949
7/31/2017,10,11751,1333,4158,65,263,27,17597
7/31/2017,11,11741,1527,4514,124,312,27,18245
7/31/2017,12,11728,1640,4874,201,313,27,18783
7/31/2017,13,11731,1933,4993,304,289,27,19277
7/31/2017,14,11754,2291,4816,433,287,29,19610
7/31/2017,15,11765,2245,4721,495,199,43,19468
7/31/2017,16,11788,2517,5061,433,158,96,20053
7/31/2017,17,11789,2552,5097,403,168,101,20110
7/31/2017,18,11786,2626,5144,317,98,100,20071
7/31/2017,19,11780,2706,5054,222,31,100,19893
7/31/2017,20,11775,2596,5103,177,4,98,19753
7/31/2017,21,11781,2764,5047,171,0,86,19849
7/31/2017,22,11779,2010,4664,171,0,82,18706
7/31/2017,23,11784,1015,4010,200,0,77,17086
7/31/2017,24,11777,756,2997,192,0,69,15791
8/1/2017,1,11775,413,2595,278,0,32,15093
8/1/2017,2,11769,330,2513,157,0,15,14784
8/1/2017,3,11750,331,2608,191,0,17,14897
8/1/2017,4,11741,336,2531,64,0,21,14693
8/1/2017,5,11752,349,2711,79,0,50,14941
8/1/2017,6,11771,551,2727,66,2,63,15180
8/1/2017,7,11802,916,3023,97,38,68,15944
8/1/2017,8,11816,1386,3363,65,113,70,16813
8/1/2017,9,11835,1712,4059,11,170,61,17848
8/1/2017,10,11803,2156,4321,32,250,58,18620
8/1/2017,11,11769,2517,4450,109,310,56,19211
8/1/2017,12,11729,2384,4829,189,303,57,19491
8/1/2017,13,11705,2541,4833,285,294,58,19716
8/1/2017,14,11699,2573,5006,391,239,69,19977
8/1/2017,15,11693,2679,4349,569,201,71,19562
8/1/2017,16,11719,2682,4346,403,188,69,19407
8/1/2017,17,11729,2702,4968,253,179,71,19902
8/1/2017,18,11743,2882,5120,265,101,66,20177
8/1/2017,19,11737,2778,5131,201,23,66,19936
8/1/2017,20,11770,2574,5004,235,2,69,19654
8/1/2017,21,11797,2388,4866,333,0,67,19451
8/1/2017,22,11436,2131,4230,421,0,67,18285
8/1/2017,23,10966,1599,3632,685,0,59,16941
8/1/2017,24,10962,736,3091,893,0,50,15732
8/2/2017,1,10992,358,2572,881,0,42,14845
8/2/2017,2,11005,325,2548,836,0,43,14757
8/2/2017,3,11014,327,2612,730,0,42,14725
8/2/2017,4,11020,332,2620,617,0,40,14629
8/2/2017,5,11011,420,2679,320,0,41,14471
8/2/2017,6,10990,622,2820,240,1,36,14709
8/2/2017,7,10964,947,3491,420,26,27,15875
8/2/2017,8,10944,1542,3907,188,83,27,16691
8/2/2017,9,10931,1976,4260,143,172,27,17509
8/2/2017,10,10921,2467,4309,174,227,27,18125
8/2/2017,11,10920,2664,4453,271,262,27,18597
8/2/2017,12,10909,2815,4745,462,269,27,19227
8/2/2017,13,10509,3446,4934,680,300,29,19898
8/2/2017,14,10511,3015,4585,797,310,33,19251
8/2/2017,15,10518,2877,4848,685,293,52,19273
8/2/2017,16,10525,3047,4970,782,238,53,19615
8/2/2017,17,10577,2862,5189,768,145,54,19595
8/2/2017,18,10611,2640,4591,636,57,54,18589
8/2/2017,19,10606,2715,5152,300,28,54,18855
8/2/2017,20,10607,3134,5020,201,5,54,19021
8/2/2017,21,10596,3215,4985,130,0,51,18977
8/2/2017,22,10568,2463,4116,116,0,43,17306
8/2/2017,23,10546,1579,3964,129,0,31,16249
8/2/2017,24,10533,1270,3504,146,0,22,15475
8/3/2017,1,10526,850,3290,163,0,24,14853
8/3/2017,2,10517,518,3049,140,0,15,14239
8/3/2017,3,10516,437,2753,90,0,12,13808
8/3/2017,4,10509,567,2567,104,0,12,13759
8/3/2017,5,10513,848,2587,92,0,19,14059
8/3/2017,6,10521,1326,2848,113,1,26,14835
8/3/2017,7,10523,1552,3220,182,24,43,15544
8/3/2017,8,10521,1765,3268,191,70,29,15844
8/3/2017,9,10580,2102,4017,210,122,26,17057
8/3/2017,10,10634,2270,4334,250,187,26,17701
8/3/2017,11,10642,2575,4703,241,228,26,18415
8/3/2017,12,10618,2714,5102,269,260,26,18989
8/3/2017,13,10580,2775,5325,382,237,32,19331
8/3/2017,14,10193,3502,5145,338,191,39,19408
8/3/2017,15,10524,3410,4963,331,232,38,19498
8/3/2017,16,10518,3316,4649,511,156,45,19195
8/3/2017,17,10513,3493,5230,283,118,51,19688
8/3/2017,18,10517,3488,5147,434,39,50,19675
8/3/2017,19,10520,2987,5000,797,25,43,19372
8/3/2017,20,10529,2844,4296,1094,3,42,18808
8/3/2017,21,10527,2729,4196,1270,0,39,18761
8/3/2017,22,10523,2054,3859,1459,0,30,17925
8/3/2017,23,10498,1479,3679,1141,0,20,16817
8/3/2017,24,10487,552,3256,1422,0,24,15741
8/4/2017,1,10492,372,2650,1754,0,31,15299
8/4/2017,2,10504,368,2490,1392,0,41,14795
8/4/2017,3,10502,365,2842,1319,0,37,15065
8/4/2017,4,10483,365,2574,1323,0,38,14783
8/4/2017,5,10478,365,2674,941,0,42,14500
8/4/2017,6,10451,369,3151,1288,1,47,15307
8/4/2017,7,10429,402,3462,1386,23,58,15760
8/4/2017,8,10435,630,3860,1497,76,56,16554
8/4/2017,9,10460,899,4166,1776,95,56,17452
8/4/2017,10,10419,1279,3919,2488,133,59,18297
8/4/2017,11,10368,1708,4372,2417,131,56,19052
8/4/2017,12,10508,1888,4242,2481,168,54,19341
8/4/2017,13,10505,1873,4448,2679,182,47,19734
8/4/2017,14,10495,1983,4440,2635,210,53,19816
8/4/2017,15,10494,1988,4444,2868,130,53,19977
8/4/2017,16,10500,2008,4384,2845,91,52,19880
8/4/2017,17,10496,1818,4199,2819,52,50,19434
8/4/2017,18,10476,1631,4276,2596,31,47,19057
8/4/2017,19,10472,1609,4025,2593,21,42,18762
8/4/2017,20,10471,676,3950,2700,3,31,17831
8/4/2017,21,10466,399,3762,2906,0,27,17560
8/4/2017,22,10461,387,3518,2889,0,27,17282
8/4/2017,23,10450,225,2912,2803,0,21,16411
8/4/2017,24,10463,196,2520,2412,0,4,15595
8/5/2017,1,10466,197,2402,2004,0,0,15069
8/5/2017,2,10463,196,2401,1515,0,0,14575
8/5/2017,3,10471,195,2412,1202,0,0,14280
8/5/2017,4,10506,196,2441,1002,0,0,14145
8/5/2017,5,10573,196,2445,970,0,0,14184
8/5/2017,6,10596,197,2446,824,0,0,14063
8/5/2017,7,10618,197,2704,856,6,0,14381
8/5/2017,8,10632,197,3152,1283,60,0,15324
8/5/2017,9,10635,156,3106,1862,89,0,15848
8/5/2017,10,10634,146,3070,2090,123,0,16063
8/5/2017,11,10633,148,3071,2272,165,0,16289
8/5/2017,12,10636,172,3111,2186,201,0,16306
8/5/2017,13,10650,201,3264,1832,217,1,16165
8/5/2017,14,10650,199,3464,1554,177,1,16045
8/5/2017,15,10619,198,3588,1485,207,1,16098
8/5/2017,16,10667,196,4044,1216,184,0,16307
8/5/2017,17,10666,196,4270,1278,142,0,16552
8/5/2017,18,10678,195,4822,929,91,0,16715
8/5/2017,19,10683,195,4926,584,28,0,16416
8/5/2017,20,10691,201,4833,364,9,0,16098
8/5/2017,21,10690,202,4714,322,1,0,15929
8/5/2017,22,10697,224,4418,326,0,0,15665
8/5/2017,23,10711,229,3702,326,0,1,14969
8/5/2017,24,10720,202,3194,313,0,0,14429
8/6/2017,1,10725,203,2783,388,0,0,14099
8/6/2017,2,10726,204,2427,449,0,0,13806
8/6/2017,3,10723,202,2428,246,0,0,13599
8/6/2017,4,10723,204,2437,255,0,0,13619
8/6/2017,5,10721,205,2431,239,0,0,13596
8/6/2017,6,10724,204,2463,137,4,0,13532
8/6/2017,7,10719,204,2565,84,5,0,13577
8/6/2017,8,10712,201,2771,134,73,0,13891
8/6/2017,9,10714,202,2961,155,183,0,14215
8/6/2017,10,10719,201,3178,250,234,0,14582
8/6/2017,11,10714,200,3302,471,222,0,14909
8/6/2017,12,10708,200,3498,559,234,0,15199
8/6/2017,13,10709,200,3628,611,247,0,15395
8/6/2017,14,10710,198,3594,717,210,0,15429
8/6/2017,15,10715,199,3878,828,203,0,15823
8/6/2017,16,10732,199,4011,941,155,0,16038
8/6/2017,17,10741,199,4164,864,132,0,16100
8/6/2017,18,10747,199,4077,802,52,0,15877
8/6/2017,19,10745,199,4297,371,23,0,15635
8/6/2017,20,10742,200,4305,343,3,0,15593
8/6/2017,21,10739,202,4361,507,1,0,15810
8/6/2017,22,10738,202,3879,521,0,0,15340
8/6/2017,23,10741,203,3587,392,0,0,14923
8/6/2017,24,10749,203,3004,292,0,0,14248
8/7/2017,1,10750,203,2756,254,0,0,13963
8/7/2017,2,10744,203,2604,172,0,0,13723
8/7/2017,3,10731,204,2601,127,0,0,13663
8/7/2017,4,10724,204,2505,121,0,0,13554
8/7/2017,5,10737,204,2511,115,0,0,13567
8/7/2017,6,10737,204,2681,108,2,3,13735
8/7/2017,7,10738,202,2756,70,20,7,13793
8/7/2017,8,10734,203,3101,22,37,8,14105
8/7/2017,9,10733,202,3170,12,66,13,14196
8/7/2017,10,10729,203,3595,34,113,16,14690
8/7/2017,11,10727,202,4094,45,175,21,15264
8/7/2017,12,10723,331,4529,51,179,17,15830
8/7/2017,13,10725,365,4440,83,168,18,15799
8/7/2017,14,10714,355,4310,261,136,14,15790
8/7/2017,15,10707,541,4069,386,128,14,15845
8/7/2017,16,10701,636,4605,305,129,4,16380
8/7/2017,17,10695,647,4983,292,73,1,16691
8/7/2017,18,10701,679,5211,293,56,0,16940
8/7/2017,19,10700,652,5000,253,44,7,16656
8/7/2017,20,10698,667,4567,290,31,6,16259
8/7/2017,21,10693,716,4321,516,6,0,16252
8/7/2017,22,10689,332,3822,578,1,0,15422
8/7/2017,23,10701,215,3219,597,0,0,14732
8/7/2017,24,10710,216,2789,471,0,0,14186
8/8/2017,1,10713,259,2676,386,0,4,14038
8/8/2017,2,10707,303,2580,282,0,12,13884
8/8/2017,3,10477,341,2594,358,0,12,13782
8/8/2017,4,10453,387,2687,387,0,12,13926
8/8/2017,5,10460,438,2699,303,0,17,13917
8/8/2017,6,10557,472,2587,390,2,24,14032
8/8/2017,7,10720,630,2896,125,22,27,14420
8/8/2017,8,10722,715,3176,145,102,27,14887
8/8/2017,9,10720,702,3596,148,189,27,15382
8/8/2017,10,10722,741,4160,169,252,36,16080
8/8/2017,11,10718,743,4318,223,272,69,16343
8/8/2017,12,10718,996,4205,334,264,81,16598
8/8/2017,13,10721,1185,4157,386,247,93,16789
8/8/2017,14,10710,1214,4168,540,214,97,16943
8/8/2017,15,10696,1286,4169,686,248,102,17187
8/8/2017,16,10689,1125,4687,856,204,92,17653
8/8/2017,17,10697,1052,4901,838,142,92,17722
8/8/2017,18,10687,1054,5201,787,72,85,17886
8/8/2017,19,10701,914,5271,636,18,78,17618
8/8/2017,20,10702,911,5371,687,1,83,17755
8/8/2017,21,10693,712,4927,766,0,83,17181
8/8/2017,22,10693,500,4495,813,0,83,16584
8/8/2017,23,10701,419,3548,930,0,76,15674
8/8/2017,24,10705,386,2842,870,0,72,14875
8/9/2017,1,10709,384,2778,903,0,71,14845
8/9/2017,2,10713,383,2770,785,0,71,14722
8/9/2017,3,10719,385,2689,512,0,71,14376
8/9/2017,4,10725,461,2656,391,0,71,14304
8/9/2017,5,10729,481,2760,290,0,73,14333
8/9/2017,6,10731,662,2825,336,0,79,14633
8/9/2017,7,10731,941,3160,324,23,82,15261
8/9/2017,8,10728,1213,3495,328,112,82,15958
8/9/2017,9,10726,1467,3841,200,199,82,16515
8/9/2017,10,10722,1628,4202,214,215,82,17063
8/9/2017,11,10670,1901,4124,296,248,82,17321
8/9/2017,12,10561,1942,4160,441,298,82,17484
8/9/2017,13,10555,2140,4331,566,282,82,17956
8/9/2017,14,10559,2360,4345,618,298,82,18262
8/9/2017,15,10710,2335,4450,674,266,81,18516
8/9/2017,16,10794,2455,4835,657,249,81,19071
8/9/2017,17,10798,2739,4869,557,170,82,19215
8/9/2017,18,10788,2777,4875,312,80,82,18914
8/9/2017,19,10787,2835,4696,231,22,82,18653
8/9/2017,20,10771,2719,4648,279,1,82,18500
8/9/2017,21,10896,2293,4691,278,0,82,18240
8/9/2017,22,11038,1628,4222,384,0,82,17354
8/9/2017,23,11044,958,3845,488,0,74,16409
8/9/2017,24,11046,493,3073,651,0,69,15332
8/10/2017,1,11043,408,2781,744,0,57,15033
8/10/2017,2,11049,411,2705,732,0,11,14908
8/10/2017,3,11043,413,2556,848,0,10,14870
8/10/2017,4,11046,493,2555,798,0,10,14902
8/10/2017,5,11043,570,2537,388,0,22,14560
8/10/2017,6,11047,598,2741,285,3,29,14703
8/10/2017,7,11091,736,3128,469,33,34,15491
8/10/2017,8,11120,885,3482,274,81,36,15878
8/10/2017,9,11048,1219,4377,141,163,38,16986
8/10/2017,10,11050,1395,4288,137,204,36,17110
8/10/2017,11,11047,1797,4805,141,265,48,18103
8/10/2017,12,11054,1905,4806,140,266,51,18222
8/10/2017,13,10975,2465,4769,163,300,37,18709
8/10/2017,14,10955,2447,4483,195,259,24,18363
8/10/2017,15,10953,2333,4622,249,232,16,18405
8/10/2017,16,10948,2375,4795,212,193,3,18526
8/10/2017,17,10948,2583,5360,256,125,0,19272
8/10/2017,18,10928,2596,4706,330,59,5,18624
8/10/2017,19,10914,2596,4857,454,17,19,18857
8/10/2017,20,10905,2028,5183,610,0,25,18751
8/10/2017,21,10912,1875,4863,871,0,26,18547
8/10/2017,22,10928,1520,4312,928,0,26,17714
8/10/2017,23,10969,1111,3917,985,0,18,17000
8/10/2017,24,10972,467,3407,1141,0,12,15999
8/11/2017,1,10977,392,2756,1171,0,12,15308
8/11/2017,2,10978,403,2619,1330,0,12,15342
8/11/2017,3,10984,403,2637,1207,0,15,15246
8/11/2017,4,10987,401,2669,1134,0,14,15205
8/11/2017,5,10956,402,2781,905,0,17,15061
8/11/2017,6,10977,408,3373,1038,1,25,15822
8/11/2017,7,10980,487,3639,924,25,25,16080
8/11/2017,8,10975,609,4263,850,74,26,16797
8/11/2017,9,10974,1037,4330,773,116,26,17256
8/11/2017,10,10972,1223,4306,897,130,25,17553
8/11/2017,11,10973,1543,4193,1087,166,25,17987
8/11/2017,12,10974,1781,4348,1150,144,25,18422
8/11/2017,13,10969,1838,4302,1175,146,25,18455
8/11/2017,14,10968,1720,4256,1304,149,25,18422
8/11/2017,15,10974,1483,4385,1340,149,25,18356
8/11/2017,16,10974,1764,4760,1258,75,25,18856
8/11/2017,17,10972,1980,4802,1272,79,25,19130
8/11/2017,18,10973,1754,4872,988,67,26,18680
8/11/2017,19,10974,1608,5162,731,22,26,18523
8/11/2017,20,10968,1390,5335,522,0,26,18241
8/11/2017,21,10967,1570,5186,393,0,26,18142
8/11/2017,22,10957,728,4607,457,0,26,16775
8/11/2017,23,10945,393,3845,564,0,24,15771
8/11/2017,24,10942,317,2993,283,0,43,14578
8/12/2017,1,10748,210,3105,286,0,51,14400
8/12/2017,2,10693,242,3140,426,0,51,14552
8/12/2017,3,10701,203,2741,541,0,51,14237
8/12/2017,4,10701,203,2671,628,0,51,14254
8/12/2017,5,10706,205,2741,564,0,51,14267
8/12/2017,6,10736,200,2906,555,1,51,14449
8/12/2017,7,10948,201,2850,490,23,51,14563
8/12/2017,8,10950,200,3229,450,85,51,14965
8/12/2017,9,10945,200,3513,434,158,51,15301
8/12/2017,10,10950,201,4016,518,200,51,15936
8/12/2017,11,10942,200,4142,690,216,51,16241
8/12/2017,12,10928,201,4087,893,215,51,16375
8/12/2017,13,10923,202,4008,1207,267,51,16658
8/12/2017,14,10874,202,3955,1383,259,51,16724
8/12/2017,15,10906,203,3765,1459,245,51,16629
8/12/2017,16,10902,201,4051,1121,185,51,16511
8/12/2017,17,10855,202,4409,1514,87,51,17118
8/12/2017,18,10857,201,4682,1145,72,51,17008
8/12/2017,19,10865,196,4952,809,18,51,16891
8/12/2017,20,10873,201,4720,593,1,51,16439
8/12/2017,21,10878,211,4540,552,0,51,16232
8/12/2017,22,10887,206,3930,566,0,51,15640
8/12/2017,23,10883,203,3038,496,0,51,14671
8/12/2017,24,10874,203,2477,393,0,16,13963
8/13/2017,1,10875,203,2600,308,0,0,13986
8/13/2017,2,10858,204,2640,246,0,0,13948
8/13/2017,3,10631,205,2615,189,0,0,13640
8/13/2017,4,10402,205,2787,295,0,0,13689
8/13/2017,5,10335,206,2996,263,0,0,13800
8/13/2017,6,10368,206,2879,273,1,0,13727
8/13/2017,7,10499,206,3039,252,29,0,14025
8/13/2017,8,10807,203,3065,97,110,0,14282
8/13/2017,9,10914,203,3197,24,187,0,14525
8/13/2017,10,10899,206,3420,9,257,0,14791
8/13/2017,11,10882,206,4201,33,291,0,15613
8/13/2017,12,10873,210,4194,105,289,0,15671
8/13/2017,13,10868,234,4393,184,295,0,15974
8/13/2017,14,10861,302,4442,269,265,0,16139
8/13/2017,15,10866,324,4315,316,257,0,16078
8/13/2017,16,10865,401,4962,296,208,0,16732
8/13/2017,17,10858,490,5187,247,149,4,16935
8/13/2017,18,10866,477,5239,230,71,14,16897
8/13/2017,19,10865,526,5232,193,20,3,16839
8/13/2017,20,10863,498,5011,168,1,0,16541
8/13/2017,21,10865,604,5131,98,0,0,16698
8/13/2017,22,10870,599,4689,129,0,0,16287
8/13/2017,23,10879,434,3632,143,0,1,15089
8/13/2017,24,10876,244,2869,90,0,0,14079
8/14/2017,1,10879,207,2756,77,0,4,13923
8/14/2017,2,10886,239,2815,77,0,14,14031
8/14/2017,3,10883,292,2767,120,0,14,14076
8/14/2017,4,10874,383,2813,119,0,14,14203
8/14/2017,5,10868,470,2911,98,0,16,14363
8/14/2017,6,10877,589,3135,101,3,23,14728
8/14/2017,7,10867,876,3273,99,27,27,15169
8/14/2017,8,10856,1148,3733,118,76,27,15958
8/14/2017,9,10850,1347,3851,74,147,27,16296
8/14/2017,10,10846,1644,3992,55,221,27,16785
8/14/2017,11,10838,1870,3981,35,258,27,17009
8/14/2017,12,10841,1909,4465,74,282,27,17598
8/14/2017,13,10838,2116,4766,74,279,27,18100
8/14/2017,14,10838,2393,4649,101,306,27,18314
8/14/2017,15,10824,2305,5051,107,281,27,18595
8/14/2017,16,10827,2788,5226,72,216,27,19156
8/14/2017,17,10818,2951,5261,77,137,27,19271
8/14/2017,18,10819,2592,5199,101,66,27,18804
8/14/2017,19,10821,2396,5195,125,15,27,18579
8/14/2017,20,10800,2367,5125,200,0,27,18519
8/14/2017,21,10783,1998,4798,336,0,27,17942
8/14/2017,22,10780,1820,4031,452,0,27,17110
8/14/2017,23,10782,977,3286,658,0,22,15725
8/14/2017,24,10799,454,3053,647,0,20,14973
8/15/2017,1,10815,368,2949,525,0,14,14671
8/15/2017,2,10823,372,2922,598,0,14,14729
8/15/2017,3,10834,387,2712,653,0,14,14600
8/15/2017,4,10843,406,2730,434,0,14,14427
8/15/2017,5,10836,523,3005,334,0,19,14717
8/15/2017,6,10834,759,3398,206,2,24,15223
8/15/2017,7,10830,1035,3680,165,23,27,15760
8/15/2017,8,10831,1378,4080,196,84,27,16596
8/15/2017,9,10829,1494,4121,204,150,27,16825
8/15/2017,10,10821,1438,4310,153,200,27,16949
8/15/2017,11,10813,1517,4685,100,222,27,17364
8/15/2017,12,10797,1550,4853,201,206,27,17634
8/15/2017,13,10788,1557,4945,291,199,27,17807
8/15/2017,14,10786,1615,5062,323,223,27,18036
8/15/2017,15,10786,1786,5012,350,211,27,18172
8/15/2017,16,10779,2137,4991,410,146,27,18490
8/15/2017,17,10772,2073,5331,367,108,27,18678
8/15/2017,18,10771,2191,5269,359,59,27,18676
8/15/2017,19,10772,2110,5241,303,17,27,18470
8/15/2017,20,10738,1961,4918,250,0,27,17894
8/15/2017,21,10754,1821,4803,311,0,27,17716
8/15/2017,22,10767,1607,4188,305,0,27,16894
8/15/2017,23,10778,985,3582,285,0,18,15648
8/15/2017,24,10830,831,3116,305,0,14,15096
8/16/2017,1,10841,493,3043,305,0,13,14695
8/16/2017,2,10829,410,3214,326,0,13,14792
8/16/2017,3,10824,414,2811,270,0,13,14332
8/16/2017,4,10844,415,2760,231,0,13,14263
8/16/2017,5,10863,504,2880,335,0,17,14599
8/16/2017,6,10895,692,3015,334,2,25,14963
8/16/2017,7,10885,979,3194,210,10,26,15304
8/16/2017,8,10878,1309,3752,193,88,26,16246
8/16/2017,9,10867,1475,3817,97,170,27,16453
8/16/2017,10,10858,1559,4053,86,255,27,16838
8/16/2017,11,10856,1591,3810,67,283,27,16634
8/16/2017,12,10830,1687,4124,63,195,27,16926
8/16/2017,13,10800,1706,4349,87,289,26,17257
8/16/2017,14,10740,1860,4402,82,283,26,17393
8/16/2017,15,10727,1867,4597,87,214,27,17519
8/16/2017,16,10719,1936,5088,105,196,26,18070
8/16/2017,17,10716,2183,5251,105,147,26,18428
8/16/2017,18,10718,2052,5207,114,86,27,18204
8/16/2017,19,10668,1779,5241,141,17,27,17873
8/16/2017,20,10659,1414,5176,218,0,27,17494
8/16/2017,21,10683,1541,4774,364,0,27,17389
8/16/2017,22,10710,1019,4024,552,0,27,16332
8/16/2017,23,10715,759,3381,672,0,18,15545
8/16/2017,24,10723,438,2999,933,0,16,15109
8/17/2017,1,10795,330,2726,924,0,15,14790
8/17/2017,2,10923,329,2734,777,0,14,14777
8/17/2017,3,10896,329,2712,491,0,13,14441
8/17/2017,4,10909,327,2802,424,0,13,14475
8/17/2017,5,10904,328,2784,733,0,17,14766
8/17/2017,6,10897,329,2945,1000,2,23,15196
8/17/2017,7,10884,329,3267,989,30,26,15525
8/17/2017,8,10870,358,3495,1600,82,26,16431
8/17/2017,9,10868,409,3676,1564,147,26,16690
8/17/2017,10,10875,412,4218,1639,193,26,17363
8/17/2017,11,10876,524,4457,1686,203,26,17772
8/17/2017,12,10870,729,4069,1662,198,26,17554
8/17/2017,13,10854,950,3829,1320,154,26,17133
8/17/2017,14,10845,967,4129,1553,125,26,17645
8/17/2017,15,10842,997,4294,1493,101,11,17738
8/17/2017,16,10841,985,4139,1488,85,0,17538
8/17/2017,17,10837,981,4495,1128,49,0,17490
8/17/2017,18,10833,981,4839,1344,32,0,18029
8/17/2017,19,10827,839,4811,1315,12,0,17804
8/17/2017,20,10807,866,5240,1522,0,19,18454
8/17/2017,21,10809,636,4438,1806,0,25,17714
8/17/2017,22,10821,310,4108,1892,0,27,17158
8/17/2017,23,10826,321,3626,1723,0,18,16514
8/17/2017,24,10866,328,3052,1748,0,14,16008
8/18/2017,1,10932,328,2647,1502,0,13,15422
8/18/2017,2,10937,328,2686,1055,0,15,15021
8/18/2017,3,10932,326,2594,1042,0,11,14905
8/18/2017,4,10932,326,2727,880,0,13,14878
8/18/2017,5,10940,326,2708,1296,0,18,15288
8/18/2017,6,10941,322,2993,1426,0,38,15720
8/18/2017,7,10939,324,3443,1628,7,76,16417
8/18/2017,8,10942,363,4041,2181,63,143,17733
8/18/2017,9,10934,418,3857,2532,126,198,18065
8/18/2017,10,10923,621,3718,2697,165,195,18319
8/18/2017,11,10915,906,3870,2682,188,201,18762
8/18/2017,12,10916,1148,4084,2576,209,202,19135
8/18/2017,13,10902,1132,4201,2602,143,202,19182
8/18/2017,14,10898,1132,4279,2497,174,200,19180
8/18/2017,15,10894,1130,4408,2472,135,198,19237
8/18/2017,16,10898,1131,4650,2247,101,198,19225
8/18/2017,17,10897,1133,4725,1975,81,198,19009
8/18/2017,18,10908,1133,4824,1793,37,199,18894
8/18/2017,19,10914,1131,4554,1709,8,199,18515
8/18/2017,20,10908,802,4417,1693,0,192,18012
8/18/2017,21,10905,401,4671,1384,0,187,17548
8/18/2017,22,10913,308,4342,1207,0,110,16880
8/18/2017,23,10920,308,3406,1091,0,67,15792
8/18/2017,24,10924,308,2913,911,0,63,15119
8/19/2017,1,10919,309,2821,847,0,22,14918
8/19/2017,2,10926,308,2821,667,0,1,14723
8/19/2017,3,10929,308,2674,497,0,2,14410
8/19/2017,4,10940,308,2831,245,0,0,14324
8/19/2017,5,10942,307,2906,334,0,1,14490
8/19/2017,6,10946,307,3244,230,1,26,14754
8/19/2017,7,10752,307,3364,272,9,53,14757
8/19/2017,8,10892,310,3490,725,67,107,15591
8/19/2017,9,10942,308,3877,949,158,175,16409
8/19/2017,10,10946,308,3811,1090,198,176,16529
8/19/2017,11,10945,308,3995,781,194,121,16344
8/19/2017,12,10946,306,3918,1108,199,69,16546
8/19/2017,13,10944,305,3904,1218,216,52,16639
8/19/2017,14,10948,305,3928,1089,189,56,16515
8/19/2017,15,10938,308,4077,909,180,57,16469
8/19/2017,16,10927,312,3997,1021,193,55,16505
8/19/2017,17,10931,314,4491,722,122,58,16638
8/19/2017,18,10937,316,4826,735,63,132,17009
8/19/2017,19,10956,316,4709,426,15,173,16595
8/19/2017,20,10968,316,4726,261,0,173,16444
8/19/2017,21,10966,318,4483,270,0,134,16171
8/19/2017,22,10970,321,4040,301,0,22,15654
8/19/2017,23,10970,322,3720,424,0,0,15436
8/19/2017,24,10858,323,3211,607,0,0,14999
8/20/2017,1,10537,323,2817,677,0,0,14354
8/20/2017,2,10465,323,2797,455,0,0,14040
8/20/2017,3,10314,324,2832,484,0,0,13954
8/20/2017,4,10158,324,2877,554,0,1,13914
8/20/2017,5,10142,323,2893,552,0,14,13924
8/20/2017,6,10133,324,3060,569,0,24,14110
8/20/2017,7,10130,324,3290,310,18,23,14095
8/20/2017,8,10124,335,3641,317,85,26,14528
8/20/2017,9,10486,348,4110,330,193,24,15491
8/20/2017,10,10902,361,3663,188,230,42,15386
8/20/2017,11,10966,418,3911,566,301,72,16234
8/20/2017,12,10970,579,4007,693,296,145,16690
8/20/2017,13,10973,753,4297,885,310,188,17406
8/20/2017,14,10976,869,4372,954,292,175,17638
8/20/2017,15,10931,1005,4380,765,277,130,17488
8/20/2017,16,10966,1122,4648,809,240,141,17926
8/20/2017,17,10935,1174,5526,672,160,150,18617
8/20/2017,18,10918,1517,5653,450,74,177,18789
8/20/2017,19,10923,1008,5628,425,16,114,18114
8/20/2017,20,10950,1099,5583,531,0,50,18213
8/20/2017,21,10982,828,4996,723,0,45,17574
8/20/2017,22,10998,599,4271,791,0,45,16704
8/20/2017,23,10618,508,3741,895,0,17,15779
8/20/2017,24,10598,352,3255,971,0,0,15176
8/21/2017,1,10611,320,2871,805,0,3,14610
8/21/2017,2,10602,322,2900,832,0,13,14669
8/21/2017,3,10593,333,2948,779,0,13,14666
8/21/2017,4,10593,450,2995,656,0,13,14707
8/21/2017,5,10593,679,3066,540,0,13,14891
8/21/2017,6,10603,1033,3527,279,0,22,15464
8/21/2017,7,10608,1393,3902,407,21,26,16357
8/21/2017,8,10617,1668,4323,447,98,26,17179
8/21/2017,9,10623,2400,4179,142,136,26,17506
8/21/2017,10,10642,2815,4403,225,257,26,18368
8/21/2017,11,10658,3172,4615,178,306,26,18955
8/21/2017,12,10646,3158,4377,168,319,33,18701
8/21/2017,13,10629,3304,5006,190,287,35,19451
8/21/2017,14,10603,3374,5223,214,133,53,19600
8/21/2017,15,10609,3274,4701,185,230,55,19054
8/21/2017,16,10605,3224,5289,221,218,56,19613
8/21/2017,17,10595,3372,5673,297,157,55,20149
8/21/2017,18,10585,3486,5417,394,74,54,20010
8/21/2017,19,10584,3320,5398,425,15,51,19793
8/21/2017,20,10571,3286,5400,552,0,52,19861
8/21/2017,21,10568,2936,4889,921,0,49,19363
8/21/2017,22,10566,2177,4258,1221,0,29,18251
8/21/2017,23,10600,1769,3807,1278,0,19,17473
8/21/2017,24,10626,985,3552,1372,0,14,16549
8/22/2017,1,10621,419,3177,1536,0,14,15767
8/22/2017,2,10604,324,2849,1482,0,13,15272
8/22/2017,3,10591,321,2838,1557,0,14,15321
8/22/2017,4,10603,319,2849,1800,0,14,15585
8/22/2017,5,10593,303,2921,1574,0,16,15407
8/22/2017,6,10573,310,3164,1880,0,23,15950
8/22/2017,7,10558,319,3497,2435,4,26,16839
8/22/2017,8,10543,327,4305,2776,30,26,18007
8/22/2017,9,10517,368,4844,2872,66,26,18693
8/22/2017,10,10510,442,4913,2966,131,26,18988
8/22/2017,11,10522,544,5332,2917,89,26,19430
8/22/2017,12,10547,644,5358,2934,99,26,19608
8/22/2017,13,10556,782,4944,3037,153,27,19499
8/22/2017,14,10552,950,4505,3021,171,27,19226
8/22/2017,15,10536,1007,4325,3101,126,27,19122
8/22/2017,16,10549,1067,5032,2956,112,27,19743
8/22/2017,17,10557,1068,5222,2814,80,26,19767
8/22/2017,18,10560,1069,4763,2791,39,26,19248
8/22/2017,19,10561,1074,4454,2421,14,26,18550
8/22/2017,20,10588,1018,4380,2045,0,27,18058
8/22/2017,21,10593,848,4450,1692,0,26,17609
8/22/2017,22,10605,456,3993,1583,0,26,16663
8/22/2017,23,10625,332,3653,1249,0,17,15876
8/22/2017,24,10650,329,3181,1290,0,13,15463
8/23/2017,1,10645,331,2891,1249,0,12,15128
8/23/2017,2,10653,333,2813,837,0,11,14647
8/23/2017,3,10655,334,2876,500,0,12,14377
8/23/2017,4,10658,335,2868,471,0,12,14344
8/23/2017,5,10665,340,2916,780,0,16,14717
8/23/2017,6,10671,389,3048,870,0,22,15000
8/23/2017,7,10670,424,3331,844,22,27,15318
8/23/2017,8,10668,412,3720,1303,101,27,16231
8/23/2017,9,10659,417,3767,1504,178,27,16552
8/23/2017,10,10663,417,3804,1541,237,27,16689
8/23/2017,11,10664,416,4365,1658,229,29,17361
8/23/2017,12,10677,417,4361,1731,233,32,17451
8/23/2017,13,10674,413,4411,1792,170,27,17487
8/23/2017,14,10687,485,4146,1752,195,27,17292
8/23/2017,15,10697,615,4158,1371,208,27,17076
8/23/2017,16,10706,615,4540,1003,178,27,17069
8/23/2017,17,10716,629,5038,995,113,27,17518
8/23/2017,18,10716,599,5058,763,61,27,17224
8/23/2017,19,10718,566,5050,590,11,27,16962
8/23/2017,20,10716,570,5129,545,0,27,16987
8/23/2017,21,10710,557,4895,613,0,27,16802
8/23/2017,22,10717,385,4097,613,0,27,15839
8/23/2017,23,10720,339,3918,409,0,17,15403
8/23/2017,24,10581,338,3590,492,0,14,15015
8/24/2017,1,10426,340,3220,458,0,14,14458
8/24/2017,2,10432,339,3057,366,0,14,14208
8/24/2017,3,10430,336,3206,320,0,14,14306
8/24/2017,4,10432,338,3109,240,0,15,14134
8/24/2017,5,10508,355,3269,218,0,17,14367
8/24/2017,6,10726,365,3776,242,0,21,15130
8/24/2017,7,10729,422,4044,213,22,27,15457
8/24/2017,8,10453,500,4286,138,95,27,15499
8/24/2017,9,9925,540,4797,170,174,27,15633
8/24/2017,10,9925,512,4817,187,227,27,15695
8/24/2017,11,9929,591,5148,268,234,27,16197
8/24/2017,12,9931,631,4762,349,238,27,15938
8/24/2017,13,9931,760,4624,411,238,27,15991
8/24/2017,14,9938,1001,4423,461,224,27,16074
8/24/2017,15,9933,1170,4439,458,166,27,16193
8/24/2017,16,9936,1193,4461,582,134,27,16333
8/24/2017,17,9942,1177,4708,554,103,27,16511
8/24/2017,18,9940,1208,4741,448,41,27,16405
8/24/2017,19,9939,1218,4701,380,10,27,16275
8/24/2017,20,9936,1171,5033,410,0,27,16577
8/24/2017,21,9939,1133,4745,451,0,27,16295
8/24/2017,22,9939,641,4331,443,0,27,15381
8/24/2017,23,9951,536,3671,262,0,19,14439
8/24/2017,24,9958,372,3388,317,0,15,14050
8/25/2017,1,9961,344,3332,372,0,15,14024
8/25/2017,2,9970,344,3228,339,0,14,13895
8/25/2017,3,9966,342,3264,273,0,14,13859
8/25/2017,4,9969,342,3267,180,0,15,13773
8/25/2017,5,9974,342,3424,152,0,17,13909
8/25/2017,6,9991,343,3611,148,1,38,14132
8/25/2017,7,9984,342,3952,154,27,72,14531
8/25/2017,8,9973,342,4330,128,102,79,14954
8/25/2017,9,9948,335,4559,34,190,79,15145
8/25/2017,10,9927,328,4583,54,275,80,15247
8/25/2017,11,9856,326,4713,87,286,80,15348
8/25/2017,12,9777,316,4763,169,282,80,15387
8/25/2017,13,9814,316,4804,232,297,81,15544
8/25/2017,14,9937,315,4543,209,301,80,15385
8/25/2017,15,9938,311,4777,239,237,80,15582
8/25/2017,16,9942,312,5013,271,195,81,15814
8/25/2017,17,9948,314,5300,283,151,82,16078
8/25/2017,18,9959,315,5463,236,63,81,16117
8/25/2017,19,9963,313,5120,170,12,80,15658
8/25/2017,20,9964,318,5573,157,0,80,16092
8/25/2017,21,9956,333,5110,225,0,79,15703
8/25/2017,22,9961,326,4211,217,0,78,14793
8/25/2017,23,9961,258,3420,228,0,33,13900
8/25/2017,24,9963,251,3023,156,0,7,13400
8/26/2017,1,9954,211,3045,284,0,0,13494
8/26/2017,2,9940,203,3145,231,0,0,13519
8/26/2017,3,9936,204,3065,175,0,0,13380
8/26/2017,4,9940,208,2963,124,0,0,13235
8/26/2017,5,9941,208,3092,106,0,0,13347
8/26/2017,6,9937,209,3319,130,1,0,13596
8/26/2017,7,9931,208,3559,37,9,4,13748
8/26/2017,8,9921,208,3876,46,61,34,14146
8/26/2017,9,9927,205,4056,54,183,68,14493
8/26/2017,10,9939,202,3968,51,245,70,14475
8/26/2017,11,9938,201,4049,95,303,74,14660
8/26/2017,12,9943,203,4009,110,282,73,14620
8/26/2017,13,9942,203,4133,92,314,65,14749
8/26/2017,14,9939,201,4249,103,314,59,14865
8/26/2017,15,9931,201,4334,113,289,59,14927
8/26/2017,16,9896,201,4697,178,222,59,15253
8/26/2017,17,9862,202,4780,209,160,62,15275
8/26/2017,18,9859,202,4890,206,71,61,15289
8/26/2017,19,9863,203,4819,177,12,55,15129
8/26/2017,20,9862,203,5059,202,0,55,15381
8/26/2017,21,9865,199,4789,294,0,55,15202
8/26/2017,22,9871,206,4555,427,0,54,15113
8/26/2017,23,9879,170,3878,613,0,14,14554
8/26/2017,24,9877,167,3235,659,0,0,13938
8/27/2017,1,9883,166,2976,515,0,1,13541
8/27/2017,2,9872,168,2991,507,0,0,13538
8/27/2017,3,9874,168,2898,446,0,0,13386
8/27/2017,4,9876,168,2944,313,0,0,13301
8/27/2017,5,9871,167,2985,513,0,0,13536
8/27/2017,6,9881,167,3000,573,1,0,13622
8/27/2017,7,9871,166,3309,124,1,0,13471
8/27/2017,8,9864,166,3521,204,61,0,13816
8/27/2017,9,9858,166,3583,170,155,0,13932
8/27/2017,10,9862,163,3556,228,264,1,14074
8/27/2017,11,9866,163,3859,294,184,14,14380
8/27/2017,12,9866,162,3897,542,288,46,14801
8/27/2017,13,9868,163,4091,499,273,54,14948
8/27/2017,14,9866,163,4411,529,281,55,15305
8/27/2017,15,9905,163,4586,517,271,55,15497
8/27/2017,16,9908,164,4524,595,226,55,15472
8/27/2017,17,9908,163,4886,635,134,55,15781
8/27/2017,18,9906,176,5153,764,55,56,16110
8/27/2017,19,9898,217,4906,986,9,56,16072
8/27/2017,20,9891,219,4912,1370,0,56,16448
8/27/2017,21,9906,218,4358,1727,0,58,16267
8/27/2017,22,9903,222,3976,1671,0,58,15830
8/27/2017,23,9897,225,3484,1619,0,16,15241
8/27/2017,24,9899,231,3030,1391,0,0,14551
8/28/2017,1,9902,236,2889,995,0,0,14022
8/28/2017,2,9893,238,2875,971,0,6,13983
8/28/2017,3,9893,271,2912,806,0,13,13895
8/28/2017,4,9889,320,2930,746,0,14,13899
8/28/2017,5,9885,366,3062,784,0,18,14115
8/28/2017,6,9879,460,3277,753,1,49,14419
8/28/2017,7,9880,565,3609,925,18,81,15078
8/28/2017,8,9875,627,4102,977,80,82,15743
8/28/2017,9,9875,755,4571,853,133,81,16268
8/28/2017,10,9874,1071,4098,801,207,80,16131
8/28/2017,11,9875,1178,4448,875,244,81,16701
8/28/2017,12,9871,1198,4452,819,223,80,16643
8/28/2017,13,9866,1302,4430,846,272,80,16796
8/28/2017,14,9868,1301,4445,957,230,81,16882
8/28/2017,15,9871,1302,4592,966,173,80,16984
8/28/2017,16,9863,1301,4661,965,136,81,17007
8/28/2017,17,9849,1301,4755,955,88,82,17030
8/28/2017,18,9842,979,4633,1141,31,82,16708
8/28/2017,19,9840,702,4857,1312,6,82,16799
8/28/2017,20,9816,677,4587,1647,0,82,16809
8/28/2017,21,9763,512,4446,1623,0,83,16427
8/28/2017,22,9754,321,3970,1551,0,85,15681
8/28/2017,23,9744,282,3448,1521,0,31,15026
8/28/2017,24,9746,281,3271,1402,0,13,14713
8/29/2017,1,9744,282,3021,1297,0,11,14355
8/29/2017,2,9738,282,3038,1268,0,10,14336
8/29/2017,3,9735,282,2946,1269,0,10,14242
8/29/2017,4,9734,286,2983,1029,0,10,14042
8/29/2017,5,9725,292,2990,682,0,13,13702
8/29/2017,6,9702,416,3472,712,0,24,14326
8/29/2017,7,9712,516,3769,764,9,87,14857
8/29/2017,8,9712,797,4286,669,41,113,15618
8/29/2017,9,9707,1092,4457,426,101,114,15897
8/29/2017,10,9706,1325,4356,412,204,112,16115
8/29/2017,11,9717,1323,4699,412,228,105,16484
8/29/2017,12,9746,1338,4701,394,242,112,16533
8/29/2017,13,9776,1394,4787,332,222,104,16615
8/29/2017,14,9776,1408,4999,215,192,99,16689
8/29/2017,15,9774,1419,5151,184,174,89,16791
8/29/2017,16,9777,1382,5193,162,171,85,16770
8/29/2017,17,9773,1295,5382,143,93,79,16765
8/29/2017,18,9776,1243,5209,166,47,80,16521
8/29/2017,19,9776,1233,5118,165,8,89,16389
8/29/2017,20,9765,1239,5260,202,0,165,16631
8/29/2017,21,9759,773,5219,244,0,198,16193
8/29/2017,22,9765,537,4725,247,0,177,15451
8/29/2017,23,9754,324,4137,294,0,83,14592
8/29/2017,24,9766,283,3549,228,0,61,13887
8/30/2017,1,9767,284,3023,264,0,59,13397
8/30/2017,2,9762,292,3013,232,0,63,13362
8/30/2017,3,9766,383,2947,111,0,61,13268
8/30/2017,4,9764,566,2937,54,0,63,13384
8/30/2017,5,9770,848,2957,72,0,68,13715
8/30/2017,6,9778,1131,3202,63,0,86,14260
8/30/2017,7,9774,1257,3630,69,16,132,14878
8/30/2017,8,9773,1244,4107,76,73,200,15473
8/30/2017,9,9700,1287,4322,47,149,202,15707
8/30/2017,10,9666,1402,4509,60,193,200,16030
8/30/2017,11,9661,1465,4814,84,202,201,16427
8/30/2017,12,9661,1571,5156,124,167,200,16879
8/30/2017,13,9660,1859,5259,181,216,200,17375
8/30/2017,14,9690,1849,5233,312,205,201,17490
8/30/2017,15,9942,1894,4820,370,163,201,17390
8/30/2017,16,9958,1909,4751,350,140,203,17311
8/30/2017,17,9953,2049,4625,358,103,205,17293
8/30/2017,18,9956,2175,4566,331,43,205,17276
8/30/2017,19,9965,2184,4575,273,7,205,17209
8/30/2017,20,9915,2190,4877,250,0,206,17438
8/30/2017,21,9908,1780,4488,359,0,173,16708
8/30/2017,22,9969,1066,4249,463,0,89,15836
8/30/2017,23,10134,757,3682,501,0,33,15107
8/30/2017,24,10213,431,3324,218,0,15,14201
8/31/2017,1,10220,350,3033,487,0,14,14104
8/31/2017,2,10316,351,2995,563,0,14,14239
8/31/2017,3,10367,329,2987,625,0,13,14321
8/31/2017,4,10402,299,3003,379,0,14,14097
8/31/2017,5,10406,236,3105,941,0,17,14705
8/31/2017,6,10413,218,3370,1118,0,22,15141
8/31/2017,7,10416,219,3661,1110,14,25,15445
8/31/2017,8,10410,218,3999,1081,62,25,15795
8/31/2017,9,10415,218,3834,1072,133,27,15699
8/31/2017,10,10437,218,3848,1045,177,53,15778
8/31/2017,11,10438,217,3995,888,254,84,15876
8/31/2017,12,10441,217,4114,1263,269,113,16417
8/31/2017,13,10514,217,4272,1375,261,117,16756
8/31/2017,14,10563,217,4031,1334,262,98,16505
8/31/2017,15,10568,217,4092,1346,244,80,16547
8/31/2017,16,10581,217,4132,1511,235,82,16758
8/31/2017,17,10590,217,4269,1033,134,82,16325
8/31/2017,18,10593,217,4355,1410,46,83,16704
8/31/2017,19,10597,217,4412,1468,8,83,16785
8/31/2017,20,10594,218,4441,1546,0,99,16898
8/31/2017,21,10622,218,4216,1442,0,80,16578
8/31/2017,22,10619,217,3789,1226,0,40,15891
8/31/2017,23,10618,217,3469,1106,0,18,15428
8/31/2017,24,10617,218,3137,746,0,13,14731
9/1/2017,1,10474,226,2910,769,0,14,14393
9/1/2017,2,10096,235,2931,987,0,14,14263
9/1/2017,3,10021,236,2944,1048,0,14,14263
9/1/2017,4,10011,235,3023,863,0,14,14146
9/1/2017,5,10014,236,3203,763,0,16,14232
9/1/2017,6,10317,236,3475,861,0,23,14912
9/1/2017,7,10631,288,3577,472,24,27,15019
9/1/2017,8,10637,294,3976,678,104,27,15716
9/1/2017,9,10639,295,4180,579,199,27,15919
9/1/2017,10,10557,280,3694,522,268,27,15348
9/1/2017,11,10468,288,3803,561,311,43,15474
9/1/2017,12,10621,292,3832,416,310,74,15545
9/1/2017,13,10628,287,3854,152,265,76,15262
9/1/2017,14,10615,286,3748,182,259,68,15158
9/1/2017,15,10624,286,3874,174,240,55,15253
9/1/2017,16,10611,286,4052,402,230,59,15640
9/1/2017,17,10599,285,4597,387,144,93,16105
9/1/2017,18,10598,286,4909,334,61,109,16297
9/1/2017,19,10603,287,4521,336,7,109,15863
9/1/2017,20,10609,287,4412,374,0,72,15754
9/1/2017,21,10612,287,4208,476,0,75,15658
9/1/2017,22,10620,289,3922,666,0,37,15534
9/1/2017,23,10623,217,3305,815,0,1,14961
9/1/2017,24,10264,202,3129,662,0,1,14258
9/2/2017,1,9794,200,2977,1281,0,1,14253
9/2/2017,2,9795,201,2752,747,0,1,13496
9/2/2017,3,9790,201,2741,705,0,1,13438
9/2/2017,4,9795,201,2731,541,0,1,13269
9/2/2017,5,9797,201,2745,515,1,1,13260
9/2/2017,6,9800,201,2734,785,2,1,13523
9/2/2017,7,9795,200,3166,412,15,1,13589
9/2/2017,8,9792,200,3584,477,91,1,14145
9/2/2017,9,9787,200,3588,679,222,1,14477
9/2/2017,10,9786,198,3567,573,287,1,14412
9/2/2017,11,9782,199,3724,655,296,1,14657
9/2/2017,12,9775,199,3686,541,311,1,14513
9/2/2017,13,9772,198,3684,497,279,1,14431
9/2/2017,14,9766,198,3722,462,228,1,14377
9/2/2017,15,9718,198,3595,858,201,1,14571
9/2/2017,16,9737,197,3650,1136,175,1,14896
9/2/2017,17,9700,198,3999,982,100,1,14980
9/2/2017,18,9713,197,4518,832,34,1,15295
9/2/2017,19,9709,196,4901,735,4,1,15546
9/2/2017,20,9698,196,4859,485,0,1,15239
9/2/2017,21,9688,196,4649,520,0,1,15054
9/2/2017,22,9693,196,4328,495,0,1,14713
9/2/2017,23,9700,197,3962,505,0,1,14365
9/2/2017,24,9695,197,3152,523,0,1,13568
9/3/2017,1,9689,198,3176,472,0,1,13536
9/3/2017,2,9672,198,2947,479,0,1,13297
9/3/2017,3,9668,198,2804,492,0,1,13163
9/3/2017,4,9672,198,2806,474,0,1,13151
9/3/2017,5,9687,198,2699,509,0,1,13094
9/3/2017,6,9714,199,2667,322,0,1,12903
9/3/2017,7,9717,199,2949,211,1,1,13078
9/3/2017,8,9715,196,3437,687,41,1,14077
9/3/2017,9,9733,196,4141,772,78,1,14921
9/3/2017,10,9748,228,4644,872,114,1,15607
9/3/2017,11,9758,198,4394,1147,116,1,15614
9/3/2017,12,9763,196,4422,1278,137,1,15797
9/3/2017,13,9754,196,3927,1443,165,1,15486
9/3/2017,14,9748,193,3833,1268,164,1,15207
9/3/2017,15,9756,195,3801,1316,156,1,15225
9/3/2017,16,9763,196,3920,1393,151,1,15424
9/3/2017,17,9772,196,3963,1197,97,1,15226
9/3/2017,18,9776,196,4292,972,41,1,15278
9/3/2017,19,9770,196,4548,745,6,1,15266
9/3/2017,20,9760,195,4311,893,0,1,15160
9/3/2017,21,9768,196,4122,1047,0,1,15134
9/3/2017,22,9775,197,3833,1370,0,1,15176
9/3/2017,23,9769,198,3615,1423,0,1,15006
9/3/2017,24,9752,197,3041,783,0,1,13774
9/4/2017,1,9601,197,2659,801,0,1,13259
9/4/2017,2,9443,197,2656,770,0,1,13067
9/4/2017,3,9435,196,2679,667,0,1,12978
9/4/2017,4,9433,196,2657,676,0,1,12963
9/4/2017,5,9432,195,2676,505,0,1,12809
9/4/2017,6,9442,194,2758,920,0,1,13315
9/4/2017,7,9446,195,3132,628,8,1,13410
9/4/2017,8,9443,196,3353,945,57,1,13995
9/4/2017,9,9652,195,3459,1215,141,1,14663
9/4/2017,10,9724,194,3408,1794,210,1,15331
9/4/2017,11,9720,194,3434,2224,286,1,15859
9/4/2017,12,9720,194,3404,2334,305,1,15958
9/4/2017,13,9726,185,3289,2470,279,1,15950
9/4/2017,14,9734,193,3363,2618,228,1,16137
9/4/2017,15,9729,193,3901,2541,187,1,16552
9/4/2017,16,9738,192,4221,2975,105,1,17232
9/4/2017,17,9743,192,4985,2799,48,1,17768
9/4/2017,18,9985,193,4451,2862,11,1,17503
9/4/2017,19,10138,194,4575,2379,0,1,17287
9/4/2017,20,10137,195,4721,2084,0,1,17138
9/4/2017,21,10129,194,4601,1714,0,1,16639
9/4/2017,22,10126,195,4230,1591,0,1,16143
9/4/2017,23,10128,196,3840,1144,0,1,15309
9/4/2017,24,10144,198,3168,867,0,1,14378
9/5/2017,1,10217,199,2906,727,0,0,14049
9/5/2017,2,10130,199,2967,511,0,1,13808
9/5/2017,3,10024,199,3036,276,0,10,13545
9/5/2017,4,9946,200,3415,213,0,12,13786
9/5/2017,5,9996,211,3786,181,0,21,14195
9/5/2017,6,10137,237,4115,172,0,30,14691
9/5/2017,7,10584,315,4124,197,9,51,15280
9/5/2017,8,10577,295,4225,223,44,85,15449
9/5/2017,9,10563,286,4359,282,95,88,15673
9/5/2017,10,10565,286,4291,391,154,89,15776
9/5/2017,11,10570,285,4292,317,182,90,15736
9/5/2017,12,10554,284,4164,728,199,90,16019
9/5/2017,13,10542,286,4083,679,280,90,15960
9/5/2017,14,10550,286,4084,916,271,90,16197
9/5/2017,15,10564,286,4377,733,183,90,16233
9/5/2017,16,10609,298,4813,572,197,108,16597
9/5/2017,17,10641,335,5237,544,105,131,16993
9/5/2017,18,10657,446,4536,812,56,98,16605
9/5/2017,19,10662,436,4573,568,6,91,16336
9/5/2017,20,10661,334,5037,264,0,105,16401
9/5/2017,21,10654,351,4679,182,0,153,16019
9/5/2017,22,10655,293,4127,235,0,129,15439
9/5/2017,23,10629,287,3518,229,0,37,14700
9/5/2017,24,10536,288,3238,149,0,22,14233
9/6/2017,1,10078,290,3617,103,0,17,14105
9/6/2017,2,9987,337,3503,135,0,14,13976
9/6/2017,3,10043,315,3163,161,0,16,13698
9/6/2017,4,10045,291,2957,125,0,20,13438
9/6/2017,5,10067,291,3116,145,0,35,13654
9/6/2017,6,10151,298,3971,219,0,49,14688
9/6/2017,7,10486,296,4168,242,10,53,15255
9/6/2017,8,10645,289,4057,119,48,52,15210
9/6/2017,9,10660,333,4182,125,151,53,15504
9/6/2017,10,10651,385,4506,98,215,54,15909
9/6/2017,11,10633,465,4547,109,259,53,16066
9/6/2017,12,10593,499,4325,112,206,55,15790
9/6/2017,13,10593,560,4680,150,235,69,16287
9/6/2017,14,10595,617,4786,179,156,105,16438
9/6/2017,15,10595,665,4730,232,136,158,16516
9/6/2017,16,10603,734,4880,256,125,155,16753
9/6/2017,17,10625,732,4847,241,75,158,16678
9/6/2017,18,10627,785,4971,178,27,159,16747
9/6/2017,19,10627,969,5065,90,3,173,16927
9/6/2017,20,10629,815,4881,79,0,191,16595
9/6/2017,21,10646,738,4392,110,0,156,16042
9/6/2017,22,10614,425,4020,142,0,107,15308
9/6/2017,23,10589,286,3536,137,0,87,14635
9/6/2017,24,10442,286,3207,178,0,53,14166
9/7/2017,1,10028,286,3213,227,0,28,13782
9/7/2017,2,10009,285,3238,292,0,22,13846
9/7/2017,3,10003,285,3021,419,0,17,13745
9/7/2017,4,10023,286,2944,388,0,16,13657
9/7/2017,5,10043,285,3055,307,0,21,13711
9/7/2017,6,10053,285,3742,439,0,28,14547
9/7/2017,7,10157,284,4401,790,17,32,15681
9/7/2017,8,10673,285,4212,594,89,32,15885
9/7/2017,9,10695,274,4593,536,115,32,16245
9/7/2017,10,10685,283,4141,550,158,32,15849
9/7/2017,11,10679,287,3888,881,161,31,15927
9/7/2017,12,10663,301,3918,385,151,31,15449
9/7/2017,13,10649,302,3932,467,144,32,15526
9/7/2017,14,10640,300,4293,482,140,32,15887
9/7/2017,15,10640,301,4467,345,127,32,15912
9/7/2017,16,10627,316,4415,896,126,31,16411
9/7/2017,17,10619,314,4847,1228,50,31,17089
9/7/2017,18,10624,291,4445,1180,28,32,16600
9/7/2017,19,10642,292,4718,767,4,32,16455
9/7/2017,20,10662,293,4548,644,0,31,16178
9/7/2017,21,10678,294,4448,550,0,31,16001
9/7/2017,22,10693,294,4298,357,0,31,15673
9/7/2017,23,10639,295,3635,370,0,19,14958
9/7/2017,24,10146,296,3342,544,0,17,14345
9/8/2017,1,10130,296,3127,517,0,16,14086
9/8/2017,2,10134,296,2953,333,0,14,13730
9/8/2017,3,10111,296,2934,347,0,15,13703
9/8/2017,4,10113,296,2972,365,0,16,13762
9/8/2017,5,10119,296,3067,287,0,20,13789
9/8/2017,6,10126,311,3536,278,0,25,14276
9/8/2017,7,10297,315,4045,357,10,30,15054
9/8/2017,8,10718,295,4370,282,59,30,15754
9/8/2017,9,10709,294,4134,282,132,44,15595
9/8/2017,10,10696,293,4192,343,181,39,15744
9/8/2017,11,10686,293,4206,404,175,37,15801
9/8/2017,12,10685,299,4342,516,252,36,16130
9/8/2017,13,10689,391,4063,420,226,31,15820
9/8/2017,14,10698,403,4038,437,218,32,15826
9/8/2017,15,10730,442,4144,594,175,32,16117
9/8/2017,16,10672,516,4259,510,161,32,16150
9/8/2017,17,10438,531,4336,922,124,32,16383
9/8/2017,18,10240,537,4694,344,29,32,15876
9/8/2017,19,10195,548,4809,623,4,32,16211
9/8/2017,20,10088,561,5099,815,0,32,16595
9/8/2017,21,9991,610,4891,946,0,32,16470
9/8/2017,22,9969,608,4202,777,0,31,15587
9/8/2017,23,9972,509,3354,618,0,21,14474
9/8/2017,24,9907,523,3068,347,0,4,13849
9/9/2017,1,9670,527,2911,717,0,0,13825
9/9/2017,2,9658,527,2822,574,0,0,13581
9/9/2017,3,9418,527,2829,322,0,0,13096
9/9/2017,4,9333,530,2939,606,0,0,13408
9/9/2017,5,9325,482,2836,583,0,0,13226
9/9/2017,6,9398,210,3228,688,0,0,13524
9/9/2017,7,9642,210,3189,436,21,0,13498
9/9/2017,8,9653,210,3707,443,105,1,14119
9/9/2017,9,9920,210,3800,210,192,1,14333
9/9/2017,10,9950,209,3799,133,195,1,14287
9/9/2017,11,9945,208,3901,113,61,1,14229
9/9/2017,12,9937,208,3886,148,239,21,14439
9/9/2017,13,9938,208,3907,114,113,25,14305
9/9/2017,14,9792,207,3964,115,122,27,14227
9/9/2017,15,9620,206,3945,385,270,27,14453
9/9/2017,16,9606,205,4103,364,216,29,14523
9/9/2017,17,9599,222,4332,454,134,27,14768
9/9/2017,18,9744,233,4469,464,49,25,14984
9/9/2017,19,9896,208,4309,431,4,27,14875
9/9/2017,20,9906,208,4252,512,0,26,14904
9/9/2017,21,9903,209,3805,393,0,17,14327
9/9/2017,22,9911,209,3690,471,0,12,14293
9/9/2017,23,9912,210,3214,516,0,11,13863
9/9/2017,24,9772,210,2808,384,0,16,13190
9/10/2017,1,9602,199,2824,572,0,12,13209
9/10/2017,2,9600,210,2939,442,0,11,13202
9/10/2017,3,9588,210,2799,399,0,9,13005
9/10/2017,4,9586,210,2781,358,0,5,12940
9/10/2017,5,9598,209,2805,307,0,2,12921
9/10/2017,6,9603,209,3057,304,0,1,13174
9/10/2017,7,9612,209,3156,320,18,1,13316
9/10/2017,8,9617,209,3244,255,93,5,13423
9/10/2017,9,9619,209,3390,138,193,5,13554
9/10/2017,10,9621,209,3576,118,273,1,13798
9/10/2017,11,9625,208,3573,169,300,2,13877
9/10/2017,12,9629,208,3818,207,314,1,14177
9/10/2017,13,9619,209,3845,198,308,1,14180
9/10/2017,14,9597,209,3593,100,246,1,13746
9/10/2017,15,9583,209,3758,223,294,1,14068
9/10/2017,16,9566,208,4157,252,233,1,14417
9/10/2017,17,9647,208,4757,296,140,1,15049
9/10/2017,18,9840,208,4989,251,49,1,15338
9/10/2017,19,9858,259,5090,219,4,1,15431
9/10/2017,20,9877,248,4837,263,0,1,15226
9/10/2017,21,9877,238,4494,312,0,1,14922
9/10/2017,22,9890,239,4149,316,0,1,14595
9/10/2017,23,9908,239,3489,353,0,1,13990
9/10/2017,24,9903,239,2810,298,0,1,13251
9/11/2017,1,9898,240,2596,275,0,1,13010
9/11/2017,2,9886,240,2612,459,0,1,13198
9/11/2017,3,9886,239,2623,252,0,1,13001
9/11/2017,4,9881,239,2735,267,0,1,13123
9/11/2017,5,9880,240,2838,145,0,1,13104
9/11/2017,6,9869,250,3417,260,1,1,13798
9/11/2017,7,9871,298,3690,327,19,4,14209
9/11/2017,8,9867,338,3619,365,91,13,14293
9/11/2017,9,9865,422,3785,267,177,52,14568
9/11/2017,10,9856,568,3927,202,261,133,14947
9/11/2017,11,9859,618,4065,151,317,149,15159
9/11/2017,12,9868,686,4041,102,327,149,15173
9/11/2017,13,9860,932,4149,140,328,143,15552
9/11/2017,14,9857,1041,3868,183,320,119,15388
9/11/2017,15,9859,1118,3899,231,277,119,15503
9/11/2017,16,9853,1206,3999,226,192,121,15597
9/11/2017,17,9851,1258,4580,312,119,129,16249
9/11/2017,18,9851,1265,4391,306,38,118,15969
9/11/2017,19,9847,995,4767,277,4,129,16019
9/11/2017,20,9846,910,4769,316,0,127,15968
9/11/2017,21,9839,733,4750,342,0,127,15791
9/11/2017,22,9833,510,4104,307,0,53,14807
9/11/2017,23,9831,372,3669,403,0,22,14297
9/11/2017,24,9840,332,2956,314,0,19,13461
9/12/2017,1,9841,336,2765,403,0,17,13362
9/12/2017,2,9847,334,2722,298,0,18,13219
9/12/2017,3,9857,359,2776,212,0,19,13223
9/12/2017,4,9849,372,2815,180,0,20,13236
9/12/2017,5,9854,472,2684,177,0,23,13210
9/12/2017,6,9868,661,3324,125,0,33,14011
9/12/2017,7,9874,863,3541,209,16,29,14532
9/12/2017,8,9835,885,3973,225,90,28,15036
9/12/2017,9,9794,909,3919,129,179,30,14960
9/12/2017,10,9787,936,4095,65,255,56,15194
9/12/2017,11,9781,944,4121,61,312,81,15300
9/12/2017,12,9784,991,4037,95,325,85,15317
9/12/2017,13,9820,925,3775,116,328,86,15050
9/12/2017,14,9813,1052,4020,101,320,84,15390
9/12/2017,15,9801,1345,4080,136,282,84,15728
9/12/2017,16,9787,1350,4500,161,229,116,16143
9/12/2017,17,9789,1519,4638,167,142,123,16378
9/12/2017,18,9804,1796,4677,174,48,120,16619
9/12/2017,19,9821,1617,4592,192,4,125,16351
9/12/2017,20,9824,1721,4596,187,0,104,16432
9/12/2017,21,9822,1516,4287,163,0,92,15880
9/12/2017,22,9816,1385,3774,165,0,91,15231
9/12/2017,23,9825,846,3122,162,0,23,13978
9/12/2017,24,9824,546,3040,202,0,17,13629
9/13/2017,1,9872,334,2676,415,0,19,13316
9/13/2017,2,9864,291,2551,366,0,19,13091
9/13/2017,3,9872,292,2511,393,0,19,13087
9/13/2017,4,9867,300,2500,348,0,19,13034
9/13/2017,5,9873,393,2516,297,0,23,13102
9/13/2017,6,9865,565,2963,224,0,53,13670
9/13/2017,7,9847,709,3456,329,13,90,14444
9/13/2017,8,9852,754,3981,324,85,165,15161
9/13/2017,9,9832,737,4138,153,149,212,15221
9/13/2017,10,9776,769,4132,74,225,210,15186
9/13/2017,11,9698,829,4112,78,267,202,15186
9/13/2017,12,9698,939,4369,76,289,192,15563
9/13/2017,13,9699,991,4349,156,281,192,15668
9/13/2017,14,9748,1071,4137,238,250,190,15634
9/13/2017,15,9794,1199,4204,243,265,191,15896
9/13/2017,16,9799,1547,4487,255,168,194,16450
9/13/2017,17,9790,1797,4658,199,88,203,16735
9/13/2017,18,9804,1770,4585,139,31,211,16540
9/13/2017,19,9794,1769,4571,163,2,211,16510
9/13/2017,20,9784,1998,4503,210,0,211,16706
9/13/2017,21,9766,1613,4285,294,0,211,16169
9/13/2017,22,9762,1406,3867,372,0,208,15615
9/13/2017,23,9767,1165,3262,427,0,193,14814
9/13/2017,24,9765,613,2950,352,0,140,13820
9/14/2017,1,9766,315,3127,437,0,74,13719
9/14/2017,2,9773,295,2859,342,0,69,13338
9/14/2017,3,9768,307,2913,249,0,70,13307
9/14/2017,4,9756,484,2787,149,0,70,13246
9/14/2017,5,9752,811,2797,161,0,75,13596
9/14/2017,6,9749,1306,3340,161,0,126,14682
9/14/2017,7,9756,1510,3556,269,8,154,15253
9/14/2017,8,9751,1397,3325,314,44,111,14942
9/14/2017,9,9751,1419,3631,184,121,92,15198
9/14/2017,10,9721,1635,3769,100,168,98,15491
9/14/2017,11,9696,1776,4024,91,217,117,15921
9/14/2017,12,9698,2095,4151,157,244,151,16496
9/14/2017,13,9697,2315,4203,236,252,118,16821
9/14/2017,14,9685,2546,4082,290,270,90,16963
9/14/2017,15,9675,2420,4342,273,242,103,17055
9/14/2017,16,9668,2726,4563,279,188,156,17580
9/14/2017,17,9665,2835,4662,293,109,143,17707
9/14/2017,18,9665,2729,4744,280,37,114,17569
9/14/2017,19,9667,2809,4625,301,2,86,17490
9/14/2017,20,9663,2795,4535,378,0,84,17455
9/14/2017,21,9660,2358,4383,403,0,44,16848
9/14/2017,22,9664,1837,3734,388,0,29,15652
9/14/2017,23,9678,953,3428,377,0,26,14462
9/14/2017,24,9689,732,3169,446,0,21,14057
9/15/2017,1,9690,374,3080,456,0,14,13614
9/15/2017,2,9697,273,2871,451,0,13,13305
9/15/2017,3,9703,292,2780,400,0,13,13188
9/15/2017,4,9704,309,3168,352,0,14,13547
9/15/2017,5,9708,465,3114,335,0,20,13642
9/15/2017,6,9713,872,3379,346,0,29,14339
9/15/2017,7,9717,1193,3720,362,9,30,15031
9/15/2017,8,9739,1384,3662,378,63,30,15256
9/15/2017,9,9735,1568,3774,216,114,28,15435
9/15/2017,10,9693,1650,4041,126,173,27,15710
9/15/2017,11,9690,1834,3991,149,253,28,15945
9/15/2017,12,9681,2058,4055,212,279,27,16312
9/15/2017,13,9675,2107,4281,210,279,27,16579
9/15/2017,14,9671,2340,4388,242,261,26,16928
9/15/2017,15,9703,2543,4525,209,214,27,17221
9/15/2017,16,9731,2858,4676,195,158,27,17645
9/15/2017,17,9736,2961,4727,161,89,27,17701
9/15/2017,18,9742,2722,4667,158,27,30,17346
9/15/2017,19,9745,2658,4643,220,2,30,17298
9/15/2017,20,9740,2680,4486,345,0,30,17281
9/15/2017,21,9738,2441,4255,333,0,30,16797
9/15/2017,22,9747,2042,3747,420,0,29,15985
9/15/2017,23,9755,844,3642,484,0,20,14745
9/15/2017,24,9759,344,3224,448,0,12,13787
9/16/2017,1,9762,309,3239,391,0,0,13701
9/16/2017,2,9757,299,3178,349,0,2,13585
9/16/2017,3,9755,299,3164,295,0,3,13516
9/16/2017,4,9759,308,3073,250,0,0,13390
9/16/2017,5,9755,418,2859,253,0,0,13285
9/16/2017,6,9756,592,2876,253,0,0,13477
9/16/2017,7,9760,787,2954,210,10,0,13721
9/16/2017,8,9753,774,3277,413,65,0,14282
9/16/2017,9,9762,802,3765,224,142,0,14695
9/16/2017,10,9756,1054,3843,139,210,1,15003
9/16/2017,11,9753,1499,3487,128,263,0,15130
9/16/2017,12,9749,1771,3678,167,271,0,15636
9/16/2017,13,9738,1850,3907,255,274,0,16024
9/16/2017,14,9736,1884,4077,261,265,0,16223
9/16/2017,15,9730,1902,4020,297,236,0,16185
9/16/2017,16,9722,1940,4150,266,179,0,16257
9/16/2017,17,9722,2145,4438,272,107,0,16684
9/16/2017,18,9724,2167,4254,203,34,0,16382
9/16/2017,19,9726,2152,4281,239,1,0,16399
9/16/2017,20,9724,1777,4223,364,0,0,16088
9/16/2017,21,9728,1656,4026,396,0,0,15806
9/16/2017,22,9724,1439,3360,446,0,0,14969
9/16/2017,23,9716,965,3174,618,0,0,14473
9/16/2017,24,9728,412,2757,379,0,0,13276
9/17/2017,1,9733,292,2751,415,0,0,13191
9/17/2017,2,9740,291,2768,400,0,1,13200
9/17/2017,3,9751,291,2672,413,0,1,13128
9/17/2017,4,9752,295,2595,191,0,25,12858
9/17/2017,5,9752,300,2712,183,0,46,12993
9/17/2017,6,9755,361,2652,311,0,45,13124
9/17/2017,7,9752,432,2762,253,9,42,13250
9/17/2017,8,9749,501,2951,169,21,40,13431
9/17/2017,9,9741,504,3268,359,161,40,14073
9/17/2017,10,9738,584,3666,354,224,22,14588
9/17/2017,11,9728,1078,4012,389,268,12,15487
9/17/2017,12,9721,1151,4025,402,288,45,15632
9/17/2017,13,9715,1333,4062,454,286,16,15866
9/17/2017,14,9714,1648,4189,512,270,46,16379
9/17/2017,15,9665,2014,4331,585,234,44,16873
9/17/2017,16,9689,2333,4390,538,180,42,17172
9/17/2017,17,9651,2603,4474,480,99,42,17349
9/17/2017,18,9650,2742,4428,425,31,42,17318
9/17/2017,19,9644,2770,4362,560,0,42,17378
9/17/2017,20,9643,2657,4263,787,0,42,17392
9/17/2017,21,9640,1964,4148,1003,0,40,16795
9/17/2017,22,9643,1245,3536,1123,0,1,15548
9/17/2017,23,9647,613,3255,1065,0,0,14580
9/17/2017,24,9650,333,2886,1090,0,0,13959
9/18/2017,1,9661,288,2677,1013,0,0,13639
9/18/2017,2,9655,290,2636,833,0,5,13419
9/18/2017,3,9653,301,2754,610,0,8,13326
9/18/2017,4,9654,413,2961,633,0,16,13677
9/18/2017,5,9649,652,2858,350,0,19,13528
9/18/2017,6,9649,1020,3260,258,0,19,14206
9/18/2017,7,9650,1348,4064,239,10,21,15332
9/18/2017,8,9642,1809,3980,164,70,24,15689
9/18/2017,9,9640,2132,4228,84,121,25,16230
9/18/2017,10,9645,2748,4278,76,176,27,16950
9/18/2017,11,9650,3162,4210,134,222,27,17405
9/18/2017,12,9649,3599,4219,168,230,25,17890
9/18/2017,13,9648,3942,4089,188,199,25,18091
9/18/2017,14,9652,4075,4410,196,184,25,18542
9/18/2017,15,9651,4449,4399,274,169,26,18968
9/18/2017,16,9687,4500,4634,291,139,31,19282
9/18/2017,17,9693,4488,4586,281,68,41,19157
9/18/2017,18,9697,4259,4712,190,12,42,18912
9/18/2017,19,9693,4282,4673,184,0,39,18871
9/18/2017,20,9689,4210,4557,187,0,35,18678
9/18/2017,21,9680,3205,4440,146,0,33,17504
9/18/2017,22,9684,2440,4166,131,0,28,16449
9/18/2017,23,9682,1367,3821,179,0,18,15067
9/18/2017,24,9678,941,3437,141,0,15,14212
9/19/2017,1,9680,576,3334,121,0,15,13726
9/19/2017,2,9674,561,3313,150,0,15,13713
9/19/2017,3,9668,510,3060,143,0,14,13395
9/19/2017,4,9680,545,3069,183,0,15,13492
9/19/2017,5,9679,696,2705,250,0,18,13348
9/19/2017,6,9670,939,3172,210,0,47,14038
9/19/2017,7,9670,1220,3891,258,7,78,15124
9/19/2017,8,9672,1661,4234,296,46,84,15993
9/19/2017,9,9663,2317,4047,258,111,96,16492
9/19/2017,10,9667,3023,3761,179,190,94,16914
9/19/2017,11,9662,3319,3800,112,220,85,17198
9/19/2017,12,9664,3562,4159,100,218,86,17789
9/19/2017,13,9590,3688,4478,66,234,88,18144
9/19/2017,14,9179,4278,4585,55,231,88,18416
9/19/2017,15,9166,4667,4596,68,202,96,18795
9/19/2017,16,9161,4790,4631,58,158,93,18891
9/19/2017,17,9158,4599,4716,48,93,100,18714
9/19/2017,18,9155,4524,4687,108,14,100,18588
9/19/2017,19,9156,4517,4570,279,0,116,18638
9/19/2017,20,9153,4235,4628,398,0,132,18546
9/19/2017,21,9146,3905,4111,611,0,132,17905
9/19/2017,22,9147,2940,3591,619,0,124,16421
9/19/2017,23,9141,1831,3447,572,0,67,15058
9/19/2017,24,9140,965,3344,700,0,64,14213
9/20/2017,1,9143,713,3254,716,0,64,13890
9/20/2017,2,9158,706,2739,761,0,63,13427
9/20/2017,3,9165,799,2679,715,0,64,13422
9/20/2017,4,9160,999,2577,639,0,65,13440
9/20/2017,5,9166,1208,2553,556,0,34,13517
9/20/2017,6,9168,1583,3037,564,0,26,14378
9/20/2017,7,9167,2112,3438,563,5,27,15312
9/20/2017,8,9162,2576,3681,482,62,28,15991
9/20/2017,9,9160,3096,3701,406,162,28,16553
9/20/2017,10,9026,3436,3734,190,235,63,16684
9/20/2017,11,8980,3609,4034,247,261,79,17210
9/20/2017,12,8977,3758,4092,277,281,78,17463
9/20/2017,13,8971,4043,4185,350,276,83,17908
9/20/2017,14,9026,4057,4353,405,258,81,18180
9/20/2017,15,9130,4205,4575,354,236,82,18582
9/20/2017,16,9132,4277,4770,264,180,93,18716
9/20/2017,17,9133,4515,4918,285,108,94,19053
9/20/2017,18,9128,4398,4648,320,39,96,18629
9/20/2017,19,9136,4373,4730,361,9,94,18703
9/20/2017,20,9136,4627,4555,544,9,91,18962
9/20/2017,21,9134,3766,4201,917,9,84,18111
9/20/2017,22,9137,2597,3541,1054,9,78,16416
9/20/2017,23,9137,1652,3089,1054,9,74,15015
9/20/2017,24,9134,1242,2999,884,9,70,14338
9/21/2017,1,9138,1048,3234,726,9,69,14224
9/21/2017,2,9140,1037,3369,537,9,70,14162
9/21/2017,3,9140,1021,2997,626,9,69,13862
9/21/2017,4,9131,1105,2729,673,9,68,13715
9/21/2017,5,9136,1342,2647,617,9,70,13821
9/21/2017,6,9140,1590,2996,581,9,75,14391
9/21/2017,7,9141,2068,3516,750,17,80,15572
9/21/2017,8,9142,2340,3513,736,86,79,15896
9/21/2017,9,9113,2717,3907,383,172,80,16372
9/21/2017,10,9128,3008,4166,228,243,78,16851
9/21/2017,11,9128,3340,4323,257,272,78,17398
9/21/2017,12,9123,3654,4405,358,283,78,17901
9/21/2017,13,9130,3873,4632,272,260,79,18246
9/21/2017,14,9128,4045,4596,194,264,82,18309
9/21/2017,15,9145,4513,4474,148,260,83,18623
9/21/2017,16,9140,4813,4458,140,197,96,18844
9/21/2017,17,9134,4914,4417,194,113,99,18871
9/21/2017,18,9133,4750,4364,271,27,98,18643
9/21/2017,19,9133,4445,4332,571,0,53,18534
9/21/2017,20,9130,4184,4435,878,0,39,18666
9/21/2017,21,9133,3403,4570,1026,0,28,18160
9/21/2017,22,9138,2272,4131,1191,0,28,16760
9/21/2017,23,9150,1469,3558,1189,0,22,15388
9/21/2017,24,9140,1094,3328,1312,0,19,14893
9/22/2017,1,9138,680,2742,1332,0,19,13911
9/22/2017,2,9134,636,2773,1121,0,19,13683
9/22/2017,3,9132,710,2898,717,0,18,13475
9/22/2017,4,9076,887,2993,722,0,17,13695
9/22/2017,5,9086,1191,2800,582,0,20,13679
9/22/2017,6,9117,1769,3069,659,0,25,14639
9/22/2017,7,9119,1961,3410,736,8,30,15264
9/22/2017,8,9121,2360,3448,643,68,60,15700
9/22/2017,9,9116,2685,3788,284,155,83,16111
9/22/2017,10,9123,3112,4001,153,235,81,16705
9/22/2017,11,9154,3404,4204,93,286,81,17222
9/22/2017,12,9152,3708,4320,109,310,81,17680
9/22/2017,13,9152,4038,4403,95,319,81,18088
9/22/2017,14,9149,4220,4278,87,311,95,18140
9/22/2017,15,9141,4724,4395,110,254,96,18720
9/22/2017,16,9139,4846,4625,97,190,102,18999
9/22/2017,17,9164,4842,4611,100,107,100,18924
9/22/2017,18,9211,4746,4535,98,26,44,18660
9/22/2017,19,9213,4729,4523,208,0,33,18706
9/22/2017,20,9212,4519,4253,271,0,27,18282
9/22/2017,21,9221,3817,4049,307,0,27,17421
9/22/2017,22,9294,2585,3727,360,0,27,15993
9/22/2017,23,9341,1627,3507,334,0,23,14832
9/22/2017,24,9339,984,3198,391,0,19,13931
9/23/2017,1,9339,541,3160,460,0,0,13500
9/23/2017,2,9367,425,2793,429,0,0,13014
9/23/2017,3,9395,424,2718,586,0,0,13123
9/23/2017,4,9407,426,2713,427,0,35,13008
9/23/2017,5,9412,452,2757,149,0,44,12814
9/23/2017,6,9411,666,3004,164,0,43,13288
9/23/2017,7,9411,981,3170,132,3,43,13740
9/23/2017,8,9406,1504,3169,202,50,41,14372
9/23/2017,9,9397,2276,3117,213,139,41,15183
9/23/2017,10,9395,3005,3282,127,178,41,16028
9/23/2017,11,9405,3385,3678,160,258,39,16925
9/23/2017,12,9397,3693,3755,83,284,42,17254
9/23/2017,13,9392,3411,3969,111,306,42,17231
9/23/2017,14,9398,3506,4309,115,296,49,17673
9/23/2017,15,9396,3488,4775,140,260,53,18112
9/23/2017,16,9402,3925,4925,131,190,63,18636
9/23/2017,17,9402,4035,5166,117,108,31,18859
9/23/2017,18,9409,4132,5057,103,27,20,18748
9/23/2017,19,9416,4202,4920,133,0,19,18690
9/23/2017,20,9417,3901,4851,169,0,5,18343
9/23/2017,21,9439,3668,4410,213,0,0,17730
9/23/2017,22,9495,2637,3856,250,0,0,16238
9/23/2017,23,9573,1782,3463,231,0,0,15049
9/23/2017,24,9629,1307,2955,246,0,0,14137
9/24/2017,1,9620,899,2916,383,0,0,13818
9/24/2017,2,9625,673,3128,374,0,0,13800
9/24/2017,3,9627,623,3015,325,0,0,13590
9/24/2017,4,9614,628,3026,231,0,0,13499
9/24/2017,5,9597,645,3030,170,0,0,13442
9/24/2017,6,9596,863,2996,144,0,0,13599
9/24/2017,7,9607,1195,3055,86,0,0,13943
9/24/2017,8,9615,1701,3252,112,51,0,14731
9/24/2017,9,9606,2262,3430,94,159,0,15551
9/24/2017,10,9602,3015,3370,57,227,0,16271
9/24/2017,11,9611,3477,3613,65,266,0,17032
9/24/2017,12,9625,4027,3740,82,289,1,17764
9/24/2017,13,9620,4266,3935,90,298,9,18218
9/24/2017,14,9573,4275,4351,82,292,11,18584
9/24/2017,15,9608,4214,4670,94,257,22,18865
9/24/2017,16,9629,4073,4907,141,192,24,18966
9/24/2017,17,9657,4022,5109,131,111,25,19055
9/24/2017,18,9662,4089,5135,155,26,22,19089
9/24/2017,19,9665,3940,5194,212,0,23,19034
9/24/2017,20,9676,4084,4731,273,0,19,18783
9/24/2017,21,9671,4242,3976,342,0,20,18251
9/24/2017,22,9680,3691,3824,408,0,13,17616
9/24/2017,23,9646,2549,3490,461,0,10,16156
9/24/2017,24,9640,1940,3167,507,0,0,15254
9/25/2017,1,9642,1659,3252,579,0,8,15140
9/25/2017,2,9647,1693,2788,567,0,16,14711
9/25/2017,3,9657,1646,2711,520,0,16,14550
9/25/2017,4,9657,1701,2905,494,0,16,14773
9/25/2017,5,9656,2002,2932,125,0,19,14734
9/25/2017,6,9659,2427,3213,365,0,40,15704
9/25/2017,7,9663,2856,3692,431,7,74,16723
9/25/2017,8,9652,3235,3729,464,72,97,17249
9/25/2017,9,9635,3525,4088,301,175,95,17819
9/25/2017,10,9626,4015,4466,120,245,104,18576
9/25/2017,11,9621,4266,4642,132,300,110,19071
9/25/2017,12,9628,4396,4849,122,303,116,19414
9/25/2017,13,9650,4902,5069,102,293,108,20124
9/25/2017,14,9680,5131,5070,81,263,103,20328
9/25/2017,15,9685,5261,5064,63,234,100,20407
9/25/2017,16,9684,5331,5313,64,168,100,20660
9/25/2017,17,9690,5268,5135,67,85,100,20345
9/25/2017,18,9686,4617,5111,141,17,101,19673
9/25/2017,19,9685,4682,5295,241,0,100,20003
9/25/2017,20,9694,4602,5049,364,0,98,19807
9/25/2017,21,9687,4629,4673,406,0,98,19493
9/25/2017,22,9688,3753,4216,502,0,82,18241
9/25/2017,23,9684,2800,3777,474,0,37,16772
9/25/2017,24,9688,2490,3136,446,0,18,15778
9/26/2017,1,9694,2091,2970,428,0,17,15200
9/26/2017,2,9701,2014,3038,350,0,17,15120
9/26/2017,3,9686,2005,3110,278,0,18,15097
9/26/2017,4,9694,2035,3203,177,0,19,15128
9/26/2017,5,9695,2198,3186,131,0,20,15230
9/26/2017,6,9695,2569,3395,154,0,26,15839
9/26/2017,7,9692,3142,3576,222,6,49,16687
9/26/2017,8,9682,3318,3602,271,57,90,17020
9/26/2017,9,9688,3538,3784,177,143,110,17440
9/26/2017,10,9692,4097,4034,112,210,110,18255
9/26/2017,11,9686,4703,4179,104,229,145,19046
9/26/2017,12,9686,4746,4630,212,259,163,19696
9/26/2017,13,9667,4585,4956,288,289,177,19962
9/26/2017,14,9656,4491,5161,356,265,170,20099
9/26/2017,15,9651,4481,5203,389,225,144,20093
9/26/2017,16,9651,4458,5302,347,169,110,20037
9/26/2017,17,9642,4825,5343,243,99,102,20254
9/26/2017,18,9642,4664,5316,152,22,123,19919
9/26/2017,19,9643,4564,5172,212,0,128,19719
9/26/2017,20,9643,4567,4886,351,0,129,19576
9/26/2017,21,9646,4000,4409,598,0,98,18751
9/26/2017,22,9644,3278,4044,857,0,42,17865
9/26/2017,23,9637,2551,3406,1094,0,22,16710
9/26/2017,24,9651,1828,2836,1314,0,20,15649
9/27/2017,1,9643,948,3025,1408,0,20,15044
9/27/2017,2,9646,811,2743,1371,0,20,14591
9/27/2017,3,9638,821,2631,1233,0,19,14342
9/27/2017,4,9628,830,2672,1147,0,20,14297
9/27/2017,5,9622,971,2600,1083,0,23,14299
9/27/2017,6,9611,1245,3426,1129,0,30,15441
9/27/2017,7,9603,1750,3742,1155,4,61,16315
9/27/2017,8,9602,2165,3756,1094,61,90,16768
9/27/2017,9,9606,2613,4136,1218,142,103,17818
9/27/2017,10,9618,2938,4382,1317,198,114,18567
9/27/2017,11,9627,3295,4579,1143,227,121,18992
9/27/2017,12,9633,3474,4430,1491,229,127,19384
9/27/2017,13,9623,3541,4530,1495,236,134,19559
9/27/2017,14,9633,3108,4328,1443,218,137,18867
9/27/2017,15,9643,2937,4592,1655,147,125,19099
9/27/2017,16,9653,2916,4424,1992,142,112,19239
9/27/2017,17,9672,2843,4451,1980,50,111,19107
9/27/2017,18,9699,2845,4234,1820,15,111,18724
9/27/2017,19,9713,2686,4343,1807,0,111,18660
9/27/2017,20,9718,2359,4110,1876,0,110,18173
9/27/2017,21,9703,2050,3626,1697,0,100,17176
9/27/2017,22,9701,1911,3156,1088,0,40,15896
9/27/2017,23,9715,1604,2749,652,0,28,14748
9/27/2017,24,9716,895,2662,933,0,18,14224
9/28/2017,1,9768,561,2426,1700,0,20,14475
9/28/2017,2,9775,499,2471,1707,0,20,14472
9/28/2017,3,9787,505,2442,1488,0,19,14241
9/28/2017,4,9799,506,2539,1174,0,23,14041
9/28/2017,5,9832,508,2735,1164,0,25,14264
9/28/2017,6,9877,541,3402,1061,0,27,14908
9/28/2017,7,9898,742,4107,970,10,29,15756
9/28/2017,8,9909,906,3661,778,77,30,15361
9/28/2017,9,9890,1003,3189,704,173,34,14993
9/28/2017,10,9826,862,2952,760,200,89,14689
9/28/2017,11,9802,932,3146,1178,190,111,15359
9/28/2017,12,9884,1055,3333,1082,173,113,15640
9/28/2017,13,9880,1123,3381,691,174,104,15353
9/28/2017,14,9906,1109,3899,546,176,114,15750
9/28/2017,15,9935,1148,3803,513,185,163,15747
9/28/2017,16,9910,1047,4284,490,134,118,15983
9/28/2017,17,9883,1055,4156,490,78,101,15763
9/28/2017,18,9895,1055,3919,293,15,105,15282
9/28/2017,19,9903,1113,4673,193,0,106,15988
9/28/2017,20,9896,1091,4671,169,0,110,15937
9/28/2017,21,9898,743,4601,185,0,105,15532
9/28/2017,22,9899,500,4068,181,0,44,14692
9/28/2017,23,9902,475,3279,251,0,25,13932
9/28/2017,24,9906,294,2585,254,0,22,13061
9/29/2017,1,9907,247,2454,350,0,23,12981
9/29/2017,2,9904,247,2436,633,0,22,13242
9/29/2017,3,9738,255,2489,579,0,22,13083
9/29/2017,4,9107,310,2558,1061,0,22,13058
9/29/2017,5,9043,384,2772,851,0,24,13074
9/29/2017,6,9047,456,3210,976,0,28,13717
9/29/2017,7,9047,460,3817,1284,9,30,14647
9/29/2017,8,9044,531,4358,1494,54,30,15511
9/29/2017,9,8903,558,4305,1683,103,30,15582
9/29/2017,10,8871,528,4158,1718,116,30,15421
9/29/2017,11,8865,639,4317,1681,126,30,15658
9/29/2017,12,8862,402,4114,1731,177,30,15316
9/29/2017,13,8855,267,3608,2118,131,30,15009
9/29/2017,14,8842,257,3595,2360,119,28,15201
9/29/2017,15,8909,257,3460,2406,101,29,15162
9/29/2017,16,8994,256,3356,2334,83,29,15052
9/29/2017,17,9015,257,3500,2410,56,29,15267
9/29/2017,18,9024,256,3561,2312,14,29,15196
9/29/2017,19,9020,242,3741,2420,0,28,15451
9/29/2017,20,9024,239,3883,2241,0,28,15415
9/29/2017,21,9047,240,3888,2177,0,28,15380
9/29/2017,22,9040,240,3543,2108,0,28,14959
9/29/2017,23,9245,158,2775,1735,0,23,13936
9/29/2017,24,9330,152,2594,1554,0,14,13644
9/30/2017,1,9345,152,2968,1238,0,0,13703
9/30/2017,2,9350,151,2845,1092,0,0,13438
9/30/2017,3,9400,157,3021,952,0,0,13530
9/30/2017,4,9785,153,2487,916,0,0,13341
9/30/2017,5,9943,152,2458,735,0,0,13288
9/30/2017,6,10067,152,2560,848,0,0,13627
9/30/2017,7,10060,153,2798,690,6,0,13707
9/30/2017,8,10052,158,3188,638,59,0,14095
9/30/2017,9,10025,159,3222,558,183,0,14147
9/30/2017,10,10006,158,3066,663,263,0,14156
9/30/2017,11,10123,159,3189,460,242,0,14173
9/30/2017,12,10201,158,3388,651,255,0,14653
9/30/2017,13,10213,158,3469,373,248,0,14461
9/30/2017,14,10200,158,3294,161,249,0,14062
9/30/2017,15,10374,158,3158,139,247,0,14076
9/30/2017,16,10404,157,3368,219,200,0,14348
9/30/2017,17,10416,157,3578,307,111,0,14569
9/30/2017,18,10415,181,4101,230,25,0,14952
9/30/2017,19,10410,214,4454,169,0,0,15247
9/30/2017,20,10416,215,4075,278,0,0,14984
9/30/2017,21,10415,215,3855,388,0,0,14873
9/30/2017,22,10418,214,3079,419,0,0,14130
9/30/2017,23,10417,215,2851,514,0,0,13997
9/30/2017,24,10424,215,2550,549,0,0,13738
10/1/2017,1,10434,215,2750,443,0,0,13842
10/1/2017,2,10434,215,2614,383,0,0,13646
10/1/2017,3,10438,215,2494,383,0,0,13530
10/1/2017,4,10440,216,2450,326,0,0,13432
10/1/2017,5,10442,215,2654,361,0,0,13672
10/1/2017,6,10451,213,2729,323,1,1,13718
10/1/2017,7,10452,210,3133,245,13,3,14056
10/1/2017,8,10454,210,3043,230,92,3,14032
10/1/2017,9,10459,210,2841,89,140,1,13740
10/1/2017,10,10448,213,2866,103,257,1,13888
10/1/2017,11,10435,213,3102,105,182,1,14038
10/1/2017,12,10425,212,3146,179,313,1,14276
10/1/2017,13,10426,212,3172,193,330,0,14333
10/1/2017,14,10422,212,3216,169,319,0,14338
10/1/2017,15,10426,212,3192,167,232,0,14229
10/1/2017,16,10425,212,3567,244,216,0,14664
10/1/2017,17,10433,213,3786,258,105,0,14795
10/1/2017,18,10433,217,4275,287,24,0,15236
10/1/2017,19,10417,276,5026,434,0,0,16153
10/1/2017,20,10416,287,4210,641,0,0,15554
10/1/2017,21,10431,219,3502,686,0,0,14838
10/1/2017,22,10429,219,3015,825,0,0,14488
10/1/2017,23,10415,218,2650,995,0,11,14289
10/1/2017,24,10429,217,2460,1109,0,17,14232
10/2/2017,1,10424,217,2331,792,0,16,13780
10/2/2017,2,10399,216,2438,554,0,18,13625
10/2/2017,3,9901,215,2379,943,0,18,13456
10/2/2017,4,9803,215,2368,1303,0,19,13708
10/2/2017,5,9794,216,2440,1094,0,22,13566
10/2/2017,6,9882,217,2866,1179,0,22,14166
10/2/2017,7,10350,221,3566,1273,11,28,15449
10/2/2017,8,10371,277,3473,1149,91,32,15393
10/2/2017,9,10381,333,3567,792,198,33,15304
10/2/2017,10,10353,386,3823,535,262,33,15392
10/2/2017,11,10259,386,4088,422,301,33,15489
10/2/2017,12,10260,386,3722,508,313,34,15223
10/2/2017,13,10248,389,3528,572,311,33,15081
10/2/2017,14,10240,476,3653,551,314,26,15260
10/2/2017,15,10340,564,3805,603,259,30,15601
10/2/2017,16,10400,612,4696,643,173,32,16556
10/2/2017,17,10394,670,4721,714,89,33,16621
10/2/2017,18,10398,836,4858,758,18,33,16901
10/2/2017,19,10397,981,4800,1042,0,34,17254
10/2/2017,20,10396,923,4399,1402,0,34,17154
10/2/2017,21,10399,776,3695,1343,0,34,16247
10/2/2017,22,10390,682,3286,1112,0,33,15503
10/2/2017,23,10387,681,2827,471,0,18,14384
10/2/2017,24,10401,680,2508,379,0,16,13984
10/3/2017,1,10408,346,2311,823,0,16,13904
10/3/2017,2,10400,274,2304,606,0,17,13601
10/3/2017,3,10398,274,2355,477,0,17,13521
10/3/2017,4,10399,251,2357,545,0,17,13569
10/3/2017,5,10394,202,2479,805,0,20,13900
10/3/2017,6,10398,246,3152,891,0,25,14712
10/3/2017,7,10392,244,3625,1607,10,29,15907
10/3/2017,8,10389,239,3559,1588,85,24,15884
10/3/2017,9,10349,235,3462,1259,185,25,15515
10/3/2017,10,10346,232,3564,1158,265,26,15591
10/3/2017,11,10344,231,3505,1206,305,26,15617
10/3/2017,12,10335,231,3578,1412,313,27,15896
10/3/2017,13,10332,239,3496,1582,316,26,15991
10/3/2017,14,10328,234,3481,1752,301,26,16122
10/3/2017,15,10339,240,3677,1581,239,27,16103
10/3/2017,16,10363,265,4127,1461,172,26,16414
10/3/2017,17,10374,267,4079,1458,96,26,16300
10/3/2017,18,10371,256,4384,1251,15,24,16301
10/3/2017,19,10375,256,4375,1483,0,25,16514
10/3/2017,20,10368,256,4263,1853,0,25,16765
10/3/2017,21,10363,255,3837,2023,0,24,16502
10/3/2017,22,10367,257,3358,1812,0,25,15819
10/3/2017,23,10376,256,3075,1018,0,13,14738
10/3/2017,24,10383,258,2436,1204,0,11,14292
10/4/2017,1,10377,256,2315,921,0,12,13881
10/4/2017,2,10381,256,2292,594,0,14,13537
10/4/2017,3,10392,299,2190,563,0,14,13458
10/4/2017,4,10387,325,2324,343,0,14,13393
10/4/2017,5,10391,360,2567,520,0,20,13858
10/4/2017,6,10390,377,2935,1361,0,23,15086
10/4/2017,7,10389,415,3320,2136,6,27,16293
10/4/2017,8,10374,444,3495,2233,44,27,16617
10/4/2017,9,10342,458,3505,2088,85,27,16505
10/4/2017,10,10274,479,3900,2067,102,27,16849
10/4/2017,11,10275,515,3319,2224,175,26,16534
10/4/2017,12,10290,730,3294,2253,158,27,16752
10/4/2017,13,10378,853,3628,2174,104,26,17163
10/4/2017,14,10379,936,3768,2033,75,27,17218
10/4/2017,15,10385,1074,3991,1906,61,27,17444
10/4/2017,16,10372,1081,4325,1744,60,25,17607
10/4/2017,17,10371,1083,4380,1581,23,27,17465
10/4/2017,18,10375,1102,4729,1493,7,26,17732
10/4/2017,19,10382,1090,4387,1285,0,26,17170
10/4/2017,20,10381,1100,4184,1219,0,26,16910
10/4/2017,21,10381,499,4098,951,0,25,15954
10/4/2017,22,10389,301,3854,769,0,27,15340
10/4/2017,23,10394,265,3168,806,0,18,14651
10/4/2017,24,10401,263,3027,687,0,17,14395
10/5/2017,1,10410,266,2659,617,0,16,13968
10/5/2017,2,10416,266,2572,395,0,15,13664
10/5/2017,3,10418,283,2555,319,0,18,13593
10/5/2017,4,10421,271,2614,350,0,18,13674
10/5/2017,5,10408,273,2678,354,0,21,13734
10/5/2017,6,10412,278,3131,541,0,24,14386
10/5/2017,7,10411,269,3833,629,7,27,15176
10/5/2017,8,10382,268,4044,601,82,27,15404
10/5/2017,9,10363,267,3876,517,176,27,15226
10/5/2017,10,10360,266,3869,701,245,27,15468
10/5/2017,11,10371,264,3703,1030,290,27,15685
10/5/2017,12,10365,264,3523,1208,288,27,15675
10/5/2017,13,10370,264,3438,1432,293,27,15824
10/5/2017,14,10398,263,3307,1682,291,27,15968
10/5/2017,15,10399,262,3512,1663,242,43,16121
10/5/2017,16,10407,263,4095,1464,193,79,16501
10/5/2017,17,10475,269,4544,1257,90,104,16739
10/5/2017,18,10499,314,4932,949,15,108,16817
10/5/2017,19,10502,376,4843,859,0,123,16703
10/5/2017,20,10500,289,4589,862,0,115,16355
10/5/2017,21,10510,286,4440,708,0,152,16096
10/5/2017,22,10511,319,4144,559,0,159,15692
10/5/2017,23,10524,295,3632,449,0,53,14953
10/5/2017,24,10523,298,2781,382,0,13,13997
10/6/2017,1,10523,296,2500,275,0,17,13611
10/6/2017,2,10514,271,2571,141,0,14,13511
10/6/2017,3,10265,267,2727,118,0,17,13394
10/6/2017,4,10281,265,2724,182,0,16,13468
10/6/2017,5,10288,266,2812,149,0,18,13533
10/6/2017,6,10549,267,3399,102,0,22,14339
10/6/2017,7,10572,301,3990,92,1,25,14981
10/6/2017,8,10569,297,4294,85,20,24,15289
10/6/2017,9,10570,265,4380,50,64,26,15355
10/6/2017,10,10571,317,4405,27,116,27,15463
10/6/2017,11,10461,313,4311,30,140,26,15281
10/6/2017,12,10539,353,4146,40,139,27,15244
10/6/2017,13,10587,351,4405,51,128,26,15548
10/6/2017,14,10597,416,4174,75,143,27,15432
10/6/2017,15,10594,461,4020,53,126,27,15281
10/6/2017,16,10579,460,4278,28,56,26,15427
10/6/2017,17,10567,462,4236,35,29,26,15355
10/6/2017,18,10569,463,4319,70,4,27,15452
10/6/2017,19,10574,465,4499,107,0,27,15672
10/6/2017,20,10567,478,4898,157,0,27,16127
10/6/2017,21,10556,539,4851,236,0,27,16209
10/6/2017,22,10567,495,4237,501,0,27,15827
10/6/2017,23,10575,315,3654,775,0,17,15336
10/6/2017,24,10578,266,2726,793,0,11,14374
10/7/2017,1,10580,264,2497,726,0,0,14067
10/7/2017,2,10598,265,2433,653,0,0,13949
10/7/2017,3,10603,267,2380,722,0,0,13972
10/7/2017,4,10610,281,2377,806,0,0,14074
10/7/2017,5,10608,287,2499,720,0,0,14114
10/7/2017,6,10596,292,2466,714,0,0,14068
10/7/2017,7,10594,292,2673,1087,1,0,14647
10/7/2017,8,10582,291,3062,1472,6,0,15413
10/7/2017,9,10585,291,3206,2103,22,0,16207
10/7/2017,10,10594,291,3374,2253,79,0,16591
10/7/2017,11,10594,289,3508,2103,138,0,16632
10/7/2017,12,10596,290,3233,2162,212,0,16493
10/7/2017,13,10587,287,3048,2170,205,0,16297
10/7/2017,14,10547,286,3084,2184,183,0,16284
10/7/2017,15,10588,284,3055,2120,139,0,16186
10/7/2017,16,10588,283,3199,2202,125,0,16397
10/7/2017,17,10584,283,3202,2514,73,0,16656
10/7/2017,18,10582,285,3307,2640,10,0,16824
10/7/2017,19,10581,285,3582,2515,0,0,16963
10/7/2017,20,10579,287,3435,2717,0,0,17018
10/7/2017,21,10566,287,3159,2521,0,0,16533
10/7/2017,22,10565,285,2789,2194,0,0,15833
10/7/2017,23,10578,285,2512,1705,0,0,15080
10/7/2017,24,10579,286,2436,1376,0,0,14677
10/8/2017,1,10579,285,2449,1119,0,0,14432
10/8/2017,2,10377,286,2334,1173,0,0,14170
10/8/2017,3,10066,284,2392,1145,0,0,13887
10/8/2017,4,10052,284,2404,1185,0,0,13925
10/8/2017,5,10031,283,2473,1170,0,0,13957
10/8/2017,6,10026,284,2543,880,0,0,13733
10/8/2017,7,10024,285,2713,507,2,0,13531
10/8/2017,8,10022,285,3164,627,32,0,14130
10/8/2017,9,10029,288,3505,955,86,0,14863
10/8/2017,10,10052,259,3462,1489,134,0,15396
10/8/2017,11,10065,263,3721,1366,173,0,15588
10/8/2017,12,10094,264,4220,832,159,0,15569
10/8/2017,13,10118,381,4198,718,156,0,15571
10/8/2017,14,10134,366,3880,673,231,1,15285
10/8/2017,15,10146,435,3671,649,198,0,15099
10/8/2017,16,10147,482,3794,625,135,0,15183
10/8/2017,17,10151,482,4278,561,50,0,15522
10/8/2017,18,10146,484,3885,429,7,6,14957
10/8/2017,19,10137,485,4088,545,0,4,15259
10/8/2017,20,10133,497,4402,659,0,0,15691
10/8/2017,21,10128,489,3898,841,0,0,15356
10/8/2017,22,10132,334,3272,977,0,0,14715
10/8/2017,23,10145,289,3265,846,0,0,14545
10/8/2017,24,10140,289,2773,683,0,0,13885
10/9/2017,1,10135,290,2406,550,0,0,13381
10/9/2017,2,10133,291,2378,260,0,0,13062
10/9/2017,3,9994,289,2369,276,0,0,12928
10/9/2017,4,9624,291,2425,484,0,1,12825
10/9/2017,5,9546,290,2456,887,0,0,13179
10/9/2017,6,9535,290,2486,834,1,0,13146
10/9/2017,7,9838,289,2787,476,1,0,13391
10/9/2017,8,10126,291,2925,558,19,0,13919
10/9/2017,9,10123,291,3361,782,77,0,14634
10/9/2017,10,10119,289,4070,685,104,0,15267
10/9/2017,11,10107,287,4170,527,126,0,15217
10/9/2017,12,10098,285,3894,395,178,0,14850
10/9/2017,13,10097,282,4326,235,198,0,15138
10/9/2017,14,10095,283,4283,195,182,0,15038
10/9/2017,15,10085,282,3933,274,155,0,14729
10/9/2017,16,10081,284,4393,310,108,3,15179
10/9/2017,17,10074,289,4785,336,54,3,15541
10/9/2017,18,10078,306,5001,356,10,16,15767
10/9/2017,19,10077,286,4906,387,0,9,15665
10/9/2017,20,10081,285,5007,380,0,0,15753
10/9/2017,21,10093,286,4612,373,0,0,15364
10/9/2017,22,10102,286,4213,440,0,0,15041
10/9/2017,23,10107,282,3302,482,0,0,14173
10/9/2017,24,10105,282,2864,421,0,0,13672
10/10/2017,1,10101,281,2537,411,0,0,13330
10/10/2017,2,10080,283,2482,305,0,3,13153
10/10/2017,3,10065,284,2502,153,0,8,13012
10/10/2017,4,10063,283,2474,249,0,13,13082
10/10/2017,5,10058,292,2772,207,0,28,13357
10/10/2017,6,10055,337,3436,263,0,35,14126
10/10/2017,7,10057,392,4570,478,2,51,15550
10/10/2017,8,10059,412,4158,547,44,81,15301
10/10/2017,9,10068,496,4287,341,154,114,15460
10/10/2017,10,10078,492,4474,345,244,117,15750
10/10/2017,11,10069,499,4370,376,280,116,15710
10/10/2017,12,10048,501,4225,469,292,116,15651
10/10/2017,13,10041,497,4389,477,269,114,15787
10/10/2017,14,10036,491,4183,628,257,115,15710
10/10/2017,15,10034,492,4162,950,219,119,15976
10/10/2017,16,10041,496,4641,979,117,120,16394
10/10/2017,17,10042,506,4804,941,51,121,16465
10/10/2017,18,10050,514,4912,880,5,116,16477
10/10/2017,19,10053,502,4895,1071,0,125,16646
10/10/2017,20,10049,495,4541,1105,0,130,16320
10/10/2017,21,10059,332,3934,1083,0,72,15480
10/10/2017,22,10082,289,3507,889,0,61,14828
10/10/2017,23,10095,291,3043,1002,0,53,14484
10/10/2017,24,10085,291,2610,884,0,39,13909
10/11/2017,1,10090,288,2365,713,0,36,13492
10/11/2017,2,10082,289,2342,442,0,49,13204
10/11/2017,3,10078,287,2329,702,0,50,13446
10/11/2017,4,10079,288,2325,746,0,52,13490
10/11/2017,5,10081,288,2368,774,0,66,13577
10/11/2017,6,10078,292,2434,1907,0,111,14822
10/11/2017,7,10078,290,2864,2476,0,115,15823
10/11/2017,8,10078,290,3302,2740,15,108,16533
10/11/2017,9,10070,292,3282,2835,38,109,16626
10/11/2017,10,10066,289,3288,2905,59,102,16709
10/11/2017,11,10065,304,3365,2673,77,117,16601
10/11/2017,12,10075,315,3425,2553,82,123,16573
10/11/2017,13,10081,319,3528,2464,63,117,16572
10/11/2017,14,10080,318,3586,2378,74,113,16549
10/11/2017,15,10081,318,3703,2223,57,121,16503
10/11/2017,16,10081,318,3745,2630,44,135,16953
10/11/2017,17,10084,314,4066,2731,18,98,17311
10/11/2017,18,10096,317,4113,2805,2,115,17448
10/11/2017,19,10088,322,4163,2796,0,147,17516
10/11/2017,20,10087,322,4184,2716,0,162,17471
10/11/2017,21,10083,321,3714,2556,0,184,16858
10/11/2017,22,10080,320,2987,2206,0,169,15762
10/11/2017,23,10082,321,2615,1600,0,84,14702
10/11/2017,24,10090,294,2561,951,0,27,13923
10/12/2017,1,10091,292,2499,725,0,15,13622
10/12/2017,2,10090,292,2429,845,0,15,13671
10/12/2017,3,10079,293,2452,692,0,15,13531
10/12/2017,4,10073,294,2543,719,0,14,13643
10/12/2017,5,10077,293,2595,812,0,14,13791
10/12/2017,6,10091,293,2952,1661,0,22,15019
10/12/2017,7,10044,294,3863,1831,4,25,16061
10/12/2017,8,10045,294,4346,1640,42,50,16417
10/12/2017,9,10039,293,4292,1558,96,87,16365
10/12/2017,10,9974,288,4049,1538,122,124,16095
10/12/2017,11,9874,290,4206,1367,175,130,16042
10/12/2017,12,10033,289,4102,1178,197,152,15951
10/12/2017,13,10066,281,4006,1300,163,166,15982
10/12/2017,14,10091,283,3933,1312,172,166,15957
10/12/2017,15,10086,284,4029,1267,138,165,15969
10/12/2017,16,10091,287,4426,1249,89,165,16307
10/12/2017,17,10083,289,4787,1169,40,162,16530
10/12/2017,18,10072,289,5051,1100,1,112,16625
10/12/2017,19,10071,292,5095,1174,0,101,16733
10/12/2017,20,10060,291,4809,1276,0,169,16605
10/12/2017,21,10050,290,4216,1548,0,177,16281
10/12/2017,22,10049,290,3691,1648,0,141,15819
10/12/2017,23,10053,290,3034,1549,0,35,14961
10/12/2017,24,10054,290,2541,1476,0,15,14376
10/13/2017,1,10054,289,2450,1057,0,14,13864
10/13/2017,2,10065,289,2436,842,0,13,13645
10/13/2017,3,10076,288,2418,908,0,13,13703
10/13/2017,4,10079,286,2472,902,0,13,13752
10/13/2017,5,10071,285,2538,723,0,16,13633
10/13/2017,6,10072,286,3096,786,0,19,14259
10/13/2017,7,10070,287,4114,855,1,28,15355
10/13/2017,8,10055,290,4558,809,6,52,15770
10/13/2017,9,10019,410,4894,795,20,88,16226
10/13/2017,10,9960,308,4635,725,51,138,15817
10/13/2017,11,9963,398,4529,658,108,149,15805
10/13/2017,12,10045,316,4425,640,110,155,15691
10/13/2017,13,10046,291,4326,650,127,164,15604
10/13/2017,14,10052,335,4666,695,120,157,16025
10/13/2017,15,10055,299,4423,595,97,139,15608
10/13/2017,16,10074,310,4981,678,93,175,16311
10/13/2017,17,10080,394,5263,493,28,202,16460
10/13/2017,18,10080,350,5152,407,3,138,16130
10/13/2017,19,10080,291,5189,480,0,165,16205
10/13/2017,20,10078,307,5014,569,0,202,16170
10/13/2017,21,10071,292,4662,702,0,209,15936
10/13/2017,22,10070,301,4192,785,0,190,15538
10/13/2017,23,10062,244,3350,945,0,102,14703
10/13/2017,24,10059,240,2582,966,0,8,13855
10/14/2017,1,10063,239,2344,982,0,0,13628
10/14/2017,2,10068,239,2406,576,0,0,13289
10/14/2017,3,10069,239,2448,402,0,0,13158
10/14/2017,4,10062,239,2412,313,0,0,13026
10/14/2017,5,10056,241,2532,327,0,0,13156
10/14/2017,6,10051,240,2706,186,1,0,13184
10/14/2017,7,10052,241,3513,190,1,0,13997
10/14/2017,8,10055,249,4273,133,13,0,14723
10/14/2017,9,10055,280,5033,88,40,1,15497
10/14/2017,10,10071,375,5111,61,71,7,15696
10/14/2017,11,10079,277,4759,69,106,7,15297
10/14/2017,12,10070,233,4653,149,129,3,15237
10/14/2017,13,10068,230,4595,215,154,0,15262
10/14/2017,14,10062,232,4487,149,135,0,15065
10/14/2017,15,10058,290,4560,18,78,11,15015
10/14/2017,16,10059,530,4591,160,43,57,15440
10/14/2017,17,10060,393,4183,472,14,98,15220
10/14/2017,18,10062,326,3892,749,1,100,15130
10/14/2017,19,10060,234,3751,858,0,100,15003
10/14/2017,20,10058,233,3571,1017,0,86,14965
10/14/2017,21,10051,234,3551,1313,0,9,15158
10/14/2017,22,10058,234,3103,1673,0,0,15068
10/14/2017,23,10061,235,2915,1115,0,0,14326
10/14/2017,24,10053,234,2471,962,0,0,13720
10/15/2017,1,10054,235,2384,936,0,0,13609
10/15/2017,2,10054,235,2317,802,0,0,13408
10/15/2017,3,10060,234,2352,542,0,0,13188
10/15/2017,4,10060,233,2293,464,0,0,13050
10/15/2017,5,10060,231,2402,402,0,0,13095
10/15/2017,6,10059,233,2496,686,0,0,13474
10/15/2017,7,10059,233,2829,831,0,0,13952
10/15/2017,8,10053,232,3138,1058,11,0,14492
10/15/2017,9,10056,231,3235,1501,39,0,15062
10/15/2017,10,10040,231,3335,1942,56,0,15604
10/15/2017,11,10045,230,3488,2159,67,0,15989
10/15/2017,12,10047,229,3378,2527,91,0,16272
10/15/2017,13,10043,236,3340,2562,69,0,16250
10/15/2017,14,10046,234,3207,2783,46,0,16316
10/15/2017,15,10002,235,3092,2838,44,0,16211
10/15/2017,16,10023,236,3258,2439,29,0,15985
10/15/2017,17,10016,230,3454,2565,19,0,16284
10/15/2017,18,10013,233,3612,2575,2,0,16435
10/15/2017,19,10016,236,3652,2865,0,0,16769
10/15/2017,20,10028,236,3438,2653,0,0,16355
10/15/2017,21,10052,237,3397,2149,0,0,15835
10/15/2017,22,10068,237,3267,1285,0,0,14857
10/15/2017,23,10079,238,3148,805,0,6,14276
10/15/2017,24,10085,238,2724,536,0,13,13596
10/16/2017,1,10092,238,2395,740,0,7,13472
10/16/2017,2,10097,247,2396,534,0,7,13281
10/16/2017,3,10096,250,2408,458,0,7,13219
10/16/2017,4,10099,269,2411,656,0,10,13445
10/16/2017,5,10097,280,2464,510,0,14,13365
10/16/2017,6,10100,320,3140,599,0,19,14178
10/16/2017,7,10104,422,3668,743,2,25,14964
10/16/2017,8,10108,479,3610,819,46,27,15089
10/16/2017,9,10109,508,3594,749,133,27,15120
10/16/2017,10,10102,504,3666,830,156,27,15285
10/16/2017,11,10102,514,3580,726,160,27,15109
10/16/2017,12,10110,544,3717,716,187,27,15301
10/16/2017,13,10113,553,3950,561,188,27,15392
10/16/2017,14,10107,582,3782,492,208,27,15198
10/16/2017,15,10116,617,3555,450,197,27,14962
10/16/2017,16,10116,739,3814,326,150,27,15172
10/16/2017,17,10121,878,4197,222,65,27,15510
10/16/2017,18,10131,903,4615,176,4,27,15856
10/16/2017,19,10132,990,4598,272,0,27,16019
10/16/2017,20,10137,711,4127,511,0,27,15513
10/16/2017,21,10128,553,4064,784,0,27,15556
10/16/2017,22,10127,345,3434,1008,0,27,14941
10/16/2017,23,10134,296,2992,858,0,20,14300
10/16/2017,24,10138,295,3034,412,0,15,13894
10/17/2017,1,9913,296,2747,723,0,14,13693
10/17/2017,2,9846,297,2641,700,0,14,13498
10/17/2017,3,9843,300,2653,573,0,15,13384
10/17/2017,4,9840,301,2676,640,0,14,13471
10/17/2017,5,9844,302,2789,645,0,22,13602
10/17/2017,6,9975,321,3057,1418,0,28,14799
10/17/2017,7,10140,338,3105,1999,3,46,15631
10/17/2017,8,10137,322,3277,1851,34,77,15698
10/17/2017,9,10147,325,3257,1744,123,132,15728
10/17/2017,10,10153,327,3195,1496,196,134,15501
10/17/2017,11,10139,325,3226,1130,227,133,15180
10/17/2017,12,10132,325,3306,863,167,132,14925
10/17/2017,13,10137,381,3192,1539,285,132,15666
10/17/2017,14,10139,458,3247,1349,218,132,15543
10/17/2017,15,10140,555,3299,932,161,131,15218
10/17/2017,16,10145,535,3543,1052,99,132,15506
10/17/2017,17,10142,689,3673,1469,49,135,16157
10/17/2017,18,10146,692,4164,1695,5,136,16838
10/17/2017,19,10144,691,3969,1970,0,136,16910
10/17/2017,20,10142,524,3784,2155,0,123,16728
10/17/2017,21,10140,360,3674,2125,0,40,16339
10/17/2017,22,10144,335,3225,1345,0,32,15081
10/17/2017,23,10163,368,3098,660,0,25,14314
10/17/2017,24,10026,386,2934,567,0,21,13934
10/18/2017,1,9734,389,2904,515,0,20,13562
10/18/2017,2,9398,389,2786,505,0,20,13098
10/18/2017,3,9357,390,2668,617,0,19,13051
10/18/2017,4,9361,307,2753,761,0,20,13202
10/18/2017,5,9374,298,2909,1118,0,26,13725
10/18/2017,6,9670,299,3163,1389,0,31,14552
10/18/2017,7,10218,300,3296,1597,2,47,15460
10/18/2017,8,10230,300,3329,1553,65,89,15566
10/18/2017,9,10241,294,3330,1197,182,132,15376
10/18/2017,10,10244,291,3248,1073,267,136,15259
10/18/2017,11,10249,296,3072,1046,309,135,15107
10/18/2017,12,10108,290,2978,1168,325,136,15005
10/18/2017,13,10115,289,3063,1092,305,136,15000
10/18/2017,14,10240,288,3072,1163,230,136,15129
10/18/2017,15,10242,286,3302,1175,227,136,15368
10/18/2017,16,10250,286,3413,1425,166,136,15676
10/18/2017,17,10250,286,3763,1862,79,135,16375
10/18/2017,18,10253,293,4117,2042,5,135,16845
10/18/2017,19,10249,294,4153,2236,0,136,17068
10/18/2017,20,10265,295,3796,2258,0,135,16749
10/18/2017,21,10286,295,3546,2167,0,72,16366
10/18/2017,22,10290,296,3179,1517,0,32,15314
10/18/2017,23,10297,296,2950,1112,0,23,14678
10/18/2017,24,10166,297,2754,641,0,17,13875
10/19/2017,1,9543,296,2617,850,0,16,13322
10/19/2017,2,9285,297,2607,717,0,16,12922
10/19/2017,3,9101,296,2601,969,0,16,12983
10/19/2017,4,9104,296,2620,1009,0,16,13045
10/19/2017,5,9277,296,2583,1385,0,18,13559
10/19/2017,6,9888,296,2938,1414,0,28,14564
10/19/2017,7,10232,295,3135,2174,1,68,15905
10/19/2017,8,10184,297,3164,2141,48,97,15931
10/19/2017,9,10172,296,3137,1891,125,130,15751
10/19/2017,10,10166,298,3321,1507,193,130,15615
10/19/2017,11,10163,304,3225,1467,221,132,15512
10/19/2017,12,10193,336,3249,1191,232,141,15342
10/19/2017,13,10234,376,3311,1169,244,141,15475
10/19/2017,14,10240,449,3232,1313,194,141,15569
10/19/2017,15,10228,538,3286,1335,155,141,15683
10/19/2017,16,10246,567,3340,1777,139,145,16214
10/19/2017,17,10249,690,3672,1778,50,147,16586
10/19/2017,18,10253,695,4304,1537,4,142,16935
10/19/2017,19,10251,694,4887,1416,0,131,17379
10/19/2017,20,10244,697,4478,1392,0,131,16942
10/19/2017,21,10237,392,3954,1243,0,67,15893
10/19/2017,22,10243,301,3631,890,0,25,15090
10/19/2017,23,10245,302,3496,539,0,19,14601
10/19/2017,24,9949,303,3193,443,0,13,13901
10/20/2017,1,9513,303,3000,608,0,11,13435
10/20/2017,2,9395,305,2918,566,0,11,13195
10/20/2017,3,9394,305,2906,477,0,11,13093
10/20/2017,4,9391,306,2953,538,0,11,13199
10/20/2017,5,9484,305,3189,695,0,14,13687
10/20/2017,6,9815,306,3929,594,0,21,14665
10/20/2017,7,10237,318,4581,397,1,26,15560
10/20/2017,8,10253,302,4501,375,65,51,15547
10/20/2017,9,10247,303,4037,300,148,79,15114
10/20/2017,10,10248,310,3871,200,203,79,14911
10/20/2017,11,10244,300,3764,399,311,81,15099
10/20/2017,12,10248,298,3707,631,284,94,15262
10/20/2017,13,10240,298,3386,550,281,94,14849
10/20/2017,14,10247,298,3395,1087,270,99,15396
10/20/2017,15,10240,297,3387,1089,222,104,15339
10/20/2017,16,10236,295,3810,964,168,111,15584
10/20/2017,17,10237,296,4428,1172,63,107,16303
10/20/2017,18,10235,296,4912,1302,2,60,16807
10/20/2017,19,10231,300,4493,1569,0,26,16619
10/20/2017,20,10233,297,3934,1490,0,27,15981
10/20/2017,21,10233,300,3688,1798,0,27,16046
10/20/2017,22,10229,301,3443,1477,0,27,15477
10/20/2017,23,10226,251,3260,806,0,33,14576
10/20/2017,24,9768,247,3137,901,0,30,14083
10/21/2017,1,9230,245,2944,1168,0,3,13590
10/21/2017,2,9078,243,3072,1080,0,0,13473
10/21/2017,3,9083,247,2988,1022,0,0,13340
10/21/2017,4,9075,248,3014,805,0,0,13142
10/21/2017,5,9071,247,3099,928,0,8,13353
10/21/2017,6,9080,246,3396,1161,0,8,13891
10/21/2017,7,9151,246,3706,1435,1,0,14539
10/21/2017,8,9570,245,3640,1292,46,0,14793
10/21/2017,9,9621,246,3829,1166,118,0,14980
10/21/2017,10,9685,245,4176,840,197,0,15143
10/21/2017,11,9925,245,3922,750,232,0,15074
10/21/2017,12,9922,246,4058,831,199,0,15256
10/21/2017,13,10158,245,3748,851,198,0,15200
10/21/2017,14,10210,242,3754,688,172,0,15066
10/21/2017,15,10212,243,3851,828,149,0,15283
10/21/2017,16,10212,242,4093,967,96,0,15610
10/21/2017,17,10206,240,4066,1175,34,0,15721
10/21/2017,18,10210,245,4255,1267,1,0,15978
10/21/2017,19,10203,245,4222,1528,0,0,16198
10/21/2017,20,10202,245,4057,1494,0,0,15998
10/21/2017,21,10200,245,3671,1344,0,0,15460
10/21/2017,22,10196,244,3508,835,0,0,14783
10/21/2017,23,9887,246,3272,825,0,0,14230
10/21/2017,24,9138,256,3015,1267,0,0,13676
10/22/2017,1,9044,285,2856,1152,0,0,13337
10/22/2017,2,9042,319,2724,968,0,0,13053
10/22/2017,3,9045,332,2829,913,0,0,13119
10/22/2017,4,9044,328,2755,890,0,0,13017
10/22/2017,5,9044,330,2741,1025,0,0,13140
10/22/2017,6,9224,331,2901,1014,0,0,13470
10/22/2017,7,9379,260,3065,1214,1,0,13919
10/22/2017,8,9595,245,3174,965,51,0,14030
10/22/2017,9,9596,244,3245,786,135,0,14006
10/22/2017,10,9595,243,3275,797,194,0,14104
10/22/2017,11,9597,245,3334,1112,245,0,14533
10/22/2017,12,9595,246,3384,1184,257,0,14666
10/22/2017,13,9593,247,3273,1057,261,0,14431
10/22/2017,14,9301,291,3655,1038,233,0,14518
10/22/2017,15,9270,294,3524,1516,175,0,14779
10/22/2017,16,9428,245,4187,1517,102,0,15479
10/22/2017,17,9563,244,4042,1718,22,0,15589
10/22/2017,18,9563,245,4369,1903,2,0,16082
10/22/2017,19,9560,246,4710,1966,0,0,16482
10/22/2017,20,9570,247,4010,2182,0,0,16009
10/22/2017,21,9647,247,3869,1899,0,0,15662
10/22/2017,22,9724,246,3746,1219,0,0,14935
10/22/2017,23,9724,245,3355,621,0,0,13945
10/22/2017,24,9728,246,3165,594,0,0,13733
10/23/2017,1,9718,247,2908,528,0,1,13402
10/23/2017,2,9696,247,3025,368,0,10,13346
10/23/2017,3,9444,248,2935,615,0,11,13253
10/23/2017,4,9426,247,2971,628,0,11,13283
10/23/2017,5,9427,245,3213,634,0,14,13533
10/23/2017,6,9646,253,3703,1042,0,18,14662
10/23/2017,7,9722,297,3830,1589,0,25,15463
10/23/2017,8,9735,302,3809,1525,16,26,15413
10/23/2017,9,9781,301,3680,1693,63,26,15544
10/23/2017,10,9786,302,4146,1720,87,26,16067
10/23/2017,11,9790,329,4218,1856,109,26,16328
10/23/2017,12,9780,326,3668,2169,132,26,16101
10/23/2017,13,9779,326,3696,2193,98,26,16118
10/23/2017,14,9726,326,3908,2137,75,27,16199
10/23/2017,15,9723,348,3622,2074,41,28,15836
10/23/2017,16,9856,325,3701,2135,15,26,16058
10/23/2017,17,10034,327,3936,2362,4,26,16689
10/23/2017,18,10075,328,4016,2772,0,15,17206
10/23/2017,19,10070,326,4060,2983,0,21,17460
10/23/2017,20,10058,327,4010,3124,0,26,17545
10/23/2017,21,10072,327,3794,2898,0,27,17118
10/23/2017,22,10073,299,3410,2324,0,26,16132
10/23/2017,23,10073,296,3045,1415,0,20,14849
10/23/2017,24,10072,297,2893,1115,0,22,14399
10/24/2017,1,10070,298,2761,972,0,27,14128
10/24/2017,2,10067,296,2754,660,0,28,13805
10/24/2017,3,9983,295,2840,578,0,19,13715
10/24/2017,4,9747,295,2886,893,0,16,13837
10/24/2017,5,9749,294,2945,731,0,26,13745
10/24/2017,6,9796,319,3283,955,0,37,14390
10/24/2017,7,10060,325,3433,1953,0,38,15809
10/24/2017,8,10019,323,3575,2187,8,21,16133
10/24/2017,9,9925,325,3619,1908,54,29,15860
10/24/2017,10,9937,327,3510,1848,136,23,15781
10/24/2017,11,10000,326,3635,1438,118,39,15556
10/24/2017,12,10105,326,3702,1108,162,53,15456
10/24/2017,13,10103,317,3686,1258,138,48,15550
10/24/2017,14,10116,319,3640,1448,102,27,15652
10/24/2017,15,10104,328,3743,1431,91,21,15718
10/24/2017,16,10108,326,3799,1602,105,26,15966
10/24/2017,17,10112,328,3845,2334,22,26,16667
10/24/2017,18,10114,329,3941,2637,0,26,17047
10/24/2017,19,10112,330,3858,2985,0,26,17311
10/24/2017,20,10101,331,3752,2656,0,26,16866
10/24/2017,21,10092,333,3668,2028,0,26,16147
10/24/2017,22,10097,332,3471,1211,0,26,15137
10/24/2017,23,10111,304,3292,843,0,17,14567
10/24/2017,24,10039,301,3103,499,0,14,13956
10/25/2017,1,9818,299,2817,785,0,14,13733
10/25/2017,2,9820,296,2871,550,0,24,13561
10/25/2017,3,9822,300,2838,434,0,25,13419
10/25/2017,4,9831,300,2828,422,0,16,13397
10/25/2017,5,9834,301,3066,374,0,18,13593
10/25/2017,6,9854,302,3325,848,0,22,14351
10/25/2017,7,10115,301,3637,1926,0,26,16005
10/25/2017,8,10130,302,3749,2100,21,26,16328
10/25/2017,9,10129,303,3816,1856,91,26,16221
10/25/2017,10,10053,302,3922,1409,132,26,15844
10/25/2017,11,9981,302,3870,1242,156,26,15577
10/25/2017,12,10128,337,3890,1028,166,26,15575
10/25/2017,13,10130,368,4172,787,137,26,15620
10/25/2017,14,10141,414,4186,827,125,26,15719
10/25/2017,15,10153,503,4146,885,89,26,15802
10/25/2017,16,10151,877,4762,590,78,26,16484
10/25/2017,17,10069,1054,5368,364,26,26,16907
10/25/2017,18,10051,1130,5383,208,1,26,16799
10/25/2017,19,10152,1089,5336,179,0,27,16783
10/25/2017,20,10154,1065,5264,144,0,26,16653
10/25/2017,21,10154,960,5197,143,0,26,16480
10/25/2017,22,10160,615,4841,174,0,26,15816
10/25/2017,23,10158,488,3948,174,0,18,14786
10/25/2017,24,10160,311,3500,225,0,14,14210
10/26/2017,1,10159,302,3551,233,0,12,14257
10/26/2017,2,10158,302,3347,161,0,12,13980
10/26/2017,3,10147,302,3251,162,0,12,13874
10/26/2017,4,10152,301,3309,169,0,13,13944
10/26/2017,5,10149,301,3802,167,0,16,14435
10/26/2017,6,10147,307,4441,147,0,23,15065
10/26/2017,7,10132,431,5091,138,0,32,15824
10/26/2017,8,10137,467,4959,142,48,50,15803
10/26/2017,9,10156,405,4651,119,163,27,15521
10/26/2017,10,10158,331,4351,60,240,26,15166
10/26/2017,11,10152,409,4404,136,251,26,15378
10/26/2017,12,10151,409,4131,149,161,26,15027
10/26/2017,13,10156,434,4302,552,203,27,15674
10/26/2017,14,10150,474,4353,550,167,26,15720
10/26/2017,15,10147,616,4480,468,125,26,15862
10/26/2017,16,10145,703,4710,414,124,26,16122
10/26/2017,17,10140,855,4783,360,40,26,16204
10/26/2017,18,10138,953,5373,274,0,26,16764
10/26/2017,19,10140,915,5420,259,0,27,16761
10/26/2017,20,10141,871,5289,228,0,27,16556
10/26/2017,21,10044,579,4972,345,0,27,15967
10/26/2017,22,9540,370,4560,413,0,27,14910
10/26/2017,23,9246,276,4081,671,0,19,14293
10/26/2017,24,9258,276,3940,639,0,15,14128
10/27/2017,1,9266,292,3712,776,0,11,14057
10/27/2017,2,9269,306,3514,940,0,11,14040
10/27/2017,3,9259,304,3139,1302,0,11,14015
10/27/2017,4,9266,307,2924,1451,0,13,13961
10/27/2017,5,9275,309,3240,1200,0,17,14041
10/27/2017,6,9285,310,3752,1755,0,22,15124
10/27/2017,7,9279,360,4604,2086,1,27,16357
10/27/2017,8,9271,304,4863,2197,28,27,16690
10/27/2017,9,9305,292,4609,2173,75,27,16481
10/27/2017,10,9334,284,4333,2038,133,27,16149
10/27/2017,11,9715,285,4396,1956,165,27,16544
10/27/2017,12,9723,288,4228,2086,183,27,16535
10/27/2017,13,9697,285,3941,2057,204,27,16211
10/27/2017,14,9699,287,4062,1991,194,27,16260
10/27/2017,15,9696,285,4327,2023,131,27,16489
10/27/2017,16,9700,287,4866,1784,75,27,16739
10/27/2017,17,9712,289,5071,1335,19,27,16453
10/27/2017,18,9718,347,5480,1081,0,28,16654
10/27/2017,19,9722,370,5287,1188,0,27,16594
10/27/2017,20,9718,335,5135,1136,0,27,16351
10/27/2017,21,9708,325,5059,953,0,27,16072
10/27/2017,22,9709,323,4775,783,0,26,15616
10/27/2017,23,9711,323,4240,885,0,20,15179
10/27/2017,24,9794,323,3311,830,0,9,14267
10/28/2017,1,9962,289,2839,580,0,5,13675
10/28/2017,2,10068,283,2759,326,0,4,13440
10/28/2017,3,9937,282,2762,256,0,0,13237
10/28/2017,4,9780,282,2894,184,0,0,13140
10/28/2017,5,9779,283,2978,507,0,0,13547
10/28/2017,6,9805,294,3205,687,0,0,13991
10/28/2017,7,10081,304,3441,738,0,0,14564
10/28/2017,8,10099,366,3930,839,15,4,15253
10/28/2017,9,10091,445,4267,796,54,2,15655
10/28/2017,10,10097,665,4098,859,63,8,15790
10/28/2017,11,10098,972,3982,881,101,9,16043
10/28/2017,12,10073,1120,3898,604,102,0,15797
10/28/2017,13,10079,1175,3720,658,84,2,15718
10/28/2017,14,10081,1193,3761,553,54,0,15642
10/28/2017,15,10102,1076,3855,827,56,0,15916
10/28/2017,16,10114,966,4311,916,29,0,16336
10/28/2017,17,10117,569,4958,877,8,0,16529
10/28/2017,18,10114,508,4954,933,0,0,16509
10/28/2017,19,10116,511,4633,1056,0,0,16316
10/28/2017,20,10109,508,4520,955,0,0,16092
10/28/2017,21,10114,373,4471,871,0,0,15829
10/28/2017,22,10178,283,4269,818,0,0,15548
10/28/2017,23,10181,283,3586,670,0,0,14720
10/28/2017,24,10179,283,3124,259,0,0,13845
10/29/2017,1,10185,284,2924,322,0,0,13715
10/29/2017,2,9967,284,2928,243,0,0,13422
10/29/2017,3,9905,284,2893,118,0,0,13200
10/29/2017,4,9682,285,2950,130,0,0,13047
10/29/2017,5,9605,284,3118,182,0,0,13189
10/29/2017,6,9626,283,3682,142,0,4,13737
10/29/2017,7,10049,292,3865,125,0,4,14335
10/29/2017,8,10208,298,4193,139,3,0,14841
10/29/2017,9,10202,329,4662,105,15,0,15313
10/29/2017,10,10199,367,4912,134,37,0,15649
10/29/2017,11,10186,445,4778,173,49,0,15631
10/29/2017,12,10173,670,4742,238,56,0,15879
10/29/2017,13,10173,1101,4431,329,50,0,16084
10/29/2017,14,10124,1162,4369,407,53,0,16115
10/29/2017,15,10170,1166,4256,508,41,4,16145
10/29/2017,16,10183,1140,4514,646,24,1,16508
10/29/2017,17,10180,1140,4764,618,9,0,16711
10/29/2017,18,10177,1121,5044,637,0,0,16979
10/29/2017,19,10188,589,4990,741,0,0,16508
10/29/2017,20,10223,352,4584,961,0,0,16120
10/29/2017,21,9751,225,4309,997,0,0,15282
10/29/2017,22,9390,226,4194,1252,0,0,15062
10/29/2017,23,9391,227,3390,1440,0,0,14448
10/29/2017,24,9386,226,3100,1338,0,0,14050
10/30/2017,1,9388,225,2720,1297,0,1,13631
10/30/2017,2,9393,225,2712,875,0,12,13217
10/30/2017,3,9387,226,2847,846,0,12,13318
10/30/2017,4,9385,226,2813,718,0,12,13154
10/30/2017,5,9391,226,2935,1342,0,13,13907
10/30/2017,6,9392,228,3517,1867,0,21,15025
10/30/2017,7,9384,227,4409,2112,0,36,16168
10/30/2017,8,9388,232,4751,2106,13,35,16525
10/30/2017,9,9393,221,4674,2144,74,26,16532
10/30/2017,10,9401,191,4724,2129,73,26,16544
10/30/2017,11,9408,215,4264,2109,144,26,16166
10/30/2017,12,9408,191,4306,2186,52,26,16169
10/30/2017,13,9415,289,4563,2364,34,23,16688
10/30/2017,14,9421,318,4410,2427,50,27,16653
10/30/2017,15,9422,408,4498,2382,51,29,16790
10/30/2017,16,9419,616,4826,2248,16,27,17152
10/30/2017,17,9415,685,5193,2108,6,27,17434
10/30/2017,18,9411,735,5479,2114,0,27,17766
10/30/2017,19,9413,661,5194,2345,0,27,17640
10/30/2017,20,9414,661,4836,2448,0,27,17386
10/30/2017,21,9404,662,4382,2537,0,27,17012
10/30/2017,22,9413,372,3887,2513,0,27,16212
10/30/2017,23,9411,261,3462,2406,0,14,15554
10/30/2017,24,9415,226,3339,1545,0,11,14536
10/31/2017,1,9416,226,3203,1115,0,11,13971
10/31/2017,2,9414,226,3190,856,0,11,13697
10/31/2017,3,9413,226,3231,840,0,12,13722
10/31/2017,4,9418,227,3219,826,0,14,13704
10/31/2017,5,9422,253,3200,1156,0,18,14049
10/31/2017,6,9428,257,3499,1828,0,21,15033
10/31/2017,7,9437,258,4383,2462,0,27,16567
10/31/2017,8,9438,256,4575,2373,10,27,16679
10/31/2017,9,9433,258,4295,2231,125,27,16369
10/31/2017,10,9424,266,4284,1923,164,27,16088
10/31/2017,11,9425,297,4371,2233,121,27,16474
10/31/2017,12,9433,396,4458,2111,96,27,16521
10/31/2017,13,9442,446,4204,2311,96,27,16526
10/31/2017,14,9450,848,4081,2014,134,27,16554
10/31/2017,15,9447,1041,4454,1730,98,27,16797
10/31/2017,16,9444,1280,4986,1360,68,27,17165
10/31/2017,17,9446,1197,5071,1080,13,27,16834
10/31/2017,18,9441,1136,4959,808,0,27,16371
10/31/2017,19,9451,1136,4679,755,0,25,16046
10/31/2017,20,9450,951,4833,966,0,23,16223
10/31/2017,21,9443,554,4770,976,0,23,15766
10/31/2017,22,9449,255,4718,794,0,24,15240
10/31/2017,23,9449,229,4215,765,0,17,14675
10/31/2017,24,9456,230,3872,633,0,11,14202
11/1/2017,1,9482,230,4102,460,0,11,14285
11/1/2017,2,9484,229,3557,298,0,10,13578
11/1/2017,3,9481,236,3451,273,0,18,13459
11/1/2017,4,9478,321,3377,304,0,19,13499
11/1/2017,5,9476,681,3551,261,0,27,13996
11/1/2017,6,9474,853,4445,279,0,34,15085
11/1/2017,7,9472,1360,5056,246,0,42,16176
11/1/2017,8,9476,1396,4988,260,4,39,16163
11/1/2017,9,9471,1384,4991,437,26,43,16352
11/1/2017,10,9422,1631,5011,490,48,46,16648
11/1/2017,11,9309,1591,4822,683,79,48,16532
11/1/2017,12,9308,1456,4843,633,84,46,16370
11/1/2017,13,9354,1226,4784,615,72,49,16100
11/1/2017,14,9479,1344,5114,468,50,47,16502
11/1/2017,15,9483,1802,5160,313,26,46,16830
11/1/2017,16,9481,1734,5184,266,12,36,16713
11/1/2017,17,9480,1941,5146,336,3,33,16939
11/1/2017,18,9477,1645,5209,490,0,31,16852
11/1/2017,19,9479,1591,5088,619,0,31,16808
11/1/2017,20,9478,1601,5028,641,0,31,16779
11/1/2017,21,9471,1569,4827,653,0,31,16551
11/1/2017,22,9475,1055,4352,904,0,30,15816
11/1/2017,23,9476,433,4120,971,0,20,15020
11/1/2017,24,9480,271,3637,986,0,17,14391
11/2/2017,1,9484,271,3390,1093,0,17,14255
11/2/2017,2,9483,271,3302,994,0,17,14067
11/2/2017,3,9477,271,3284,1021,0,17,14070
11/2/2017,4,9477,271,3415,927,0,17,14107
11/2/2017,5,9485,271,3419,1322,0,20,14517
11/2/2017,6,9482,271,3648,1571,0,24,14996
11/2/2017,7,9487,274,4572,1756,0,31,16120
11/2/2017,8,9472,275,4843,1775,0,31,16396
11/2/2017,9,9476,311,5065,1798,3,31,16684
11/2/2017,10,9482,358,4843,1806,18,28,16535
11/2/2017,11,9479,509,5019,1761,23,27,16818
11/2/2017,12,9475,659,5158,1712,31,26,17061
11/2/2017,13,9480,842,4862,1709,23,27,16943
11/2/2017,14,9486,1145,5084,1515,17,27,17274
11/2/2017,15,9483,1318,5059,1366,20,27,17273
11/2/2017,16,9476,1341,4893,1339,8,29,17086
11/2/2017,17,9485,1353,4891,1571,2,29,17331
11/2/2017,18,9484,1352,4755,1887,0,30,17508
11/2/2017,19,9482,1352,4601,1739,0,30,17204
11/2/2017,20,9482,1351,4755,1430,0,31,17049
11/2/2017,21,9468,934,4465,1510,0,30,16407
11/2/2017,22,9475,397,3979,1745,0,30,15626
11/2/2017,23,9475,268,3756,1339,0,22,14860
11/2/2017,24,9477,268,3378,1276,0,18,14417
11/3/2017,1,9478,269,3327,1162,0,18,14254
11/3/2017,2,9473,269,3143,839,0,17,13741
11/3/2017,3,9482,271,3035,904,0,17,13709
11/3/2017,4,9483,277,3164,688,0,18,13630
11/3/2017,5,9485,378,3339,1080,0,20,14302
11/3/2017,6,9489,531,3611,1335,0,25,14991
11/3/2017,7,9492,694,4385,1905,0,31,16507
11/3/2017,8,9486,700,4400,1854,6,31,16477
11/3/2017,9,9473,701,4249,1734,65,31,16253
11/3/2017,10,9482,701,4171,2040,107,31,16532
11/3/2017,11,9491,699,4267,1849,207,31,16544
11/3/2017,12,9493,694,4294,1840,185,31,16537
11/3/2017,13,9493,416,4279,1924,189,31,16332
11/3/2017,14,9487,324,4280,1680,246,31,16048
11/3/2017,15,9489,585,4406,1354,186,31,16051
11/3/2017,16,9487,734,4538,1627,104,31,16521
11/3/2017,17,9482,895,5103,1360,26,31,16897
11/3/2017,18,9482,894,5436,1133,0,31,16976
11/3/2017,19,9481,815,5567,922,0,31,16816
11/3/2017,20,9484,777,5306,851,0,31,16449
11/3/2017,21,9485,707,5110,670,0,31,16003
11/3/2017,22,9487,705,4664,613,0,31,15500
11/3/2017,23,9483,430,4219,534,0,20,14686
11/3/2017,24,9488,270,3745,601,0,8,14112
11/4/2017,1,9487,271,3576,620,0,0,13954
11/4/2017,2,9487,271,3621,539,0,0,13918
11/4/2017,3,9485,271,3525,563,0,0,13844
11/4/2017,4,9487,272,3550,538,0,0,13847
11/4/2017,5,9486,272,3712,607,0,0,14077
11/4/2017,6,9490,272,3902,709,0,0,14373
11/4/2017,7,9491,272,4153,856,0,0,14772
11/4/2017,8,9482,274,4473,1176,11,0,15416
11/4/2017,9,9483,274,4893,1058,73,0,15781
11/4/2017,10,9521,273,4963,1092,81,0,15930
11/4/2017,11,9710,273,4515,1299,103,0,15900
11/4/2017,12,9719,273,4279,1522,127,0,15920
11/4/2017,13,9706,249,4279,1683,112,0,16029
11/4/2017,14,9620,245,4161,1821,122,0,15969
11/4/2017,15,9657,271,4131,1604,108,0,15771
11/4/2017,16,9661,272,4304,1763,79,0,16079
11/4/2017,17,9699,272,4467,2368,11,0,16817
11/4/2017,18,9858,272,4475,2324,0,0,16929
11/4/2017,19,9863,272,4386,2411,0,0,16932
11/4/2017,20,9892,272,4317,1979,0,0,16460
11/4/2017,21,10030,271,3809,2042,0,0,16152
11/4/2017,22,10037,271,3574,1393,0,0,15275
11/4/2017,23,10038,271,3210,895,0,0,14414
11/4/2017,24,9909,271,3044,698,0,0,13922
11/5/2017,1,9709,271,3072,337,0,0,13389
11/5/2017,2,9315,271,2967,475,0,0,13028
11/5/2017,3,9189,271,2986,519,0,0,12965
11/5/2017,4,8970,270,2980,569,0,0,12789
11/5/2017,5,8895,270,3022,764,0,0,12951
11/5/2017,6,8905,270,3061,825,0,0,13061
11/5/2017,7,9170,270,3199,873,0,0,13512
11/5/2017,8,9339,271,3551,1116,0,0,14277
11/5/2017,9,9700,270,3566,1409,3,0,14948
11/5/2017,10,10023,269,3772,1519,11,0,15594
11/5/2017,11,10027,267,3888,1730,19,0,15931
11/5/2017,12,10025,267,4107,1663,17,0,16079
11/5/2017,13,10024,268,4043,1867,19,0,16221
11/5/2017,14,10027,266,3819,2058,19,0,16189
11/5/2017,15,10021,267,3938,1872,9,0,16107
11/5/2017,16,10016,267,4055,2052,2,0,16392
11/5/2017,17,10017,266,4380,2177,0,0,16840
11/5/2017,18,10044,267,4516,2157,0,0,16984
11/5/2017,19,10106,266,4562,2019,0,0,16953
11/5/2017,20,10116,266,4652,2075,0,0,17109
11/5/2017,21,10133,267,4286,1978,0,0,16664
11/5/2017,22,10134,268,3636,2062,0,0,16100
11/5/2017,23,10135,276,3390,1131,0,0,14932
11/5/2017,24,10138,293,3248,519,0,0,14198
11/6/2017,1,9934,311,3058,362,0,0,13665
11/6/2017,2,9655,323,2942,515,0,0,13435
11/6/2017,3,9543,323,2843,593,0,6,13308
11/6/2017,4,9538,317,2937,434,0,14,13240
11/6/2017,5,9540,270,2968,600,0,17,13395
11/6/2017,6,9618,270,3126,689,0,17,13720
11/6/2017,7,10009,272,3573,1308,0,19,15181
11/6/2017,8,10211,327,3804,2279,0,25,16646
11/6/2017,9,10210,389,4126,2011,10,29,16775
11/6/2017,10,10213,398,4102,2076,34,18,16841
11/6/2017,11,10223,403,4167,2089,63,15,16960
11/6/2017,12,10220,496,4167,1799,105,19,16806
11/6/2017,13,10233,611,4201,1570,111,19,16745
11/6/2017,14,10237,714,4168,1710,112,27,16968
11/6/2017,15,10225,889,4321,1576,92,30,17133
11/6/2017,16,10227,995,4354,1154,70,31,16831
11/6/2017,17,10232,1136,4669,1135,8,31,17211
11/6/2017,18,10227,1289,5389,979,0,28,17912
11/6/2017,19,10230,1337,5426,739,0,28,17760
11/6/2017,20,10230,1298,5359,603,0,33,17523
11/6/2017,21,10222,1130,5033,482,0,31,16898
11/6/2017,22,10228,958,4636,477,0,30,16329
11/6/2017,23,10230,643,4038,394,0,30,15335
11/6/2017,24,10231,467,3953,359,0,22,15032
11/7/2017,1,10235,331,3733,400,0,17,14716
11/7/2017,2,10230,329,3439,398,0,16,14412
11/7/2017,3,10235,362,3215,348,0,16,14176
11/7/2017,4,10235,366,3159,269,0,16,14045
11/7/2017,5,10239,396,3173,367,0,16,14191
11/7/2017,6,10232,534,3360,375,0,20,14521
11/7/2017,7,10243,749,4444,297,0,25,15758
11/7/2017,8,10250,938,5254,391,5,29,16867
11/7/2017,9,10246,937,5091,444,34,28,16780
11/7/2017,10,10242,971,4444,310,83,29,16079
11/7/2017,11,10246,1015,4339,319,128,30,16077
11/7/2017,12,10241,1062,4245,255,109,31,15943
11/7/2017,13,10240,1163,4216,300,145,31,16095
11/7/2017,14,10239,1268,4457,469,144,29,16606
11/7/2017,15,10243,1336,4761,513,106,30,16989
11/7/2017,16,10257,1466,4599,363,66,31,16782
11/7/2017,17,10245,1740,4735,331,14,30,17095
11/7/2017,18,10246,1822,5311,451,0,29,17859
11/7/2017,19,10243,1742,5268,445,0,29,17727
11/7/2017,20,10242,1675,5169,492,0,30,17608
11/7/2017,21,10230,1326,4922,565,0,30,17073
11/7/2017,22,10223,850,4719,513,0,30,16335
11/7/2017,23,10228,739,3968,403,0,30,15368
11/7/2017,24,10239,426,3794,457,0,22,14938
11/8/2017,1,10244,289,3720,458,0,16,14727
11/8/2017,2,10245,289,3325,399,0,15,14273
11/8/2017,3,10243,289,3461,381,0,15,14389
11/8/2017,4,10242,289,3389,359,0,15,14294
11/8/2017,5,10231,288,3464,406,0,16,14405
11/8/2017,6,10233,346,3343,419,0,19,14360
11/8/2017,7,10240,465,4184,561,0,24,15474
11/8/2017,8,10209,578,4823,617,7,31,16265
11/8/2017,9,10173,687,5000,535,70,31,16496
11/8/2017,10,10154,811,4250,540,138,31,15924
11/8/2017,11,10019,914,4180,440,149,31,15733
11/8/2017,12,10166,914,4143,448,171,31,15873
11/8/2017,13,10180,1088,4217,710,194,31,16420
11/8/2017,14,10181,1079,4305,594,183,32,16374
11/8/2017,15,10211,1141,4337,607,151,31,16478
11/8/2017,16,10243,1325,4423,355,56,31,16433
11/8/2017,17,10241,1389,4716,594,20,31,16991
11/8/2017,18,10243,1341,5347,785,0,31,17747
11/8/2017,19,10245,1400,5328,1060,0,31,18064
11/8/2017,20,10241,1329,5122,1187,0,31,17910
11/8/2017,21,10231,1324,4586,1169,0,31,17341
11/8/2017,22,10222,1326,4133,1087,0,30,16798
11/8/2017,23,10201,852,3908,1345,0,31,16337
11/8/2017,24,10231,403,3706,1331,0,18,15689
11/9/2017,1,10237,302,3354,1220,0,15,15128
11/9/2017,2,10243,314,3185,1008,0,15,14765
11/9/2017,3,10244,323,2950,963,0,15,14495
11/9/2017,4,10250,323,2954,939,0,15,14481
11/9/2017,5,10246,328,3015,1026,0,16,14631
11/9/2017,6,10252,330,3364,1084,0,16,15046
11/9/2017,7,10254,375,3954,1072,0,26,15681
11/9/2017,8,10235,475,4670,1606,0,31,17017
11/9/2017,9,10189,520,4860,1778,23,31,17401
11/9/2017,10,10188,549,4410,1961,28,30,17166
11/9/2017,11,10185,568,4233,2332,30,31,17379
11/9/2017,12,10184,605,4128,2362,57,31,17367
11/9/2017,13,10188,649,4158,2532,48,31,17606
11/9/2017,14,10190,648,4237,2512,42,31,17660
11/9/2017,15,10242,638,4140,2660,45,31,17756
11/9/2017,16,10252,589,4152,3122,6,31,18152
11/9/2017,17,10245,571,4383,3293,0,31,18523
11/9/2017,18,10227,586,4662,2777,0,31,18283
11/9/2017,19,10232,627,4722,2687,0,32,18300
11/9/2017,20,10234,516,4614,2681,0,34,18079
11/9/2017,21,10233,360,4488,3088,0,30,18199
11/9/2017,22,10226,358,3815,3473,0,30,17902
11/9/2017,23,10224,331,3321,2844,0,30,16750
11/9/2017,24,10227,330,3251,2261,0,24,16093
11/10/2017,1,10237,304,2953,2368,0,15,15877
11/10/2017,2,10239,301,2909,1848,0,15,15312
11/10/2017,3,10222,303,2920,1692,0,15,15152
11/10/2017,4,10221,310,2947,1507,0,15,15000
11/10/2017,5,10231,445,2964,1609,0,14,15263
11/10/2017,6,10232,553,3551,1586,0,13,15935
11/10/2017,7,10235,673,4261,1659,0,15,16843
11/10/2017,8,10233,790,4162,2165,16,28,17394
11/10/2017,9,10223,906,4175,2022,97,31,17454
11/10/2017,10,10182,984,4195,1880,200,30,17471
11/10/2017,11,10089,964,4227,1590,236,31,17137
11/10/2017,12,10119,1171,4767,1356,244,31,17688
11/10/2017,13,10216,1409,4528,760,246,31,17190
11/10/2017,14,10222,1528,4316,652,228,28,16974
11/10/2017,15,10214,1852,4330,514,182,26,17118
11/10/2017,16,10222,2066,4477,361,68,27,17221
11/10/2017,17,10223,1844,5176,572,21,27,17863
11/10/2017,18,10272,2549,5724,512,0,27,19084
11/10/2017,19,10283,2393,5567,561,0,27,18831
11/10/2017,20,10284,2220,5388,581,0,27,18500
11/10/2017,21,10285,1956,5353,565,0,28,18187
11/10/2017,22,10273,1767,4936,552,0,28,17556
11/10/2017,23,10283,1225,4763,565,0,28,16864
11/10/2017,24,9953,975,4218,736,0,6,15888
11/11/2017,1,9592,750,4066,765,0,0,15173
11/11/2017,2,9423,709,3994,749,0,0,14875
11/11/2017,3,9417,389,3944,740,0,0,14490
11/11/2017,4,9413,305,3883,688,0,0,14289
11/11/2017,5,9403,303,3827,834,0,0,14367
11/11/2017,6,9402,362,3926,844,0,0,14534
11/11/2017,7,9399,455,4607,982,0,0,15443
11/11/2017,8,9410,512,4823,1229,19,0,15993
11/11/2017,9,9410,591,4874,1325,98,0,16298
11/11/2017,10,9408,780,5062,1287,177,0,16714
11/11/2017,11,9397,940,4996,1414,220,0,16967
11/11/2017,12,9400,1136,5133,1254,230,0,17153
11/11/2017,13,9408,1334,4905,1254,227,0,17128
11/11/2017,14,9410,1688,4425,1034,188,1,16746
11/11/2017,15,9409,1922,4576,927,134,0,16968
11/11/2017,16,9369,1928,4635,433,28,0,16393
11/11/2017,17,9407,1928,5055,855,10,0,17255
11/11/2017,18,9406,1924,5683,797,0,0,17810
11/11/2017,19,9428,1921,5791,611,0,0,17751
11/11/2017,20,9429,1950,5364,663,0,0,17406
11/11/2017,21,9421,1785,5257,612,0,0,17075
11/11/2017,22,9414,1579,4988,543,0,0,16524
11/11/2017,23,9413,1066,5430,433,0,0,16342
11/11/2017,24,9417,730,4426,359,0,0,14932
11/12/2017,1,9413,386,4530,290,0,0,14619
11/12/2017,2,9418,305,4533,262,0,0,14518
11/12/2017,3,9416,298,3942,235,0,0,13891
11/12/2017,4,9427,300,3498,119,0,0,13344
11/12/2017,5,9422,300,3765,257,0,0,13744
11/12/2017,6,9381,423,3871,184,0,0,13859
11/12/2017,7,9321,612,4070,105,0,0,14108
11/12/2017,8,9325,816,5087,116,1,0,15345
11/12/2017,9,9322,1161,5507,131,22,0,16143
11/12/2017,10,9323,1186,5481,99,75,0,16164
11/12/2017,11,9320,1310,4952,94,56,0,15732
11/12/2017,12,9318,1535,5141,63,60,0,16117
11/12/2017,13,9315,1552,5302,40,77,1,16287
11/12/2017,14,9318,1547,5368,21,68,1,16323
11/12/2017,15,9452,1408,4983,25,40,0,15908
11/12/2017,16,9513,1514,4936,16,18,0,15997
11/12/2017,17,9511,1624,5269,10,7,0,16421
11/12/2017,18,9586,1721,5695,35,5,0,17042
11/12/2017,19,9622,1729,5458,114,5,0,16928
11/12/2017,20,9630,1570,5298,205,5,0,16708
11/12/2017,21,9650,1384,4840,219,5,0,16098
11/12/2017,22,9817,993,5131,187,5,0,16133
11/12/2017,23,9706,874,4797,159,5,0,15541
11/12/2017,24,9943,714,4574,188,5,0,15424
11/13/2017,1,9954,380,3667,197,5,0,14203
11/13/2017,2,9956,291,3535,175,5,6,13968
11/13/2017,3,9959,296,3624,214,5,12,14110
11/13/2017,4,9954,370,3732,233,5,11,14305
11/13/2017,5,9965,674,3712,121,5,11,14488
11/13/2017,6,9966,1080,3994,209,5,14,15268
11/13/2017,7,9962,1373,4518,217,5,19,16094
11/13/2017,8,9960,1547,5201,276,5,26,17015
11/13/2017,9,9961,1670,5228,392,21,27,17299
11/13/2017,10,9957,1756,5216,364,29,27,17349
11/13/2017,11,9962,1983,5135,290,35,27,17432
11/13/2017,12,9967,1815,5182,275,44,27,17310
11/13/2017,13,9965,1665,5199,370,49,27,17275
11/13/2017,14,9968,1577,5108,394,42,27,17116
11/13/2017,15,9972,2004,5229,391,27,27,17650
11/13/2017,16,10094,1968,5251,252,15,27,17607
11/13/2017,17,10137,2362,5447,149,6,28,18129
11/13/2017,18,10128,3139,5463,131,5,27,18893
11/13/2017,19,10084,2971,5506,122,5,27,18715
11/13/2017,20,10084,2641,5619,134,5,27,18510
11/13/2017,21,10084,2346,5519,126,5,27,18107
11/13/2017,22,10085,1800,5312,105,5,27,17334
11/13/2017,23,10071,1251,4767,147,5,26,16267
11/13/2017,24,10072,771,4231,187,5,18,15284
11/14/2017,1,10074,388,3714,220,5,13,14414
11/14/2017,2,10077,295,3621,233,5,12,14243
11/14/2017,3,10083,298,3519,191,5,13,14109
11/14/2017,4,10108,386,3559,203,5,13,14274
11/14/2017,5,10098,753,3449,87,5,14,14406
11/14/2017,6,10127,1319,3599,77,5,14,15141
11/14/2017,7,10127,1569,4430,189,5,21,16341
11/14/2017,8,10065,1523,5002,235,6,27,16858
11/14/2017,9,10052,1584,5238,188,16,27,17105
11/14/2017,10,10057,1710,5229,208,32,27,17263
11/14/2017,11,10054,1870,5211,159,48,27,17369
11/14/2017,12,10055,1565,5055,134,77,27,16913
11/14/2017,13,10057,1515,5124,194,116,27,17033
11/14/2017,14,10059,1632,5168,256,87,27,17229
11/14/2017,15,10063,1810,5192,240,51,27,17383
11/14/2017,16,10063,2086,5060,269,23,28,17529
11/14/2017,17,10088,2117,5109,358,4,30,17706
11/14/2017,18,10140,2173,5397,597,0,27,18334
11/14/2017,19,10145,2169,5175,841,0,27,18357
11/14/2017,20,10150,1964,4809,1126,0,27,18076
11/14/2017,21,10141,1439,4950,1281,0,27,17838
11/14/2017,22,10138,931,4726,1502,0,27,17324
11/14/2017,23,10138,719,4256,1502,0,27,16642
11/14/2017,24,10136,393,3660,1113,0,18,15320
11/15/2017,1,10137,292,3427,1187,0,14,15057
11/15/2017,2,10142,292,3391,1012,0,13,14850
11/15/2017,3,10144,293,3151,1077,0,13,14678
11/15/2017,4,10144,294,2895,1329,0,12,14674
11/15/2017,5,10146,315,2861,1481,0,13,14816
11/15/2017,6,10140,323,3153,1734,0,15,15365
11/15/2017,7,10140,322,3918,1865,0,21,16266
11/15/2017,8,10141,322,4272,2288,10,26,17059
11/15/2017,9,10135,322,4334,2185,54,26,17056
11/15/2017,10,10137,323,4321,2099,44,26,16950
11/15/2017,11,10143,326,4333,2199,64,26,17091
11/15/2017,12,10011,433,4474,2461,89,26,17494
11/15/2017,13,9971,678,4816,2275,87,22,17849
11/15/2017,14,9999,910,4955,2276,48,20,18208
11/15/2017,15,10135,959,4696,2441,31,22,18284
11/15/2017,16,10138,963,4513,2113,12,25,17764
11/15/2017,17,10149,983,4624,2763,1,26,18546
11/15/2017,18,10155,989,4651,3189,0,26,19010
11/15/2017,19,10155,991,4676,3226,0,27,19075
11/15/2017,20,10144,668,4659,3091,0,27,18589
11/15/2017,21,10144,460,4787,3446,0,27,18864
11/15/2017,22,10139,374,4368,3168,0,27,18076
11/15/2017,23,10140,347,3721,2882,0,27,17117
11/15/2017,24,10146,332,3306,2260,0,16,16060
11/16/2017,1,10145,332,2996,1856,0,12,15341
11/16/2017,2,10141,330,2840,1508,0,12,14831
11/16/2017,3,10144,330,2765,1413,0,12,14664
11/16/2017,4,10149,332,2736,1226,0,12,14455
11/16/2017,5,10148,331,3081,948,0,12,14520
11/16/2017,6,10139,328,3221,1431,0,14,15133
11/16/2017,7,10144,326,3983,1853,0,21,16327
11/16/2017,8,10128,325,4145,3002,4,25,17629
11/16/2017,9,10138,331,4230,2970,46,25,17740
11/16/2017,10,10140,334,4427,2976,36,25,17938
11/16/2017,11,10139,378,4587,2809,42,25,17980
11/16/2017,12,10143,420,4216,2899,52,25,17755
11/16/2017,13,10141,601,4508,2659,49,25,17983
11/16/2017,14,10142,810,4897,2552,49,25,18475
11/16/2017,15,10145,1152,4846,2353,31,25,18552
11/16/2017,16,10131,1234,4991,2310,15,25,18706
11/16/2017,17,10136,1223,4982,2184,2,25,18552
11/16/2017,18,10144,1231,5211,2059,0,25,18670
11/16/2017,19,10147,1221,5308,1832,0,26,18534
11/16/2017,20,10151,1214,5437,1796,0,27,18625
11/16/2017,21,10145,894,5187,1869,0,27,18122
11/16/2017,22,10141,756,4651,1798,0,27,17373
11/16/2017,23,10142,542,4834,1433,0,27,16978
11/16/2017,24,10137,327,4691,1136,0,21,16312
11/17/2017,1,10132,297,4173,944,0,16,15562
11/17/2017,2,10138,305,3873,833,0,14,15163
11/17/2017,3,10133,435,3763,740,0,14,15085
11/17/2017,4,10121,704,3515,658,0,14,15012
11/17/2017,5,10145,976,3627,377,0,14,15139
11/17/2017,6,10160,1150,3958,297,0,15,15580
11/17/2017,7,10161,1389,4545,307,0,22,16424
11/17/2017,8,10161,1544,5198,386,10,27,17326
11/17/2017,9,10161,1576,5290,433,62,27,17549
11/17/2017,10,10160,1523,5115,431,138,27,17394
11/17/2017,11,10160,1509,4979,487,192,27,17354
11/17/2017,12,10164,1510,4511,452,212,27,16876
11/17/2017,13,10169,1531,4509,540,155,31,16935
11/17/2017,14,10168,1562,4349,532,159,42,16812
11/17/2017,15,10157,1253,4435,504,132,42,16523
11/17/2017,16,10143,977,4704,1111,46,41,17022
11/17/2017,17,10152,1012,5235,1327,4,31,17761
11/17/2017,18,10159,1299,5489,1668,0,41,18656
11/17/2017,19,10209,1171,4997,1918,0,40,18335
11/17/2017,20,10248,1162,4560,2139,0,36,18145
11/17/2017,21,10240,639,4522,2554,0,28,17983
11/17/2017,22,10232,497,4313,2619,0,27,17688
11/17/2017,23,10250,487,3830,2130,0,27,16724
11/17/2017,24,10324,206,3405,1577,0,14,15526
11/18/2017,1,10404,180,3022,1559,0,1,15166
11/18/2017,2,10416,177,2992,1291,0,0,14876
11/18/2017,3,10379,177,3013,1134,0,0,14703
11/18/2017,4,10351,177,3186,1006,0,0,14720
11/18/2017,5,10370,178,3137,1036,0,0,14721
11/18/2017,6,10380,177,3396,975,0,0,14928
11/18/2017,7,10376,178,3711,1136,0,0,15401
11/18/2017,8,10375,178,4028,1491,1,0,16073
11/18/2017,9,10382,178,4310,1634,3,0,16507
11/18/2017,10,10408,177,4977,1240,10,1,16813
11/18/2017,11,10408,178,5194,891,15,11,16697
11/18/2017,12,10402,175,5048,823,17,6,16471
11/18/2017,13,10406,177,5031,829,16,0,16459
11/18/2017,14,10401,178,5000,579,11,0,16169
11/18/2017,15,10401,178,4921,477,8,0,15985
11/18/2017,16,10399,198,4895,552,2,0,16046
11/18/2017,17,10401,210,4859,852,0,0,16322
11/18/2017,18,10397,234,4982,1460,0,0,17073
11/18/2017,19,10398,218,4646,2000,0,0,17262
11/18/2017,20,10396,217,4608,2200,0,0,17421
11/18/2017,21,10410,217,4333,2485,0,0,17445
11/18/2017,22,10450,196,3952,2384,0,0,16982
11/18/2017,23,10460,175,3544,2050,0,0,16229
11/18/2017,24,10518,176,3145,1662,0,0,15501
11/19/2017,1,10519,195,2860,1464,0,0,15038
11/19/2017,2,10524,207,2863,1162,0,0,14756
11/19/2017,3,10537,208,2811,1084,0,0,14640
11/19/2017,4,10536,207,2902,804,0,0,14449
11/19/2017,5,10545,208,2917,663,0,0,14333
11/19/2017,6,10560,209,3212,843,0,0,14824
11/19/2017,7,10560,207,3699,1062,0,0,15528
11/19/2017,8,10556,209,4130,675,0,0,15570
11/19/2017,9,10564,209,4112,1179,4,0,16068
11/19/2017,10,10564,207,4104,1749,36,0,16660
11/19/2017,11,10560,207,4137,1997,42,0,16943
11/19/2017,12,10558,209,4163,2282,38,0,17250
11/19/2017,13,10557,208,4263,2212,45,0,17285
11/19/2017,14,10553,215,4427,2201,22,0,17418
11/19/2017,15,10517,272,4332,1569,22,0,16712
11/19/2017,16,10560,334,4431,1748,12,0,17085
11/19/2017,17,10544,398,4831,1805,0,0,17578
11/19/2017,18,10544,585,5071,2476,0,0,18676
11/19/2017,19,10548,610,5364,2677,0,0,19199
11/19/2017,20,10551,602,5283,2529,0,0,18965
11/19/2017,21,10547,573,5196,2357,0,0,18673
11/19/2017,22,10557,444,4735,2278,0,0,18014
11/19/2017,23,10553,387,3968,2157,0,0,17065
11/19/2017,24,10554,220,3291,2141,0,0,16206
11/20/2017,1,10558,178,2987,1676,0,6,15405
11/20/2017,2,10555,180,2935,1865,0,18,15553
11/20/2017,3,10566,180,2926,1657,0,18,15347
11/20/2017,4,10567,202,3044,1603,0,18,15434
11/20/2017,5,10559,206,3154,1543,0,18,15480
11/20/2017,6,10566,222,3287,1615,0,19,15709
11/20/2017,7,10567,250,3704,1966,0,24,16511
11/20/2017,8,10571,450,4479,2398,1,26,17925
11/20/2017,9,10568,461,4538,2441,13,27,18048
11/20/2017,10,10497,519,4363,2519,36,29,17963
11/20/2017,11,10465,529,4189,2570,48,27,17828
11/20/2017,12,10482,612,4654,2247,31,27,18053
11/20/2017,13,10483,612,4431,2338,33,27,17924
11/20/2017,14,10488,744,4445,2113,52,27,17869
11/20/2017,15,10492,846,4357,2394,41,27,18157
11/20/2017,16,10526,986,4483,2362,57,27,18441
11/20/2017,17,10561,962,4605,2658,11,27,18824
11/20/2017,18,10560,963,4677,3349,0,27,19576
11/20/2017,19,10570,962,4661,3473,0,27,19693
11/20/2017,20,10581,1014,4565,3599,0,27,19786
11/20/2017,21,10582,723,4372,3502,0,27,19206
11/20/2017,22,10580,332,4143,3432,0,27,18514
11/20/2017,23,10574,242,3884,2802,0,27,17529
11/20/2017,24,10563,242,3294,2011,0,18,16128
11/21/2017,1,10462,242,3065,1769,0,14,15552
11/21/2017,2,10447,240,2909,1534,0,14,15144
11/21/2017,3,10634,241,2850,1378,0,14,15117
11/21/2017,4,10678,257,2851,1337,0,15,15138
11/21/2017,5,10673,269,2901,994,0,13,14850
11/21/2017,6,10715,268,2892,1507,0,16,15398
11/21/2017,7,10737,267,3324,2198,0,22,16548
11/21/2017,8,10741,269,3630,3253,7,27,17927
11/21/2017,9,10737,270,3685,3239,60,27,18018
11/21/2017,10,10810,270,3777,2839,125,27,17848
11/21/2017,11,11091,268,3728,2488,136,27,17738
11/21/2017,12,11145,275,3763,1816,208,27,17234
11/21/2017,13,11164,280,3852,1803,194,26,17319
11/21/2017,14,11162,347,4010,1644,142,26,17331
11/21/2017,15,11162,478,4102,1821,98,25,17686
11/21/2017,16,11176,710,4016,2306,37,26,18271
11/21/2017,17,11173,747,4401,2358,4,26,18709
11/21/2017,18,11171,753,4591,2821,0,26,19362
11/21/2017,19,11179,754,4616,2682,0,27,19258
11/21/2017,20,11179,754,4625,2739,0,27,19324
11/21/2017,21,11251,727,4577,2343,0,27,18925
11/21/2017,22,11316,515,4345,2086,0,26,18288
11/21/2017,23,11303,259,3662,2020,0,26,17270
11/21/2017,24,11307,214,3211,1429,0,16,16177
11/22/2017,1,11307,218,2865,1431,0,11,15832
11/22/2017,2,11312,232,2793,1039,0,9,15385
11/22/2017,3,11325,320,2724,789,0,9,15167
11/22/2017,4,11325,358,2862,513,0,9,15067
11/22/2017,5,11316,439,2928,482,0,8,15173
11/22/2017,6,11310,542,3232,511,0,14,15609
11/22/2017,7,11312,602,3948,914,0,21,16797
11/22/2017,8,11310,634,4417,1623,1,27,18012
11/22/2017,9,11305,685,4583,1804,15,27,18419
11/22/2017,10,11290,744,4764,1608,40,27,18473
11/22/2017,11,11290,785,4272,1248,61,27,17683
11/22/2017,12,11311,773,4195,1181,108,27,17595
11/22/2017,13,11318,848,4457,1171,82,27,17903
11/22/2017,14,11309,1332,4937,865,78,27,18548
11/22/2017,15,11330,1563,4854,898,49,27,18721
11/22/2017,16,11367,1779,4644,773,22,27,18612
11/22/2017,17,11381,1930,4923,503,4,27,18768
11/22/2017,18,11382,2149,5557,377,0,27,19492
11/22/2017,19,11383,2040,5537,320,0,27,19307
11/22/2017,20,11390,2134,5536,224,0,27,19311
11/22/2017,21,11392,1976,5363,197,0,27,18955
11/22/2017,22,11380,1424,5136,310,0,27,18277
11/22/2017,23,11382,792,4507,374,0,26,17081
11/22/2017,24,11389,387,3845,415,0,20,16056
11/23/2017,1,11386,283,3663,553,0,15,15900
11/23/2017,2,11395,284,3307,716,0,14,15716
11/23/2017,3,11394,336,3033,615,0,14,15392
11/23/2017,4,11396,432,3039,466,0,14,15347
11/23/2017,5,11393,496,3201,350,0,15,15455
11/23/2017,6,11381,498,3561,518,0,17,15975
11/23/2017,7,11371,499,4065,674,0,23,16632
11/23/2017,8,11339,507,4692,1185,0,27,17750
11/23/2017,9,11298,525,5167,1281,11,27,18309
11/23/2017,10,11303,538,5231,1326,34,27,18459
11/23/2017,11,11261,535,4611,1567,42,37,18053
11/23/2017,12,11303,410,4384,1759,53,36,17945
11/23/2017,13,11319,522,4560,2018,41,28,18488
11/23/2017,14,11307,970,4441,1722,56,27,18523
11/23/2017,15,11306,1089,4387,1806,36,27,18651
11/23/2017,16,11333,1284,4338,1814,24,27,18820
11/23/2017,17,11377,1368,4607,1701,4,27,19084
11/23/2017,18,11381,1377,4524,2276,0,27,19585
11/23/2017,19,11382,1376,4623,2019,0,27,19427
11/23/2017,20,11384,1022,4860,2019,0,27,19312
11/23/2017,21,11386,811,4984,1990,0,27,19198
11/23/2017,22,11383,678,4513,1918,0,27,18519
11/23/2017,23,11383,455,3984,1672,0,27,17521
11/23/2017,24,11374,406,3475,1151,0,20,16426
11/24/2017,1,11381,343,2713,1514,0,15,15966
11/24/2017,2,11381,282,2627,1199,0,13,15502
11/24/2017,3,11372,313,2588,840,0,13,15126
11/24/2017,4,11361,311,2606,773,0,14,15065
11/24/2017,5,11358,266,2613,902,0,14,15153
11/24/2017,6,11351,256,2926,989,0,17,15539
11/24/2017,7,11347,257,3400,1585,0,19,16608
11/24/2017,8,11353,255,3766,1960,2,26,17362
11/24/2017,9,11340,276,3659,2295,42,27,17639
11/24/2017,10,11340,310,3621,2021,110,24,17426
11/24/2017,11,11337,310,3769,1453,149,16,17034
11/24/2017,12,11340,310,3807,1307,156,27,16947
11/24/2017,13,11338,311,3669,1354,159,27,16858
11/24/2017,14,11354,312,3741,1257,147,26,16837
11/24/2017,15,11351,311,3843,1162,103,26,16796
11/24/2017,16,11360,314,3819,1602,70,27,17192
11/24/2017,17,11361,329,4084,1956,11,27,17768
11/24/2017,18,11360,329,4079,2968,0,26,18762
11/24/2017,19,11357,330,4168,2699,0,27,18581
11/24/2017,20,11359,331,4068,2574,0,27,18359
11/24/2017,21,11354,329,3960,2343,0,27,18013
11/24/2017,22,11344,328,3760,2051,0,27,17510
11/24/2017,23,11341,329,3518,1299,0,26,16513
11/24/2017,24,11346,279,3068,1285,0,16,15994
11/25/2017,1,11346,265,2675,845,0,1,15132
11/25/2017,2,11261,269,2708,276,0,0,14514
11/25/2017,3,10653,304,2669,272,0,0,13898
11/25/2017,4,10217,242,2699,439,0,0,13597
11/25/2017,5,10197,240,2698,488,0,0,13623
11/25/2017,6,10196,240,2748,1201,0,0,14385
11/25/2017,7,10423,241,3063,927,0,0,14654
11/25/2017,8,10628,239,3491,1021,0,0,15379
11/25/2017,9,10964,242,3631,1232,2,0,16071
11/25/2017,10,11322,240,3684,1309,26,0,16581
11/25/2017,11,11337,240,3858,1544,43,0,17022
11/25/2017,12,11339,239,3921,1615,66,0,17180
11/25/2017,13,11330,242,3947,1384,56,0,16959
11/25/2017,14,11333,237,3909,1336,53,0,16868
11/25/2017,15,11338,235,4019,1169,30,0,16791
11/25/2017,16,11292,239,4278,1287,21,0,17117
11/25/2017,17,11330,236,4347,1861,3,0,17777
11/25/2017,18,11325,236,4659,2174,0,0,18394
11/25/2017,19,11320,237,4414,2222,0,1,18194
11/25/2017,20,11326,238,4121,2033,0,1,17719
11/25/2017,21,11320,237,3975,1760,0,0,17292
11/25/2017,22,11320,238,3671,1584,0,0,16813
11/25/2017,23,11322,237,3167,1444,0,0,16170
11/25/2017,24,11317,236,2790,1217,0,0,15560
11/26/2017,1,11314,238,2680,820,0,0,15052
11/26/2017,2,11047,236,2685,313,0,0,14281
11/26/2017,3,10534,236,2709,284,0,0,13763
11/26/2017,4,10064,235,2692,487,0,0,13478
11/26/2017,5,9828,236,2827,852,0,0,13743
11/26/2017,6,9823,235,2817,1084,0,0,13959
11/26/2017,7,10202,235,3363,856,0,0,14656
11/26/2017,8,10506,235,3648,840,2,0,15231
11/26/2017,9,10856,252,4020,823,18,0,15969
11/26/2017,10,10969,260,4187,711,43,0,16170
11/26/2017,11,10969,310,4215,778,52,0,16324
11/26/2017,12,10968,348,4264,897,57,0,16534
11/26/2017,13,10967,355,4118,865,87,0,16392
11/26/2017,14,10968,353,4171,798,117,0,16407
11/26/2017,15,10967,287,4151,965,74,0,16444
11/26/2017,16,10959,267,4196,1549,29,0,17000
11/26/2017,17,10960,267,4396,2167,3,0,17793
11/26/2017,18,10956,266,4491,3150,0,0,18863
11/26/2017,19,10963,266,4369,3157,0,0,18755
11/26/2017,20,10960,267,4374,2802,0,0,18403
11/26/2017,21,10955,267,3992,2722,0,0,17936
11/26/2017,22,10947,239,3482,2665,0,1,17334
11/26/2017,23,10943,238,3014,2322,0,1,16518
11/26/2017,24,10946,290,2911,1607,0,0,15754
11/27/2017,1,10955,355,2781,1029,0,0,15120
11/27/2017,2,10955,414,2802,491,0,4,14666
11/27/2017,3,10829,430,2894,293,0,12,14458
11/27/2017,4,10497,476,2948,524,0,2,14447
11/27/2017,5,10409,709,2966,669,0,2,14755
11/27/2017,6,10552,930,3169,650,0,3,15304
11/27/2017,7,10910,980,4031,674,0,7,16602
11/27/2017,8,10960,1278,5265,571,2,22,18098
11/27/2017,9,10960,1586,5242,405,43,25,18261
11/27/2017,10,10949,1484,5090,282,163,25,17993
11/27/2017,11,10931,1236,4918,273,220,25,17603
11/27/2017,12,10929,1079,4745,208,239,25,17225
11/27/2017,13,10925,1032,4738,201,250,25,17171
11/27/2017,14,10923,1302,5120,168,217,25,17755
11/27/2017,15,10921,1495,4955,202,117,25,17715
11/27/2017,16,10915,1575,4649,185,32,25,17381
11/27/2017,17,10915,1850,5308,363,1,25,18462
11/27/2017,18,10915,2224,5398,612,0,25,19174
11/27/2017,19,10918,2447,5380,864,0,25,19634
11/27/2017,20,10918,2037,5065,1276,0,25,19321
11/27/2017,21,10916,1718,4525,1775,0,25,18959
11/27/2017,22,10913,1060,4061,1894,0,25,17953
11/27/2017,23,10907,415,3369,2230,0,25,16946
11/27/2017,24,10908,303,2957,2048,0,16,16232
11/28/2017,1,10905,303,2900,1824,0,10,15942
11/28/2017,2,10908,298,2921,1306,0,10,15443
11/28/2017,3,10911,298,2905,1347,0,11,15472
11/28/2017,4,10905,298,2814,1523,0,11,15551
11/28/2017,5,10909,299,2893,1589,0,11,15701
11/28/2017,6,10906,308,3100,1826,0,16,16156
11/28/2017,7,10906,328,3319,2985,0,21,17559
11/28/2017,8,10912,324,3833,3598,2,37,18706
11/28/2017,9,10914,324,4001,3379,56,41,18715
11/28/2017,10,10759,321,4056,2673,169,36,18014
11/28/2017,11,10762,322,4254,1756,241,35,17370
11/28/2017,12,10768,320,4178,1329,263,35,16893
11/28/2017,13,10766,320,4062,1413,245,30,16836
11/28/2017,14,10768,320,4057,1406,248,28,16827
11/28/2017,15,10766,318,4087,1273,194,30,16668
11/28/2017,16,10763,310,4152,1900,85,32,17242
11/28/2017,17,10861,305,4081,2904,12,34,18197
11/28/2017,18,10930,307,4264,3652,0,31,19184
11/28/2017,19,10930,314,4161,3656,0,28,19089
11/28/2017,20,10934,319,4024,3454,0,26,18757
11/28/2017,21,10932,320,3776,3346,0,25,18399
11/28/2017,22,10933,323,3406,2952,0,25,17639
11/28/2017,23,10939,299,3008,2334,0,25,16605
11/28/2017,24,10940,296,2908,1540,0,15,15699
11/29/2017,1,10947,296,2864,874,0,11,14992
11/29/2017,2,10620,297,2817,626,0,11,14371
11/29/2017,3,10179,305,2817,939,0,11,14251
11/29/2017,4,10109,261,2835,874,0,11,14090
11/29/2017,5,10110,262,3022,993,0,12,14399
11/29/2017,6,10275,273,3169,1696,0,12,15425
11/29/2017,7,10897,301,3516,1717,0,25,16456
11/29/2017,8,10966,424,4139,2217,1,30,17777
11/29/2017,9,10972,620,4182,1945,37,26,17782
11/29/2017,10,10967,890,4098,1722,101,25,17803
11/29/2017,11,10898,1101,4161,1345,146,29,17680
11/29/2017,12,10805,1233,4177,575,197,27,17014
11/29/2017,13,10877,1377,4334,127,85,26,16826
11/29/2017,14,10393,1472,4495,67,208,26,16661
11/29/2017,15,10121,1569,4730,145,189,25,16779
11/29/2017,16,10249,1600,4919,228,92,25,17113
11/29/2017,17,10885,1543,5300,204,11,26,17969
11/29/2017,18,11024,1641,5462,354,0,27,18508
11/29/2017,19,11027,1414,5081,561,0,26,18109
11/29/2017,20,11029,1396,4703,714,0,27,17869
11/29/2017,21,11031,1306,4680,748,0,26,17791
11/29/2017,22,11025,864,4841,998,0,26,17754
11/29/2017,23,11020,461,4253,1277,0,27,17038
11/29/2017,24,11010,378,3474,1536,0,19,16417
11/30/2017,1,11005,378,3098,1220,0,14,15715
11/30/2017,2,11012,378,2982,1110,0,11,15493
11/30/2017,3,11009,378,3019,865,0,10,15281
11/30/2017,4,11013,378,3046,833,0,10,15280
11/30/2017,5,11016,378,3106,944,0,10,15454
11/30/2017,6,11014,377,3367,1006,0,10,15774
11/30/2017,7,11023,391,3850,1309,0,10,16583
11/30/2017,8,11008,400,4093,2728,4,9,18242
11/30/2017,9,10966,452,4010,2713,38,10,18189
11/30/2017,10,10981,475,3863,2473,56,10,17858
11/30/2017,11,10976,538,3887,2372,86,19,17878
11/30/2017,12,10965,588,3903,2265,127,26,17874
11/30/2017,13,10970,585,3942,2463,76,27,18063
11/30/2017,14,11011,515,3914,2538,51,27,18056
11/30/2017,15,11042,571,3943,2694,32,27,18309
11/30/2017,16,11082,750,4429,2021,19,27,18328
11/30/2017,17,11088,795,4617,2578,4,29,19111
11/30/2017,18,11091,799,4747,2906,0,50,19593
11/30/2017,19,11100,763,4980,2346,0,60,19249
11/30/2017,20,11108,597,4942,2449,0,66,19162
11/30/2017,21,11102,600,5035,2200,0,65,19002
11/30/2017,22,11086,468,4748,1956,0,67,18325
11/30/2017,23,11100,377,3966,1756,0,67,17266
11/30/2017,24,11097,378,3298,1528,0,57,16358
12/1/2017,1,11105,378,2829,1232,0,52,15596
12/1/2017,2,11103,379,2820,583,0,50,14935
12/1/2017,3,10981,383,2810,344,0,50,14568
12/1/2017,4,10804,386,2901,485,0,48,14624
12/1/2017,5,10807,462,3071,564,0,48,14952
12/1/2017,6,10846,501,3478,583,0,51,15459
12/1/2017,7,10993,654,4202,437,0,57,16343
12/1/2017,8,10994,799,4838,424,0,77,17132
12/1/2017,9,10993,849,5128,298,31,89,17388
12/1/2017,10,10993,952,5213,206,122,90,17576
12/1/2017,11,10993,799,4838,152,177,106,17065
12/1/2017,12,10983,798,4636,162,226,138,16943
12/1/2017,13,10997,818,4677,196,182,173,17043
12/1/2017,14,10999,898,4915,252,143,173,17380
12/1/2017,15,11028,952,4748,257,140,170,17295
12/1/2017,16,11079,1018,4532,128,32,139,16928
12/1/2017,17,11093,1023,4841,318,8,219,17502
12/1/2017,18,11085,1049,5383,459,0,238,18214
12/1/2017,19,11080,1044,5353,488,0,237,18202
12/1/2017,20,11079,1029,5406,469,0,238,18221
12/1/2017,21,11074,1071,5402,426,0,236,18209
12/1/2017,22,11063,924,5264,434,0,202,17887
12/1/2017,23,11069,471,4788,477,0,124,16929
12/1/2017,24,11074,330,4133,465,0,63,16065
12/2/2017,1,11076,323,3519,542,0,43,15503
12/2/2017,2,11091,324,3038,508,0,36,14997
12/2/2017,3,10972,324,3065,391,0,33,14785
12/2/2017,4,10800,323,3071,444,0,29,14667
12/2/2017,5,10799,322,3095,488,0,29,14733
12/2/2017,6,10800,329,3272,589,0,35,15025
12/2/2017,7,10802,329,3637,628,0,39,15435
12/2/2017,8,10817,376,3934,589,1,42,15759
12/2/2017,9,11074,397,4173,713,17,54,16428
12/2/2017,10,11090,520,4526,641,45,92,16914
12/2/2017,11,11090,634,4554,458,101,179,17016
12/2/2017,12,11086,864,4134,376,116,191,16767
12/2/2017,13,11067,1122,3992,173,66,152,16572
12/2/2017,14,10530,1274,4245,129,40,100,16318
12/2/2017,15,9808,1434,4401,366,94,66,16169
12/2/2017,16,9542,1544,4615,476,71,40,16288
12/2/2017,17,9989,1562,5195,466,5,39,17256
12/2/2017,18,10145,1604,5532,607,0,42,17930
12/2/2017,19,10152,1552,5444,831,0,53,18032
12/2/2017,20,10147,1538,4559,830,0,92,17166
12/2/2017,21,10146,1072,4850,1019,0,173,17260
12/2/2017,22,10141,756,4636,1055,0,206,16794
12/2/2017,23,10136,415,4296,1140,0,209,16196
12/2/2017,24,10133,319,3859,1043,0,205,15559
12/3/2017,1,10141,319,3322,1113,0,206,15101
12/3/2017,2,10144,319,3057,1061,0,213,14794
12/3/2017,3,10145,319,2766,979,0,208,14417
12/3/2017,4,10144,319,2801,802,0,171,14237
12/3/2017,5,10141,319,3024,590,0,177,14251
12/3/2017,6,10134,319,3382,463,0,200,14498
12/3/2017,7,10135,319,3726,421,0,202,14803
12/3/2017,8,10127,285,4304,413,0,210,15339
12/3/2017,9,10118,292,4866,476,22,210,15984
12/3/2017,10,10130,354,4691,446,81,214,15916
12/3/2017,11,10140,500,4408,299,151,208,15706
12/3/2017,12,10149,728,4506,244,208,209,16044
12/3/2017,13,10145,1070,4406,221,181,205,16228
12/3/2017,14,9930,1198,4460,144,169,215,16116
12/3/2017,15,9850,1446,4545,98,122,222,16283
12/3/2017,16,9988,1461,4966,122,53,223,16813
12/3/2017,17,10140,1550,5284,170,8,218,17370
12/3/2017,18,10135,1634,5639,209,0,213,17830
12/3/2017,19,10136,1545,5643,229,0,204,17757
12/3/2017,20,10129,1512,5438,287,0,203,17569
12/3/2017,21,10119,974,5384,349,0,194,17020
12/3/2017,22,10117,911,5266,428,0,188,16910
12/3/2017,23,10118,409,4611,559,0,180,15877
12/3/2017,24,10124,320,4254,748,0,150,15596
12/4/2017,1,10129,319,3652,1036,0,62,15198
12/4/2017,2,10128,320,3216,1252,0,57,14973
12/4/2017,3,10135,339,3185,1074,0,54,14787
12/4/2017,4,10308,348,2983,1068,0,61,14768
12/4/2017,5,10642,348,2961,1052,0,62,15065
12/4/2017,6,10646,348,3272,1349,0,65,15680
12/4/2017,7,10862,355,3809,1787,0,123,16936
12/4/2017,8,10999,408,4163,2447,0,194,18211
12/4/2017,9,11009,409,4141,2503,13,191,18266
12/4/2017,10,11011,402,3957,2813,32,190,18405
12/4/2017,11,11011,403,3908,2858,75,137,18392
12/4/2017,12,10996,403,3758,2716,95,83,18051
12/4/2017,13,10999,408,3841,2512,81,78,17919
12/4/2017,14,10992,409,4114,2438,65,95,18113
12/4/2017,15,10993,411,4388,2434,60,99,18385
12/4/2017,16,11004,412,4618,2346,16,95,18491
12/4/2017,17,10993,410,4392,2484,0,92,18371
12/4/2017,18,11010,411,4568,3325,0,91,19405
12/4/2017,19,11020,409,4633,3538,0,77,19677
12/4/2017,20,11022,409,4388,3589,0,78,19486
12/4/2017,21,11018,409,4279,3248,0,76,19030
12/4/2017,22,11035,409,3682,2961,0,74,18161
12/4/2017,23,11059,409,3593,1969,0,73,17103
12/4/2017,24,11082,407,3373,1043,0,81,15986
12/5/2017,1,11075,408,2993,754,0,73,15303
12/5/2017,2,11071,375,2972,396,0,14,14828
12/5/2017,3,10811,348,2939,427,0,14,14539
12/5/2017,4,10646,348,2935,570,0,14,14513
12/5/2017,5,10499,348,3089,713,0,14,14663
12/5/2017,6,10505,347,3040,907,0,16,14815
12/5/2017,7,10723,388,3519,1539,0,20,16189
12/5/2017,8,11020,403,3773,2411,0,26,17633
12/5/2017,9,11094,403,3795,2939,1,27,18259
12/5/2017,10,11089,399,3883,2591,7,27,17996
12/5/2017,11,11094,397,4007,2632,35,27,18192
12/5/2017,12,10968,396,3970,2389,72,27,17822
12/5/2017,13,10934,385,4101,2616,56,27,18119
12/5/2017,14,11059,387,4138,2335,42,27,17988
12/5/2017,15,11089,398,4159,2369,26,27,18068
12/5/2017,16,11087,399,4269,2544,9,27,18335
12/5/2017,17,11091,400,4430,2986,2,27,18936
12/5/2017,18,11100,401,4626,3597,0,27,19751
12/5/2017,19,11099,400,4619,3555,0,26,19699
12/5/2017,20,11100,402,4489,3498,0,26,19515
12/5/2017,21,11095,401,4319,3283,0,26,19124
12/5/2017,22,11088,401,4017,2988,0,25,18519
12/5/2017,23,11088,400,3810,2095,0,25,17418
12/5/2017,24,11085,401,3446,1388,0,17,16337
12/6/2017,1,11081,402,3162,1252,0,13,15910
12/6/2017,2,11081,404,3111,664,0,12,15272
12/6/2017,3,10839,403,3126,640,0,10,15018
12/6/2017,4,10816,404,3301,564,0,10,15095
12/6/2017,5,10803,404,3400,612,0,12,15231
12/6/2017,6,10811,405,3525,920,0,14,15675
12/6/2017,7,11075,405,3879,1507,0,21,16887
12/6/2017,8,11079,406,3832,3068,0,27,18412
12/6/2017,9,11041,406,3955,3150,30,28,18610
12/6/2017,10,11039,408,4188,2275,88,26,18024
12/6/2017,11,11043,463,4098,1879,133,27,17643
12/6/2017,12,11054,515,4056,1722,175,26,17548
12/6/2017,13,11055,515,4066,1522,187,26,17371
12/6/2017,14,11054,516,4115,1805,114,26,17630
12/6/2017,15,11045,516,4113,2164,82,27,17947
12/6/2017,16,11079,560,4430,2355,42,27,18493
12/6/2017,17,11114,616,4739,3084,4,27,19584
12/6/2017,18,11118,621,4967,3628,0,27,20361
12/6/2017,19,11115,626,4886,3522,0,27,20176
12/6/2017,20,11109,625,4952,3654,0,27,20367
12/6/2017,21,11115,624,4678,3634,0,27,20078
12/6/2017,22,11112,599,4221,3406,0,27,19365
12/6/2017,23,11099,464,3926,2541,0,27,18057
12/6/2017,24,11098,374,3473,1963,0,16,16924
12/7/2017,1,11095,373,3334,1372,0,12,16186
12/7/2017,2,11080,374,3422,707,0,10,15593
12/7/2017,3,10593,375,3434,1024,0,11,15437
12/7/2017,4,10481,432,3402,1059,0,10,15384
12/7/2017,5,10468,530,3615,801,0,10,15424
12/7/2017,6,10587,592,3924,891,0,16,16010
12/7/2017,7,11066,599,4522,1205,0,20,17412
12/7/2017,8,11088,770,5492,1452,1,26,18829
12/7/2017,9,11087,1099,5369,1526,22,27,19130
12/7/2017,10,11090,924,4776,1699,87,26,18602
12/7/2017,11,11086,755,4439,2130,88,26,18524
12/7/2017,12,11072,690,4331,2307,124,27,18551
12/7/2017,13,11084,659,4451,2178,193,27,18592
12/7/2017,14,11088,721,4611,2516,121,27,19084
12/7/2017,15,11085,813,4794,2131,104,27,18954
12/7/2017,16,11082,1073,4912,1997,32,27,19123
12/7/2017,17,11089,1017,5279,2436,3,27,19851
12/7/2017,18,11090,1030,5534,2481,0,27,20162
12/7/2017,19,11097,1002,5157,2454,0,27,19737
12/7/2017,20,11099,873,5257,2895,0,26,20150
12/7/2017,21,11089,785,4983,3110,0,27,19994
12/7/2017,22,11079,786,4676,2844,0,27,19412
12/7/2017,23,11082,461,4062,2485,0,27,18117
12/7/2017,24,11093,378,3661,1940,0,17,17089
12/8/2017,1,11097,378,3547,1448,0,13,16483
12/8/2017,2,10874,378,3345,1398,0,10,16005
12/8/2017,3,10790,378,3370,1291,0,10,15839
12/8/2017,4,10798,378,3404,1067,0,10,15657
12/8/2017,5,10796,378,3453,1065,0,10,15702
12/8/2017,6,10793,405,3661,1092,0,15,15966
12/8/2017,7,10954,405,3832,2155,0,20,17366
12/8/2017,8,11091,407,4192,3060,1,26,18777
12/8/2017,9,11045,406,4373,3162,13,27,19026
12/8/2017,10,11008,407,4192,3236,50,27,18920
12/8/2017,11,10991,406,4129,2975,71,27,18599
12/8/2017,12,10887,415,4169,2867,70,27,18435
12/8/2017,13,10950,440,4270,2319,74,27,18080
12/8/2017,14,11045,537,4195,2224,62,27,18090
12/8/2017,15,11118,658,4276,2401,52,27,18532
12/8/2017,16,11113,823,4577,2288,29,27,18857
12/8/2017,17,11114,1002,4817,2513,6,27,19479
12/8/2017,18,11108,1019,5002,2967,0,27,20123
12/8/2017,19,11116,1027,5027,2544,0,27,19741
12/8/2017,20,11115,1009,5784,2246,0,28,20182
12/8/2017,21,11115,1200,6056,1888,0,28,20287
12/8/2017,22,11125,873,5532,1807,0,27,19364
12/8/2017,23,11129,443,4940,1800,0,27,18339
12/8/2017,24,11130,376,3857,1614,0,18,16995
12/9/2017,1,11130,376,3661,1113,0,11,16291
12/9/2017,2,11126,377,3579,847,0,1,15930
12/9/2017,3,11124,379,3550,541,0,0,15594
12/9/2017,4,10913,379,3551,535,0,0,15378
12/9/2017,5,10835,376,3555,743,0,0,15509
12/9/2017,6,10836,377,3692,917,0,0,15822
12/9/2017,7,11056,443,3990,774,0,0,16263
12/9/2017,8,11135,522,4325,1142,0,0,17124
12/9/2017,9,11138,570,4635,1295,21,0,17659
12/9/2017,10,11136,584,4615,1381,33,0,17749
12/9/2017,11,11137,636,4606,1440,60,0,17879
12/9/2017,12,11138,721,4722,1318,55,0,17954
12/9/2017,13,11135,1009,4796,1042,84,0,18066
12/9/2017,14,11133,1133,4820,707,70,1,17864
12/9/2017,15,11136,1190,4811,354,45,0,17536
12/9/2017,16,11133,1318,4876,234,19,2,17582
12/9/2017,17,11137,1350,5619,286,1,2,18395
12/9/2017,18,11134,1516,6019,261,0,0,18930
12/9/2017,19,11131,1439,5883,347,0,0,18800
12/9/2017,20,11133,1358,5811,449,0,0,18751
12/9/2017,21,11140,933,5514,845,0,0,18432
12/9/2017,22,11140,650,5031,899,0,0,17720
12/9/2017,23,11145,468,4438,989,0,0,17040
12/9/2017,24,11144,381,3985,1149,0,0,16659
12/10/2017,1,11146,380,3654,823,0,0,16003
12/10/2017,2,11148,381,3420,589,0,0,15538
12/10/2017,3,11146,380,3470,551,0,0,15547
12/10/2017,4,11145,379,3443,487,0,0,15454
12/10/2017,5,11138,381,3481,394,0,0,15394
12/10/2017,6,11144,381,3459,475,0,0,15459
12/10/2017,7,11146,380,3630,452,0,0,15608
12/10/2017,8,11152,380,3907,1025,0,0,16464
12/10/2017,9,11146,379,3974,1659,10,0,17168
12/10/2017,10,11143,375,3956,2395,18,0,17887
12/10/2017,11,11152,381,3948,2643,47,0,18171
12/10/2017,12,11156,381,3960,2750,61,0,18308
12/10/2017,13,11157,383,4009,2819,58,0,18426
12/10/2017,14,11157,480,4067,2747,46,0,18497
12/10/2017,15,11151,584,4180,2751,24,0,18690
12/10/2017,16,11108,667,4629,2497,12,0,18913
12/10/2017,17,11157,731,5204,2384,0,0,19476
12/10/2017,18,11156,805,5370,2434,0,0,19765
12/10/2017,19,11161,809,5250,2270,0,0,19490
12/10/2017,20,11159,810,5008,2241,0,0,19218
12/10/2017,21,11151,805,5286,2108,0,0,19350
12/10/2017,22,11148,678,4995,1900,0,0,18721
12/10/2017,23,11130,590,4489,1728,0,0,17937
12/10/2017,24,11134,421,4072,1582,0,0,17209
12/11/2017,1,11134,381,3776,1427,0,0,16718
12/11/2017,2,11133,418,3691,1102,0,0,16344
12/11/2017,3,11147,431,3818,701,0,12,16109
12/11/2017,4,11157,525,3830,570,0,15,16097
12/11/2017,5,11158,665,3888,579,0,12,16302
12/11/2017,6,11160,754,4332,456,0,14,16716
12/11/2017,7,11154,854,5123,404,0,21,17556
12/11/2017,8,11157,1327,5765,371,1,26,18647
12/11/2017,9,11156,1728,5312,437,28,27,18688
12/11/2017,10,11152,1883,5512,379,71,26,19023
12/11/2017,11,11157,1660,5665,332,90,26,18930
12/11/2017,12,11152,1632,5730,275,87,26,18902
12/11/2017,13,10995,1498,5253,391,93,27,18257
12/11/2017,14,10992,1486,5300,501,91,38,18408
12/11/2017,15,11136,1484,5522,498,38,83,18761
12/11/2017,16,11150,1769,5569,613,8,168,19277
12/11/2017,17,11155,1861,5692,781,0,199,19688
12/11/2017,18,11153,2236,5854,901,0,151,20295
12/11/2017,19,11154,1899,5898,922,0,120,19993
12/11/2017,20,11155,1873,5880,996,0,152,20056
12/11/2017,21,11149,1856,5848,923,0,205,19981
12/11/2017,22,11142,1714,5883,744,0,175,19658
12/11/2017,23,11141,1384,5499,736,0,92,18852
12/11/2017,24,11151,544,4557,600,0,29,16881
12/12/2017,1,11153,389,4342,554,0,14,16452
12/12/2017,2,11156,402,4113,736,0,11,16418
12/12/2017,3,11144,416,3589,1004,0,10,16163
12/12/2017,4,11146,413,3711,663,0,12,15945
12/12/2017,5,11148,416,3662,850,0,12,16088
12/12/2017,6,11148,413,3883,1098,0,12,16554
12/12/2017,7,11153,423,4119,2258,0,16,17969
12/12/2017,8,11151,474,4591,2946,0,23,19185
12/12/2017,9,11143,605,4809,3191,0,24,19772
12/12/2017,10,11012,605,4780,3471,1,24,19893
12/12/2017,11,10974,612,4785,3394,14,26,19805
12/12/2017,12,10970,613,4835,3461,28,24,19931
12/12/2017,13,10969,716,4693,3434,48,22,19882
12/12/2017,14,10970,878,4770,3055,57,24,19754
12/12/2017,15,10964,1013,4721,2932,27,24,19681
12/12/2017,16,10985,1027,4717,2675,27,24,19455
12/12/2017,17,11135,1056,4966,2983,1,28,20169
12/12/2017,18,11144,1205,5764,3232,0,38,21383
12/12/2017,19,11140,1206,5876,3199,0,39,21460
12/12/2017,20,11142,1202,5827,3254,0,34,21459
12/12/2017,21,11133,1212,5378,3203,0,27,20953
12/12/2017,22,11135,925,5061,3012,0,24,20157
12/12/2017,23,11121,713,4586,2792,0,24,19236
12/12/2017,24,11125,542,3908,2470,0,17,18062
12/13/2017,1,11133,493,3825,1700,0,13,17164
12/13/2017,2,11144,496,3814,1208,0,13,16675
12/13/2017,3,11145,506,3821,1019,0,18,16509
12/13/2017,4,11148,594,3813,957,0,16,16528
12/13/2017,5,11145,642,3950,973,0,25,16735
12/13/2017,6,11148,828,4262,1359,0,33,17630
12/13/2017,7,11148,1204,4905,1584,0,37,18878
12/13/2017,8,11152,1874,5816,1257,0,41,20140
12/13/2017,9,11152,1906,5715,1050,14,52,19889
12/13/2017,10,11153,2112,5722,695,47,43,19772
12/13/2017,11,11147,2223,5687,515,83,44,19699
12/13/2017,12,11152,1748,5645,472,79,33,19129
12/13/2017,13,11153,1561,5618,459,73,38,18902
12/13/2017,14,11157,1743,5411,452,51,43,18857
12/13/2017,15,11158,2139,5239,378,29,41,18984
12/13/2017,16,11148,2304,5218,522,10,43,19245
12/13/2017,17,11161,2362,5504,834,0,46,19907
12/13/2017,18,11161,2736,5856,1046,0,44,20843
12/13/2017,19,11155,2599,5771,1110,0,40,20675
12/13/2017,20,11153,2597,5681,1160,0,39,20630
12/13/2017,21,11150,2271,5824,1109,0,37,20391
12/13/2017,22,11142,2014,5394,1167,0,25,19742
12/13/2017,23,11144,1424,4772,1474,0,25,18839
12/13/2017,24,11154,719,4396,1849,0,13,18131
12/14/2017,1,11152,580,3975,1630,0,11,17348
12/14/2017,2,11149,434,4000,1673,0,11,17267
12/14/2017,3,11151,401,3970,1585,0,10,17117
12/14/2017,4,11154,412,4063,1330,0,10,16969
12/14/2017,5,11151,536,4013,1379,0,10,17089
12/14/2017,6,11152,804,4714,907,0,11,17588
12/14/2017,7,11153,1372,5286,616,0,49,18476
12/14/2017,8,11154,1966,5506,503,0,94,19223
12/14/2017,9,11152,2036,5349,441,1,165,19144
12/14/2017,10,11153,2121,5335,450,7,205,19271
12/14/2017,11,11043,2033,5391,472,14,204,19157
12/14/2017,12,10984,1995,5474,576,20,195,19244
12/14/2017,13,11112,1936,5112,651,26,154,18991
12/14/2017,14,11155,2074,5073,648,29,91,19070
12/14/2017,15,11158,2082,5037,653,22,42,18994
12/14/2017,16,11160,2172,5159,667,6,25,19189
12/14/2017,17,11159,2692,5314,609,1,27,19802
12/14/2017,18,11158,2911,5850,561,0,43,20523
12/14/2017,19,11165,3079,5719,702,0,56,20721
12/14/2017,20,11159,2661,5855,851,0,81,20607
12/14/2017,21,11204,2474,5704,944,0,123,20449
12/14/2017,22,11200,2099,5499,997,0,190,19985
12/14/2017,23,11149,1458,5552,1120,0,204,19483
12/14/2017,24,10402,797,5422,1160,0,165,17946
12/15/2017,1,10370,393,4695,1343,0,76,16877
12/15/2017,2,10370,402,4219,1377,0,66,16434
12/15/2017,3,10370,409,4227,1244,0,68,16318
12/15/2017,4,10371,529,3984,1293,0,69,16246
12/15/2017,5,10370,1009,3886,1323,0,69,16657
12/15/2017,6,10370,1389,4097,1050,0,113,17019
12/15/2017,7,10373,1653,5207,1324,0,190,18747
12/15/2017,8,10357,1860,5666,1492,0,198,19573
12/15/2017,9,10368,1757,5676,1736,0,199,19736
12/15/2017,10,10373,2010,5732,1876,3,202,20196
12/15/2017,11,10370,1854,5813,2149,8,202,20396
12/15/2017,12,10380,1497,5629,2492,12,203,20213
12/15/2017,13,10378,1395,5194,2627,12,203,19809
12/15/2017,14,10373,1406,5650,2674,11,205,20319
12/15/2017,15,10370,1077,5812,2944,8,210,20421
12/15/2017,16,10367,1022,5460,3152,2,204,20207
12/15/2017,17,10368,1353,5812,3146,0,202,20881
12/15/2017,18,10371,1745,5914,3078,0,208,21316
12/15/2017,19,10373,1552,5432,3297,0,201,20855
12/15/2017,20,10369,1475,5142,3472,0,170,20628
12/15/2017,21,10371,1350,4936,3525,0,191,20373
12/15/2017,22,10371,1196,5180,3471,0,170,20388
12/15/2017,23,10372,927,4351,3270,0,90,19010
12/15/2017,24,10357,736,4134,2740,0,29,17996
12/16/2017,1,10363,497,3806,2376,0,0,17042
12/16/2017,2,10364,428,3783,2140,0,0,16715
12/16/2017,3,10359,380,3832,1971,0,0,16542
12/16/2017,4,10361,272,3845,1738,0,0,16216
12/16/2017,5,10367,323,3728,1882,0,0,16300
12/16/2017,6,10373,339,3820,1611,0,0,16143
12/16/2017,7,10394,477,4010,1498,0,0,16379
12/16/2017,8,10420,717,4811,1494,0,0,17442
12/16/2017,9,10421,1098,5386,1063,2,0,17970
12/16/2017,10,10418,1443,5620,773,11,0,18265
12/16/2017,11,10407,1763,5750,550,13,3,18486
12/16/2017,12,10368,1855,5823,397,22,3,18468
12/16/2017,13,10368,1874,5815,310,36,13,18416
12/16/2017,14,10375,1743,5733,313,40,7,18211
12/16/2017,15,10375,2032,5746,303,32,4,18492
12/16/2017,16,10376,2340,5797,296,14,8,18831
12/16/2017,17,10382,2619,5091,285,6,0,18383
12/16/2017,18,10378,3093,5921,217,2,3,19614
12/16/2017,19,10376,3067,5861,319,2,1,19626
12/16/2017,20,10374,2657,5799,420,2,1,19253
12/16/2017,21,10365,1964,5823,431,2,1,18586
12/16/2017,22,10365,1587,5639,420,2,3,18016
12/16/2017,23,10363,1250,5368,514,2,3,17500
12/16/2017,24,10369,765,5071,554,2,0,16761
12/17/2017,1,10367,921,4760,589,2,0,16639
12/17/2017,2,10368,425,4703,622,0,0,16118
12/17/2017,3,10361,244,4314,685,0,0,15604
12/17/2017,4,10358,242,3982,767,0,0,15349
12/17/2017,5,10354,257,4046,665,0,0,15322
12/17/2017,6,10360,508,4288,672,0,0,15828
12/17/2017,7,10368,914,4669,738,0,0,16689
12/17/2017,8,10368,1223,4382,820,0,0,16793
12/17/2017,9,10364,1281,5007,954,9,0,17615
12/17/2017,10,10353,1265,5126,1080,26,0,17850
12/17/2017,11,10362,1272,5469,985,48,1,18137
12/17/2017,12,10354,1312,5518,854,55,1,18094
12/17/2017,13,10360,1439,5587,759,50,0,18195
12/17/2017,14,10369,1644,5416,883,36,0,18348
12/17/2017,15,10324,1857,5274,993,23,0,18471
12/17/2017,16,10370,2170,4961,1004,10,0,18515
12/17/2017,17,10367,2404,5227,1098,0,0,19096
12/17/2017,18,10374,2923,5741,949,0,0,19987
12/17/2017,19,10375,2923,5837,898,0,0,20033
12/17/2017,20,10373,2601,5806,1005,0,0,19785
12/17/2017,21,10371,2046,5816,1048,0,0,19281
12/17/2017,22,10359,1558,5528,1141,0,0,18586
12/17/2017,23,10357,1135,5131,1146,0,0,17769
12/17/2017,24,10370,860,4209,1260,0,9,16708
12/18/2017,1,10373,354,4183,1293,0,10,16213
12/18/2017,2,10373,267,3999,1025,0,10,15674
12/18/2017,3,10374,271,3710,1115,0,10,15480
12/18/2017,4,10379,272,3710,1171,0,10,15542
12/18/2017,5,10391,381,3665,1121,0,10,15568
12/18/2017,6,10390,637,4265,1489,0,12,16793
12/18/2017,7,10388,854,4725,1685,0,19,17671
12/18/2017,8,10383,1235,5437,1855,0,24,18934
12/18/2017,9,10379,1454,5687,2036,2,25,19583
12/18/2017,10,10379,1669,5838,1983,10,27,19906
12/18/2017,11,10378,1840,5769,2066,11,30,20094
12/18/2017,12,10381,1707,5590,2210,14,29,19931
12/18/2017,13,10372,1775,5369,2357,15,51,19939
12/18/2017,14,10377,1766,5634,2392,13,96,20278
12/18/2017,15,10378,1840,5528,2435,10,134,20325
12/18/2017,16,10382,1902,5465,2404,5,114,20272
12/18/2017,17,10382,2034,5415,2398,0,127,20356
12/18/2017,18,10379,2322,5643,2408,0,184,20936
12/18/2017,19,10381,2458,5352,2432,0,182,20805
12/18/2017,20,10378,2250,5257,2437,0,186,20508
12/18/2017,21,10369,1499,5644,2753,0,193,20458
12/18/2017,22,10366,1262,5308,3015,0,149,20100
12/18/2017,23,10361,841,4363,2874,0,70,18509
12/18/2017,24,10364,512,3874,2360,0,44,17154
12/19/2017,1,10370,374,3601,2057,0,40,16442
12/19/2017,2,10363,379,3583,1594,0,41,15960
12/19/2017,3,10365,401,3561,1415,0,46,15788
12/19/2017,4,10369,402,3563,1297,0,42,15673
12/19/2017,5,10374,402,3513,1334,0,42,15665
12/19/2017,6,10374,401,3575,1799,0,43,16192
12/19/2017,7,10371,479,3724,2947,0,49,17570
12/19/2017,8,10339,589,4175,3646,0,55,18804
12/19/2017,9,10289,588,4268,3686,5,54,18890
12/19/2017,10,10292,581,4449,3640,32,53,19047
12/19/2017,11,10294,553,4504,3600,45,51,19047
12/19/2017,12,10301,551,4220,3670,74,50,18866
12/19/2017,13,10285,606,4399,3537,71,49,18947
12/19/2017,14,10261,652,4548,3604,52,54,19171
12/19/2017,15,10262,771,4477,3694,47,53,19304
12/19/2017,16,10287,770,4420,3625,23,53,19178
12/19/2017,17,10370,774,4720,3222,5,58,19149
12/19/2017,18,10361,725,4985,3416,0,52,19539
12/19/2017,19,10365,739,4967,3690,0,54,19815
12/19/2017,20,10559,747,5005,3806,0,55,20172
12/19/2017,21,10563,606,4955,3917,0,56,20097
12/19/2017,22,10574,520,4467,3858,0,57,19476
12/19/2017,23,10553,421,3807,3194,0,57,18032
12/19/2017,24,10530,406,3475,2343,0,45,16799
12/20/2017,1,10549,380,3453,1674,0,42,16098
12/20/2017,2,10723,380,3405,1025,0,35,15568
12/20/2017,3,10728,379,3480,829,0,25,15441
12/20/2017,4,10762,380,3453,611,0,31,15237
12/20/2017,5,10919,381,3431,904,0,36,15671
12/20/2017,6,10927,455,3377,1737,0,38,16534
12/20/2017,7,10920,613,3963,1829,0,44,17369
12/20/2017,8,10913,857,4587,1995,0,50,18402
12/20/2017,9,10912,897,5311,1642,17,50,18829
12/20/2017,10,10911,943,5323,1479,40,50,18746
12/20/2017,11,10913,1154,4963,1395,88,51,18564
12/20/2017,12,10911,1490,4555,1184,119,50,18309
12/20/2017,13,10911,1711,4669,1097,117,50,18555
12/20/2017,14,10902,2022,5125,890,70,54,19063
12/20/2017,15,10900,2063,5401,774,35,54,19227
12/20/2017,16,10867,2005,5217,745,16,47,18897
12/20/2017,17,10968,2054,5617,743,2,49,19433
12/20/2017,18,10980,2259,5770,641,0,52,19702
12/20/2017,19,10988,2020,5752,633,0,47,19440
12/20/2017,20,10984,2112,5919,383,0,49,19447
12/20/2017,21,10988,2121,5803,202,0,55,19169
12/20/2017,22,10985,1664,5630,125,0,55,18459
12/20/2017,23,10975,1083,5160,105,0,58,17381
12/20/2017,24,10979,489,4941,95,0,49,16553
12/21/2017,1,10994,376,4490,90,0,44,15994
12/21/2017,2,10984,376,4253,106,0,40,15759
12/21/2017,3,10998,384,4336,108,0,41,15867
12/21/2017,4,11054,499,4516,102,0,37,16208
12/21/2017,5,11073,674,4383,117,0,44,16291
12/21/2017,6,11075,879,4369,81,0,63,16467
12/21/2017,7,11117,948,5039,69,0,111,17284
12/21/2017,8,11116,1352,5770,121,0,196,18555
12/21/2017,9,11108,1417,5706,153,29,235,18648
12/21/2017,10,11105,1246,5771,96,84,234,18536
12/21/2017,11,11083,1244,5731,124,107,238,18527
12/21/2017,12,11070,1342,5634,175,113,234,18568
12/21/2017,13,11071,1211,5563,280,108,172,18405
12/21/2017,14,11071,1228,5691,233,80,140,18443
12/21/2017,15,11064,1281,5648,212,53,212,18470
12/21/2017,16,11064,1415,5515,274,26,238,18532
12/21/2017,17,11074,1480,5729,466,3,242,18994
12/21/2017,18,11078,1711,5890,748,0,242,19669
12/21/2017,19,11095,1557,5731,988,0,238,19609
12/21/2017,20,11113,1466,5370,1347,0,238,19534
12/21/2017,21,11106,1086,5719,1559,0,239,19709
12/21/2017,22,11096,826,5602,1615,0,241,19380
12/21/2017,23,11108,473,4908,1726,0,179,18394
12/21/2017,24,11108,378,4179,1646,0,65,17376
12/22/2017,1,11099,377,3575,1510,0,51,16612
12/22/2017,2,11110,377,3565,1428,0,49,16529
12/22/2017,3,11111,375,3395,1262,0,50,16193
12/22/2017,4,11105,387,3468,1174,0,50,16184
12/22/2017,5,11115,441,3425,1360,0,48,16389
12/22/2017,6,11117,658,3854,1107,0,52,16788
12/22/2017,7,11113,826,4595,1699,0,59,18292
12/22/2017,8,11113,968,5055,1732,0,62,18930
12/22/2017,9,11100,1023,5335,1683,1,58,19200
12/22/2017,10,11101,1079,5623,1460,13,57,19333
12/22/2017,11,11101,1264,5940,1237,25,62,19629
12/22/2017,12,11104,1616,5843,1007,38,65,19673
12/22/2017,13,11093,1464,5674,788,38,69,19126
12/22/2017,14,11102,1553,5615,803,36,89,19198
12/22/2017,15,11105,1787,5613,829,26,110,19470
12/22/2017,16,11108,1664,5694,804,12,124,19406
12/22/2017,17,11107,1713,5787,725,0,137,19469
12/22/2017,18,11111,1971,5915,702,0,150,19849
12/22/2017,19,11112,1672,5898,606,0,124,19412
12/22/2017,20,11113,1906,5944,592,0,175,19730
12/22/2017,21,11109,1705,5819,553,0,158,19344
12/22/2017,22,11102,1716,5750,451,0,187,19206
12/22/2017,23,11108,1517,5407,407,0,179,18618
12/22/2017,24,11114,515,4715,319,0,98,16761
12/23/2017,1,11118,297,3888,170,0,48,15521
12/23/2017,2,11116,297,3574,125,0,33,15145
12/23/2017,3,11132,297,3226,146,0,33,14834
12/23/2017,4,11136,305,3150,95,0,32,14718
12/23/2017,5,11134,312,3244,201,0,28,14919
12/23/2017,6,11134,396,3324,224,0,26,15104
12/23/2017,7,11132,549,3697,248,0,30,15656
12/23/2017,8,11136,714,4120,164,0,30,16164
12/23/2017,9,11135,765,4537,463,0,28,16928
12/23/2017,10,11128,874,5114,638,1,29,17784
12/23/2017,11,11123,932,5456,924,2,25,18462
12/23/2017,12,11126,1028,5204,1031,2,18,18409
12/23/2017,13,11125,1249,5421,1060,5,15,18875
12/23/2017,14,11121,1345,4397,1178,14,16,18071
12/23/2017,15,11134,1332,4381,1088,35,36,18006
12/23/2017,16,11090,1335,4408,1474,25,57,18389
12/23/2017,17,11123,1331,4709,1076,4,59,18302
12/23/2017,18,11124,1335,4879,1527,0,59,18924
12/23/2017,19,11124,1335,5116,1671,0,59,19305
12/23/2017,20,11126,1207,5472,1501,0,59,19365
12/23/2017,21,11119,1113,4735,1557,0,17,18541
12/23/2017,22,11113,623,4700,1333,0,2,17771
12/23/2017,23,11108,348,4466,1366,0,0,17288
12/23/2017,24,11110,299,3768,1355,0,0,16532
12/24/2017,1,11116,299,3328,1340,0,0,16083
12/24/2017,2,11119,298,3213,958,0,0,15588
12/24/2017,3,11120,299,3147,611,0,0,15177
12/24/2017,4,11118,293,3187,428,0,0,15026
12/24/2017,5,11115,299,3143,559,0,0,15116
12/24/2017,6,11121,299,3297,696,0,0,15413
12/24/2017,7,11118,299,3960,458,0,0,15835
12/24/2017,8,11122,300,4775,358,0,0,16555
12/24/2017,9,11121,303,4862,309,3,0,16598
12/24/2017,10,11123,304,4771,285,14,0,16497
12/24/2017,11,11130,305,4777,272,34,0,16518
12/24/2017,12,11122,305,4826,267,36,0,16556
12/24/2017,13,11125,405,4721,239,23,0,16513
12/24/2017,14,11133,425,4676,314,18,0,16566
12/24/2017,15,11137,470,4736,425,8,0,16776
12/24/2017,16,11137,533,4410,491,4,0,16575
12/24/2017,17,11135,535,4712,648,0,0,17030
12/24/2017,18,11132,539,4968,866,0,0,17505
12/24/2017,19,11128,540,5018,989,0,0,17675
12/24/2017,20,11125,541,5006,1042,0,0,17714
12/24/2017,21,11122,541,4973,1012,0,0,17648
12/24/2017,22,11118,405,4877,988,0,0,17388
12/24/2017,23,11115,309,4569,1121,0,0,17114
12/24/2017,24,11118,311,3811,1384,0,0,16624
12/25/2017,1,11122,314,3249,1419,0,0,16104
12/25/2017,2,11123,315,3127,765,0,4,15334
12/25/2017,3,10755,315,3223,632,0,2,14927
12/25/2017,4,10532,315,3207,634,0,0,14688
12/25/2017,5,10530,316,3114,733,0,0,14693
12/25/2017,6,10524,316,3190,980,0,0,15010
12/25/2017,7,10264,316,3769,717,0,0,15066
12/25/2017,8,10325,315,4119,838,1,0,15598
12/25/2017,9,10963,306,4160,1002,2,0,16433
12/25/2017,10,11128,304,4144,1254,10,0,16840
12/25/2017,11,11136,317,4150,1342,25,0,16970
12/25/2017,12,11138,340,4163,1262,19,0,16922
12/25/2017,13,11131,360,4402,1359,41,0,17293
12/25/2017,14,11134,434,4496,857,26,0,16947
12/25/2017,15,11132,569,4568,824,13,0,17106
12/25/2017,16,11128,840,4575,526,13,0,17082
12/25/2017,17,11133,879,4609,1084,3,0,17708
12/25/2017,18,11135,965,4658,1657,0,0,18415
12/25/2017,19,11144,1041,4493,1334,0,0,18012
12/25/2017,20,11155,964,4552,964,0,0,17635
12/25/2017,21,11152,900,4331,1309,0,0,17692
12/25/2017,22,11140,585,3985,1771,0,0,17481
12/25/2017,23,11143,503,3703,1806,0,0,17155
12/25/2017,24,11147,499,3608,1250,0,0,16504
12/26/2017,1,11147,320,3483,689,0,0,15639
12/26/2017,2,11147,307,3480,440,0,1,15375
12/26/2017,3,11082,307,3561,265,0,1,15216
12/26/2017,4,10835,305,3647,508,0,0,15295
12/26/2017,5,10855,305,3582,601,0,0,15343
12/26/2017,6,10859,308,3623,1057,0,0,15847
12/26/2017,7,11058,308,3365,1903,0,0,16634
12/26/2017,8,11105,309,3551,2340,0,0,17305
12/26/2017,9,11102,359,3572,2540,8,0,17581
12/26/2017,10,11111,393,3875,2519,28,0,17926
12/26/2017,11,11122,321,3958,2375,53,0,17829
12/26/2017,12,11127,319,4099,2180,68,0,17793
12/26/2017,13,11136,431,4014,2243,75,0,17899
12/26/2017,14,11152,549,4048,1679,71,0,17499
12/26/2017,15,11153,675,4281,1634,51,1,17795
12/26/2017,16,11163,1009,4412,1780,18,4,18386
12/26/2017,17,11156,1141,4931,1818,3,23,19072
12/26/2017,18,11147,1253,5478,2064,0,56,19998
12/26/2017,19,11152,1260,5173,2197,0,51,19833
12/26/2017,20,11148,1265,4955,2244,0,51,19663
12/26/2017,21,11149,1262,4564,2456,0,51,19482
12/26/2017,22,11144,1063,4401,2366,0,51,19025
12/26/2017,23,11141,589,3979,2180,0,51,17940
12/26/2017,24,11140,345,3582,1948,0,50,17065
12/27/2017,1,11143,309,3188,2195,0,18,16853
12/27/2017,2,11149,313,3309,2108,0,9,16888
12/27/2017,3,11139,342,3381,2094,0,10,16966
12/27/2017,4,11138,537,3148,1836,0,10,16669
12/27/2017,5,11146,943,3040,1719,0,12,16860
12/27/2017,6,11148,1342,3282,1435,0,18,17225
12/27/2017,7,11153,1454,4175,1753,0,28,18563
12/27/2017,8,11148,1467,4586,1779,0,29,19009
12/27/2017,9,11144,1505,4984,1725,8,26,19392
12/27/2017,10,11134,1508,4770,1475,31,27,18945
12/27/2017,11,11140,1499,5069,1276,61,55,19100
12/27/2017,12,11146,1495,5202,1185,90,80,19198
12/27/2017,13,11155,1571,5049,1269,109,109,19262
12/27/2017,14,11178,1629,5343,1354,94,129,19727
12/27/2017,15,11227,1856,5491,1191,73,135,19973
12/27/2017,16,11259,2004,5216,1030,40,118,19667
12/27/2017,17,11330,2935,5523,903,8,140,20839
12/27/2017,18,11401,3432,5634,1052,0,143,21662
12/27/2017,19,11402,3592,5610,1150,0,145,21899
12/27/2017,20,11406,3524,5669,1001,0,140,21740
12/27/2017,21,11401,4036,5431,894,0,138,21900
12/27/2017,22,11389,3798,5190,917,0,132,21426
12/27/2017,23,11398,2466,4856,949,0,87,19756
12/27/2017,24,11411,1625,4252,969,0,23,18280
12/28/2017,1,11419,1748,3895,1035,0,11,18108
12/28/2017,2,11428,1393,3620,984,0,13,17438
12/28/2017,3,11430,1347,3608,874,0,15,17274
12/28/2017,4,11429,1464,3656,757,0,10,17316
12/28/2017,5,11422,1740,3989,564,0,12,17727
12/28/2017,6,11422,2360,4259,494,0,49,18584
12/28/2017,7,11425,2922,4641,457,0,79,19524
12/28/2017,8,11424,3348,4981,434,0,100,20287
12/28/2017,9,11424,3718,5056,366,11,134,20709
12/28/2017,10,11421,3631,5210,328,42,136,20768
12/28/2017,11,11423,4069,5299,255,75,137,21258
12/28/2017,12,11426,3991,5258,241,97,136,21149
12/28/2017,13,11425,3578,5303,190,99,132,20727
12/28/2017,14,11430,3077,5062,133,92,92,19886
12/28/2017,15,11426,3000,4998,155,70,84,19733
12/28/2017,16,11420,3159,5356,129,36,111,20211
12/28/2017,17,11423,3774,5304,178,6,140,20825
12/28/2017,18,11534,4316,5405,231,0,107,21593
12/28/2017,19,11604,4121,5433,347,0,91,21596
12/28/2017,20,11600,3764,5509,497,0,68,21438
12/28/2017,21,11599,4414,5339,435,0,33,21820
12/28/2017,22,11597,4336,4928,426,0,26,21313
12/28/2017,23,11596,3253,4568,461,0,26,19904
12/28/2017,24,11598,2335,3766,526,0,18,18243
12/29/2017,1,11603,1970,3651,491,0,14,17729
12/29/2017,2,11599,1927,3590,560,0,12,17688
12/29/2017,3,11592,1929,3662,613,0,10,17806
12/29/2017,4,11599,1965,3587,629,0,10,17790
12/29/2017,5,11611,2199,3921,664,0,12,18407
12/29/2017,6,11602,2559,3870,764,0,15,18810
12/29/2017,7,11597,2774,4300,818,0,17,19506
12/29/2017,8,11599,3106,4913,911,0,22,20551
12/29/2017,9,11595,3486,5093,913,0,23,21110
12/29/2017,10,11593,3594,5191,875,5,16,21274
12/29/2017,11,11592,4022,5115,753,14,17,21513
12/29/2017,12,11596,3729,5177,659,24,18,21203
12/29/2017,13,11602,3803,4967,543,33,21,20969
12/29/2017,14,11472,3679,4797,477,37,21,20483
12/29/2017,15,11604,3223,4839,558,33,22,20279
12/29/2017,16,11631,3159,4921,611,15,21,20358
12/29/2017,17,11630,3866,5277,706,1,25,21505
12/29/2017,18,11631,4500,5375,839,0,24,22369
12/29/2017,19,11636,4177,5269,1199,0,26,22307
12/29/2017,20,11648,3444,5252,1445,0,27,21816
12/29/2017,21,11642,3980,4978,1459,0,26,22085
12/29/2017,22,11641,3200,4600,1475,0,26,20942
12/29/2017,23,11654,2331,3968,1512,0,26,19491
12/29/2017,24,11640,1786,3673,1367,0,18,18484
12/30/2017,1,11640,1583,3626,1283,0,5,18137
12/30/2017,2,11643,1434,3622,1234,0,0,17933
12/30/2017,3,11647,1280,3430,1186,0,0,17543
12/30/2017,4,11653,1145,3384,1173,0,0,17355
12/30/2017,5,11682,1185,3297,1202,0,0,17366
12/30/2017,6,11684,1368,3380,1457,0,0,17889
12/30/2017,7,11679,1588,3728,1667,0,0,18662
12/30/2017,8,11663,1893,3930,1723,0,0,19209
12/30/2017,9,11664,2036,4349,1766,0,0,19815
12/30/2017,10,11655,2277,4608,1726,4,0,20270
12/30/2017,11,11685,3013,4426,1769,9,0,20902
12/30/2017,12,11684,2678,4343,2044,19,0,20768
12/30/2017,13,11688,2165,4548,2464,29,0,20894
12/30/2017,14,11692,2012,4366,2561,39,0,20670
12/30/2017,15,11678,2150,3817,2602,29,0,20276
12/30/2017,16,11685,2122,3908,2322,11,0,20048
12/30/2017,17,11674,2153,4860,2515,3,0,21205
12/30/2017,18,11683,2426,5306,2640,0,0,22055
12/30/2017,19,11688,2733,5405,2659,0,1,22486
12/30/2017,20,11691,2519,5060,2374,0,0,21644
12/30/2017,21,11681,2347,4982,2111,0,0,21121
12/30/2017,22,11671,2405,4726,1780,0,0,20582
12/30/2017,23,11682,2015,4177,1585,0,0,19459
12/30/2017,24,11681,1786,3639,1278,0,0,18384
12/31/2017,1,11678,1452,3411,1016,0,0,17557
12/31/2017,2,11678,1690,3497,961,0,0,17826
12/31/2017,3,11669,1691,3480,906,0,0,17746
12/31/2017,4,11660,1252,3320,719,0,0,16951
12/31/2017,5,11662,1391,3561,616,0,0,17230
12/31/2017,6,11670,1667,3552,551,0,0,17440
12/31/2017,7,11671,1762,3671,580,0,0,17684
12/31/2017,8,11669,2566,3796,516,0,0,18547
12/31/2017,9,11664,3002,3703,441,2,0,18812
12/31/2017,10,11669,3066,3996,500,11,0,19242
12/31/2017,11,11671,2792,4507,378,31,0,19379
12/31/2017,12,11680,2830,4483,197,48,7,19245
12/31/2017,13,11676,2777,4641,205,63,5,19367
12/31/2017,14,11680,2796,4632,255,60,0,19423
12/31/2017,15,11681,3099,4597,352,51,0,19780
12/31/2017,16,11681,2881,4439,427,25,0,19453
12/31/2017,17,11668,3393,4933,559,4,0,20557
12/31/2017,18,11674,4232,5137,722,0,0,21765
12/31/2017,19,11679,3755,5173,1018,0,6,21631
12/31/2017,20,11681,3032,5110,1201,0,8,21032
12/31/2017,21,11675,2853,4978,1180,0,6,20692
12/31/2017,22,11682,2721,4525,1214,0,0,20142
12/31/2017,23,11677,2715,3918,1164,0,1,19475
12/31/2017,24,11680,2526,3739,1049,0,3,18997
