Date,Hour,NUCLEAR,GAS,HYDRO,WIND,SOLAR,BIOFUEL,Total Output
1/1/2015,1,11564,957,3173,2504,0,20,18218
1/1/2015,2,11560,946,3100,2262,0,20,17888
1/1/2015,3,11560,947,3051,2025,0,20,17603
1/1/2015,4,11444,949,3086,1950,0,22,17451
1/1/2015,5,11174,946,3131,2015,0,21,17287
1/1/2015,6,10974,947,3103,2332,0,20,17376
1/1/2015,7,10976,951,3315,2368,0,20,17630
1/1/2015,8,11199,952,3567,2258,0,20,17996
1/1/2015,9,11271,952,3637,2183,0,20,18063
1/1/2015,10,11270,953,3932,2605,0,20,18780
1/1/2015,11,11416,951,3767,2704,0,20,18858
1/1/2015,12,11570,954,3719,2444,0,20,18707
1/1/2015,13,11562,952,3826,2741,0,20,19101
1/1/2015,14,11560,951,3974,2733,0,20,19238
1/1/2015,15,11565,970,3947,2586,0,20,19088
1/1/2015,16,11564,1007,4202,2266,0,20,19059
1/1/2015,17,11564,1093,4296,2634,0,19,19606
1/1/2015,18,11564,1083,5056,2760,0,18,20481
1/1/2015,19,11569,1083,5143,2692,0,18,20505
1/1/2015,20,11567,1084,4774,2737,0,18,20180
1/1/2015,21,11567,1084,4566,2651,0,18,19886
1/1/2015,22,11562,1083,4035,2631,0,18,19329
1/1/2015,23,11561,941,3539,2649,0,18,18708
1/1/2015,24,11558,903,3276,2079,0,18,17834
1/2/2015,1,11566,900,3060,1955,0,18,17499
1/2/2015,2,11566,900,3086,1854,0,18,17424
1/2/2015,3,11566,904,2959,1838,0,19,17286
1/2/2015,4,11560,905,2970,1590,0,19,17044
1/2/2015,5,11561,955,2931,1273,0,19,16739
1/2/2015,6,11561,990,3069,1196,0,32,16848
1/2/2015,7,11561,1079,3512,1186,0,40,17378
1/2/2015,8,11560,1265,4412,1106,0,45,18388
1/2/2015,9,11566,1491,4686,921,0,54,18718
1/2/2015,10,11564,1566,5116,870,0,53,19169
1/2/2015,11,11567,1626,4934,940,0,56,19123
1/2/2015,12,11568,1704,4729,1197,0,56,19254
1/2/2015,13,11567,1857,4462,1337,0,55,19278
1/2/2015,14,11567,2029,4346,1227,0,55,19224
1/2/2015,15,11566,2167,4490,849,0,54,19126
1/2/2015,16,11570,2168,5212,627,0,52,19629
1/2/2015,17,11570,2238,5519,531,0,51,19909
1/2/2015,18,11570,3162,6225,324,0,50,21331
1/2/2015,19,11570,3031,6064,262,0,45,20972
1/2/2015,20,11574,2798,6009,274,0,35,20690
1/2/2015,21,11564,2493,5970,203,0,36,20266
1/2/2015,22,11559,2165,5475,206,0,35,19440
1/2/2015,23,11560,1457,5401,168,0,34,18620
1/2/2015,24,11567,1212,5117,185,0,22,18103
1/3/2015,1,11575,953,4681,306,0,15,17530
1/3/2015,2,11576,907,4268,533,0,3,17287
1/3/2015,3,11577,913,3720,932,0,3,17145
1/3/2015,4,11577,912,3198,1128,0,3,16818
1/3/2015,5,11578,913,2965,1410,0,3,16869
1/3/2015,6,11579,930,3110,1423,0,3,17045
1/3/2015,7,11584,953,3537,1400,0,3,17477
1/3/2015,8,11580,952,4438,1139,0,3,18112
1/3/2015,9,11568,922,4698,1130,0,3,18321
1/3/2015,10,11561,937,5118,1247,0,3,18866
1/3/2015,11,11547,1086,5774,1174,0,3,19584
1/3/2015,12,11550,1539,5821,1065,0,3,19978
1/3/2015,13,11549,1905,5797,1113,0,3,20367
1/3/2015,14,11553,2113,4940,1361,0,3,19970
1/3/2015,15,11517,2103,4912,1403,0,3,19938
1/3/2015,16,11551,2195,4937,1368,0,3,20054
1/3/2015,17,11560,2246,5292,1105,0,3,20206
1/3/2015,18,11546,2863,5891,881,0,3,21184
1/3/2015,19,11555,2731,5898,607,0,2,20793
1/3/2015,20,11552,2102,5785,401,0,3,19843
1/3/2015,21,11553,1952,5765,344,0,3,19617
1/3/2015,22,11549,1691,5369,346,0,3,18958
1/3/2015,23,11547,1172,5023,314,0,3,18059
1/3/2015,24,11561,952,4752,264,0,3,17532
1/4/2015,1,11558,950,4541,364,0,3,17416
1/4/2015,2,11564,950,4016,441,0,3,16974
1/4/2015,3,11569,952,3778,348,0,3,16650
1/4/2015,4,11572,948,3458,283,0,3,16264
1/4/2015,5,11567,947,3403,273,0,2,16192
1/4/2015,6,11568,946,3352,267,0,6,16139
1/4/2015,7,11576,945,3933,172,0,7,16633
1/4/2015,8,11575,948,4612,118,0,10,17263
1/4/2015,9,11575,947,4888,274,0,2,17686
1/4/2015,10,11577,950,4786,861,0,2,18176
1/4/2015,11,11577,948,4521,1644,0,2,18692
1/4/2015,12,11576,945,4564,2038,0,2,19125
1/4/2015,13,11578,949,4661,2165,0,2,19355
1/4/2015,14,11576,962,4596,2365,0,2,19501
1/4/2015,15,11570,1074,4785,2062,0,2,19493
1/4/2015,16,11572,1168,4671,2153,0,2,19566
1/4/2015,17,11573,1376,5057,2132,0,3,20141
1/4/2015,18,11565,1372,5508,2352,0,2,20799
1/4/2015,19,11567,1367,5254,2539,0,2,20729
1/4/2015,20,11562,1374,5210,2613,0,2,20761
1/4/2015,21,11560,1369,4747,2717,0,2,20395
1/4/2015,22,11093,1374,4910,2738,0,3,20118
1/4/2015,23,11039,1075,4236,2727,0,14,19091
1/4/2015,24,11047,968,3617,2668,0,17,18317
1/5/2015,1,11053,968,3402,1893,0,18,17334
1/5/2015,2,10830,976,3330,1911,0,18,17065
1/5/2015,3,10758,990,3232,1955,0,17,16952
1/5/2015,4,10758,1126,3290,1894,0,18,17086
1/5/2015,5,10830,1263,3359,2156,0,19,17627
1/5/2015,6,11203,1417,3480,2164,0,24,18288
1/5/2015,7,11251,1434,4149,2402,0,29,19265
1/5/2015,8,11253,1480,5077,2589,0,36,20435
1/5/2015,9,11246,1541,5330,2591,0,37,20745
1/5/2015,10,11236,1583,5339,2510,0,38,20706
1/5/2015,11,11257,1648,5401,2427,0,39,20772
1/5/2015,12,11578,1605,5121,2467,0,38,20809
1/5/2015,13,11699,1878,4949,2425,0,37,20988
1/5/2015,14,11699,2194,4839,2341,0,38,21111
1/5/2015,15,11701,2796,4439,2261,0,38,21235
1/5/2015,16,11698,2968,4406,2288,0,36,21396
1/5/2015,17,11696,3021,5005,2238,0,35,21995
1/5/2015,18,11694,3292,5975,1886,0,35,22882
1/5/2015,19,11697,3494,6063,1648,0,36,22938
1/5/2015,20,11700,3625,6157,1422,0,36,22940
1/5/2015,21,11700,3928,6003,1384,0,37,23052
1/5/2015,22,11697,3590,5579,1434,0,36,22336
1/5/2015,23,11696,2405,5501,1144,0,35,20781
1/5/2015,24,11699,1785,4897,981,0,23,19385
1/6/2015,1,11697,1623,4314,996,0,20,18650
1/6/2015,2,11708,1521,3428,1198,0,21,17876
1/6/2015,3,11733,1504,3908,824,0,21,17990
1/6/2015,4,11836,1722,4132,523,0,17,18230
1/6/2015,5,11820,2156,4552,437,0,20,18985
1/6/2015,6,11840,2283,4418,375,0,42,18958
1/6/2015,7,11839,2779,5110,337,0,87,20152
1/6/2015,8,11839,3314,5489,413,0,167,21222
1/6/2015,9,11844,3360,5630,555,0,193,21582
1/6/2015,10,11835,3638,5111,708,0,208,21500
1/6/2015,11,11833,3471,4909,822,0,205,21240
1/6/2015,12,11835,3568,4770,978,0,209,21360
1/6/2015,13,11839,3232,4520,1259,0,210,21060
1/6/2015,14,11831,3445,4329,1502,0,225,21332
1/6/2015,15,11822,3777,4257,1769,0,231,21856
1/6/2015,16,11838,3748,4779,1894,0,225,22484
1/6/2015,17,11837,3632,5341,2033,0,225,23068
1/6/2015,18,11841,3596,5651,2238,0,199,23525
1/6/2015,19,11843,3688,5832,2342,0,151,23856
1/6/2015,20,11844,3596,5777,2504,0,103,23824
1/6/2015,21,11840,3220,5479,2614,0,88,23241
1/6/2015,22,11839,2785,5523,2551,0,86,22784
1/6/2015,23,11844,1923,5003,2529,0,88,21387
1/6/2015,24,11844,1624,3874,2576,0,32,19950
1/7/2015,1,11851,1576,3279,2501,0,19,19226
1/7/2015,2,11849,1562,3328,2351,0,19,19109
1/7/2015,3,11858,1452,3341,2184,0,19,18854
1/7/2015,4,11837,1442,3160,2362,0,20,18821
1/7/2015,5,11844,1664,3183,2319,0,20,19030
1/7/2015,6,11838,1911,3447,1996,0,21,19213
1/7/2015,7,11843,2338,4049,2377,0,29,20636
1/7/2015,8,11846,2865,5458,2223,0,53,22445
1/7/2015,9,11831,3099,5717,2250,0,87,22984
1/7/2015,10,11822,3077,5461,2298,0,90,22748
1/7/2015,11,11825,3053,5321,2317,0,95,22611
1/7/2015,12,11846,3064,5208,2296,0,93,22507
1/7/2015,13,11846,3056,5034,2373,0,385,22694
1/7/2015,14,11847,3073,4642,2416,0,395,22373
1/7/2015,15,11789,3104,4863,2475,0,101,22332
1/7/2015,16,11784,3308,4994,2472,0,94,22652
1/7/2015,17,11780,3704,5654,2298,0,89,23525
1/7/2015,18,11783,5463,6033,1907,0,118,25304
1/7/2015,19,11785,5141,5923,1833,0,109,24791
1/7/2015,20,11781,4888,5994,1918,0,89,24670
1/7/2015,21,11779,4875,5708,2071,0,114,24547
1/7/2015,22,11778,4471,5508,2198,0,84,24039
1/7/2015,23,11822,4105,4886,2184,0,83,23080
1/7/2015,24,11833,2986,4220,2067,0,41,21147
1/8/2015,1,11837,1846,3845,2093,0,21,19642
1/8/2015,2,11837,1459,3659,2242,0,20,19217
1/8/2015,3,11836,1493,3485,2450,0,20,19284
1/8/2015,4,11842,1722,3564,2450,0,20,19598
1/8/2015,5,11845,2046,3703,2428,0,20,20042
1/8/2015,6,11847,2435,3748,2452,0,39,20521
1/8/2015,7,11842,2932,4623,2519,0,79,21995
1/8/2015,8,11837,3683,5498,2599,0,86,23703
1/8/2015,9,11847,3885,5627,2503,0,113,23975
1/8/2015,10,11850,4048,5505,2562,0,117,24082
1/8/2015,11,11842,4367,5174,2618,0,117,24118
1/8/2015,12,11844,4605,5049,2616,0,175,24289
1/8/2015,13,11844,4284,5040,2629,0,239,24036
1/8/2015,14,11842,3648,5053,2679,0,262,23484
1/8/2015,15,11846,3122,5055,2678,0,262,22963
1/8/2015,16,11838,3343,5374,2627,0,260,23442
1/8/2015,17,11839,3719,5490,2589,0,211,23848
1/8/2015,18,11847,3781,5536,2631,0,184,23979
1/8/2015,19,11846,3832,5801,2692,0,164,24335
1/8/2015,20,11848,4060,5678,2697,0,168,24451
1/8/2015,21,11843,4192,5680,2639,0,155,24509
1/8/2015,22,11840,3682,5251,2596,0,145,23514
1/8/2015,23,11836,2444,4558,2591,0,87,21516
1/8/2015,24,11826,1243,3443,2571,0,39,19122
1/9/2015,1,11841,1028,3591,2533,0,21,19014
1/9/2015,2,11838,980,3767,2512,0,19,19116
1/9/2015,3,11838,989,3772,2486,0,19,19104
1/9/2015,4,11841,1131,3401,2578,0,20,18971
1/9/2015,5,11836,1379,3281,2556,0,22,19074
1/9/2015,6,11848,1721,3355,2578,0,46,19548
1/9/2015,7,11841,2019,3962,2449,0,63,20334
1/9/2015,8,11859,2428,5371,2428,0,97,22183
1/9/2015,9,11855,2437,5499,2451,0,110,22352
1/9/2015,10,11853,2429,5120,2465,0,112,21979
1/9/2015,11,11863,2572,4694,2468,0,111,21708
1/9/2015,12,11830,2523,4786,2455,0,113,21707
1/9/2015,13,11833,2309,5012,2368,0,112,21634
1/9/2015,14,11869,2235,5109,2335,0,111,21659
1/9/2015,15,11883,2402,4944,2277,0,106,21612
1/9/2015,16,11885,2123,4988,2361,0,97,21454
1/9/2015,17,11889,2387,5082,2478,0,96,21932
1/9/2015,18,11932,2782,5812,2484,0,111,23121
1/9/2015,19,11910,2893,5969,2455,0,110,23337
1/9/2015,20,11890,2773,5879,2441,0,108,23091
1/9/2015,21,11893,2877,5292,2499,0,132,22693
1/9/2015,22,11949,2535,4842,2581,0,83,21990
1/9/2015,23,11951,1921,4326,2572,0,81,20851
1/9/2015,24,11950,1253,4190,2296,0,29,19718
1/10/2015,1,11950,1135,4198,1775,0,2,19060
1/10/2015,2,11884,950,4255,1870,0,2,18961
1/10/2015,3,11657,946,4212,1917,0,2,18734
1/10/2015,4,11619,948,4190,2103,0,2,18862
1/10/2015,5,11604,946,4137,2186,0,2,18875
1/10/2015,6,11618,947,4322,2077,0,2,18966
1/10/2015,7,11842,958,4382,2182,0,2,19366
1/10/2015,8,11916,969,4627,2315,0,2,19829
1/10/2015,9,11912,982,4689,2383,0,2,19968
1/10/2015,10,11910,972,4635,2364,0,2,19883
1/10/2015,11,11904,965,4885,2259,0,3,20016
1/10/2015,12,11910,1052,4747,2259,0,3,19971
1/10/2015,13,11867,1104,4792,2373,0,2,20138
1/10/2015,14,11813,1202,4711,2473,0,2,20201
1/10/2015,15,11792,1256,4813,2489,0,3,20353
1/10/2015,16,11790,1381,4657,2581,0,3,20412
1/10/2015,17,11766,1459,5194,2606,0,3,21028
1/10/2015,18,11749,1849,5901,2528,0,2,22029
1/10/2015,19,11750,1788,5800,2410,0,3,21751
1/10/2015,20,11756,1762,5429,2421,0,3,21371
1/10/2015,21,11748,1755,5060,2471,0,2,21036
1/10/2015,22,11739,1469,4873,2442,0,2,20525
1/10/2015,23,11747,1302,4837,2290,0,2,20178
1/10/2015,24,11732,1297,4129,2021,0,2,19181
1/11/2015,1,11748,1009,4104,1712,0,2,18575
1/11/2015,2,11708,936,4118,1377,0,2,18141
1/11/2015,3,11265,993,4428,1252,0,2,17940
1/11/2015,4,11274,976,4017,991,0,2,17260
1/11/2015,5,11276,907,3946,1087,0,2,17218
1/11/2015,6,11287,942,3933,899,0,2,17063
1/11/2015,7,11283,978,4120,1386,0,3,17770
1/11/2015,8,11283,1118,4272,1561,0,3,18237
1/11/2015,9,11287,1243,4734,1565,0,3,18832
1/11/2015,10,11281,1763,4880,1473,0,3,19400
1/11/2015,11,11291,1949,5014,1389,0,2,19645
1/11/2015,12,11296,2059,4915,1357,0,3,19630
1/11/2015,13,11305,2151,4648,1392,0,3,19499
1/11/2015,14,11264,2332,4733,1191,0,3,19523
1/11/2015,15,11302,2585,4883,1075,0,3,19848
1/11/2015,16,11308,2866,4753,1116,0,3,20046
1/11/2015,17,11304,2898,4968,1240,0,3,20413
1/11/2015,18,11303,3270,5532,1123,0,3,21231
1/11/2015,19,11305,2976,5609,1224,0,3,21117
1/11/2015,20,11304,2790,5571,1552,0,3,21220
1/11/2015,21,11300,2567,5448,1403,0,3,20721
1/11/2015,22,11300,2502,4983,1384,0,2,20171
1/11/2015,23,11294,1638,4576,1250,0,3,18761
1/11/2015,24,11295,1262,4332,1063,0,3,17955
1/12/2015,1,11287,1084,4154,1040,0,5,17570
1/12/2015,2,11291,996,4348,839,0,11,17485
1/12/2015,3,11015,997,4385,729,0,8,17134
1/12/2015,4,10972,1132,4198,527,0,18,16847
1/12/2015,5,10979,1567,4179,469,0,18,17212
1/12/2015,6,10981,2090,4145,439,0,21,17676
1/12/2015,7,10971,2633,5008,394,0,30,19036
1/12/2015,8,10959,3585,5145,369,0,36,20094
1/12/2015,9,10960,3644,5061,370,0,40,20075
1/12/2015,10,10959,3825,5196,494,0,41,20515
1/12/2015,11,10959,4164,5051,509,0,43,20726
1/12/2015,12,10969,4582,5058,601,0,72,21282
1/12/2015,13,10966,4478,4962,748,0,52,21206
1/12/2015,14,10966,4002,4893,1287,0,63,21211
1/12/2015,15,10952,3802,4844,1569,0,68,21235
1/12/2015,16,10955,4122,4800,1603,0,69,21549
1/12/2015,17,10957,3695,5052,1662,0,60,21426
1/12/2015,18,10952,3896,5882,1637,0,88,22455
1/12/2015,19,10959,3876,5951,1730,0,86,22602
1/12/2015,20,10962,3742,5927,1903,0,85,22619
1/12/2015,21,10952,4022,5292,2009,0,51,22326
1/12/2015,22,10944,4071,4823,1944,0,36,21818
1/12/2015,23,10929,3841,4276,1736,0,36,20818
1/12/2015,24,10952,3113,3881,1591,0,24,19561
1/13/2015,1,10957,2856,3833,1433,0,18,19097
1/13/2015,2,10967,2763,3649,1325,0,13,18717
1/13/2015,3,10964,2702,3352,1256,0,21,18295
1/13/2015,4,10961,3006,3477,1203,0,20,18667
1/13/2015,5,10968,3311,3839,1023,0,21,19162
1/13/2015,6,10974,3103,4265,978,0,26,19346
1/13/2015,7,11049,3651,4770,1029,0,32,20531
1/13/2015,8,11070,4223,5674,937,0,37,21941
1/13/2015,9,11069,4425,5642,894,0,72,22102
1/13/2015,10,11067,4652,5475,702,0,88,21984
1/13/2015,11,11064,4576,5224,409,0,107,21380
1/13/2015,12,11017,4938,5000,234,0,89,21278
1/13/2015,13,11068,4627,4886,193,0,77,20851
1/13/2015,14,11058,4779,4858,219,0,81,20995
1/13/2015,15,10909,4859,4694,240,0,112,20814
1/13/2015,16,11020,4723,4743,258,0,113,20857
1/13/2015,17,11066,4526,5329,332,0,120,21373
1/13/2015,18,11061,4641,5710,433,0,112,21957
1/13/2015,19,11058,4539,5697,624,0,86,22004
1/13/2015,20,11062,4660,5630,737,0,38,22127
1/13/2015,21,11062,4498,5502,755,0,36,21853
1/13/2015,22,11066,4234,5230,789,0,35,21354
1/13/2015,23,11055,4250,4788,923,0,34,21050
1/13/2015,24,11056,3783,4623,946,0,24,20432
1/14/2015,1,11061,3697,3918,824,0,20,19520
1/14/2015,2,11056,3743,3657,677,0,20,19153
1/14/2015,3,11056,4124,3436,580,0,20,19216
1/14/2015,4,11052,4299,3425,517,0,19,19312
1/14/2015,5,11053,4455,3284,388,0,19,19199
1/14/2015,6,11056,4628,3743,288,0,22,19737
1/14/2015,7,11055,4682,5012,145,0,28,20922
1/14/2015,8,11057,5301,5365,98,0,36,21857
1/14/2015,9,10816,5427,5325,94,0,36,21698
1/14/2015,10,10592,5355,5172,88,0,58,21265
1/14/2015,11,10596,5085,4960,125,0,96,20862
1/14/2015,12,10651,4661,4878,112,0,159,20461
1/14/2015,13,10990,4462,4772,87,0,178,20489
1/14/2015,14,10901,5065,4628,91,0,180,20865
1/14/2015,15,10925,4960,4513,42,0,180,20620
1/14/2015,16,11049,4713,4669,45,0,170,20646
1/14/2015,17,11051,4488,5087,70,0,114,20810
1/14/2015,18,11051,4512,5241,160,0,89,21053
1/14/2015,19,11047,4702,5291,344,0,40,21424
1/14/2015,20,11060,4732,5417,532,0,41,21782
1/14/2015,21,11055,5147,5408,629,0,34,22273
1/14/2015,22,11045,5330,4871,629,0,34,21909
1/14/2015,23,11042,5128,4245,569,0,34,21018
1/14/2015,24,11051,4375,3601,499,0,22,19548
1/15/2015,1,11055,3465,3711,519,0,20,18770
1/15/2015,2,11051,3216,3661,548,0,20,18496
1/15/2015,3,11055,2979,3450,472,0,20,17976
1/15/2015,4,11051,3049,3340,484,0,21,17945
1/15/2015,5,11050,2995,3264,573,0,20,17902
1/15/2015,6,11051,3568,3704,685,0,23,19031
1/15/2015,7,11048,4207,4737,807,0,31,20830
1/15/2015,8,11044,4353,5256,1040,0,38,21731
1/15/2015,9,11054,4133,5360,1234,0,59,21840
1/15/2015,10,11054,4103,5386,1276,0,113,21932
1/15/2015,11,11055,4453,5100,1350,0,167,22125
1/15/2015,12,11052,4745,4686,1528,0,191,22202
1/15/2015,13,11049,4943,4181,1714,0,188,22075
1/15/2015,14,11053,4384,4071,2023,0,192,21723
1/15/2015,15,11051,3981,3838,2245,0,185,21300
1/15/2015,16,11042,3809,3933,2452,0,178,21414
1/15/2015,17,11038,3668,4538,2557,0,181,21982
1/15/2015,18,11034,3924,5472,2549,0,180,23159
1/15/2015,19,11034,3805,5588,2602,0,179,23208
1/15/2015,20,11039,3832,5529,2613,0,87,23100
1/15/2015,21,11039,3742,5456,2618,0,57,22912
1/15/2015,22,11040,3497,4890,2643,0,37,22107
1/15/2015,23,11050,2982,3954,2515,0,35,20536
1/15/2015,24,11054,1898,3272,2247,0,25,18496
1/16/2015,1,11057,1245,3300,2244,0,21,17867
1/16/2015,2,11052,1036,3345,2135,0,20,17588
1/16/2015,3,11049,1043,3317,2143,0,20,17572
1/16/2015,4,11047,1046,3198,2105,0,19,17415
1/16/2015,5,11049,1458,3199,1975,0,20,17701
1/16/2015,6,11034,2016,3298,1543,0,23,17914
1/16/2015,7,11035,2446,4006,1864,0,32,19383
1/16/2015,8,11034,2904,5108,1821,0,36,20903
1/16/2015,9,11027,3345,5399,1471,0,35,21277
1/16/2015,10,11031,3010,5439,1442,0,35,20957
1/16/2015,11,11052,2886,4724,1291,0,36,19989
1/16/2015,12,11092,2860,4503,1229,0,36,19720
1/16/2015,13,11084,3074,4122,1201,0,38,19519
1/16/2015,14,11100,3211,3959,1093,0,37,19400
1/16/2015,15,11119,3095,4235,924,0,37,19410
1/16/2015,16,11126,2905,4603,752,0,37,19423
1/16/2015,17,11134,3240,4636,593,0,36,19639
1/16/2015,18,11237,3943,5734,478,0,36,21428
1/16/2015,19,11283,4645,5704,400,0,35,22067
1/16/2015,20,11285,4667,5715,326,0,34,22027
1/16/2015,21,11281,4421,5445,348,0,35,21530
1/16/2015,22,11271,3809,5077,404,0,36,20597
1/16/2015,23,11267,3437,4331,491,0,35,19561
1/16/2015,24,11273,2210,3665,650,0,10,17808
1/17/2015,1,11287,1655,3740,801,0,3,17486
1/17/2015,2,11291,1344,3870,1009,0,3,17517
1/17/2015,3,11299,1403,3893,1155,0,3,17753
1/17/2015,4,11310,1223,3610,1409,0,3,17555
1/17/2015,5,11306,1387,3511,1600,0,3,17807
1/17/2015,6,11304,1563,3238,1730,0,3,17838
1/17/2015,7,11303,1813,3631,1868,0,3,18618
1/17/2015,8,11300,1880,4011,2011,0,3,19205
1/17/2015,9,11296,2163,4264,2084,0,3,19810
1/17/2015,10,11298,2327,4723,2018,0,3,20369
1/17/2015,11,11344,2398,4941,1901,0,3,20587
1/17/2015,12,11453,2399,4925,1963,0,3,20743
1/17/2015,13,11476,2129,4635,1960,0,3,20203
1/17/2015,14,11487,1895,4456,2030,0,3,19871
1/17/2015,15,11484,1596,4275,2087,0,3,19445
1/17/2015,16,11479,1525,4226,2149,0,3,19382
1/17/2015,17,11479,1575,4507,2297,0,3,19861
1/17/2015,18,11492,1781,5029,2470,0,3,20775
1/17/2015,19,11600,1813,5126,2420,0,3,20962
1/17/2015,20,11645,1744,4827,2345,0,2,20563
1/17/2015,21,11643,1748,4236,2419,0,2,20048
1/17/2015,22,11640,1262,4077,2402,0,2,19383
1/17/2015,23,11635,1134,3938,2383,0,2,19092
1/17/2015,24,11643,1017,3652,2403,0,2,18717
1/18/2015,1,11644,915,3338,2099,0,2,17998
1/18/2015,2,11496,916,3326,1782,0,2,17522
1/18/2015,3,11347,915,3278,1583,0,2,17125
1/18/2015,4,11021,914,3250,1526,0,2,16713
1/18/2015,5,10875,922,3318,1470,0,2,16587
1/18/2015,6,10879,921,3444,1575,0,2,16821
1/18/2015,7,10970,904,3529,1650,0,2,17055
1/18/2015,8,11172,938,3700,1927,0,2,17739
1/18/2015,9,11258,948,3898,1940,0,2,18046
1/18/2015,10,11647,979,4021,1898,0,2,18547
1/18/2015,11,11713,1051,3890,1902,0,3,18559
1/18/2015,12,11717,1180,4237,1846,0,2,18982
1/18/2015,13,11717,1231,4351,1777,0,2,19078
1/18/2015,14,11757,1256,4680,1770,0,3,19466
1/18/2015,15,11731,1448,4579,1624,0,3,19385
1/18/2015,16,11772,1839,4622,1464,0,3,19700
1/18/2015,17,11770,1891,4854,1195,0,4,19714
1/18/2015,18,11767,2001,5417,975,0,3,20163
1/18/2015,19,11769,2135,5573,924,0,3,20404
1/18/2015,20,11771,2278,5562,1047,0,3,20661
1/18/2015,21,11768,1697,5554,1023,0,2,20044
1/18/2015,22,11757,1647,5071,1017,0,2,19494
1/18/2015,23,11753,1159,4476,1024,0,2,18414
1/18/2015,24,11755,982,4081,1093,0,5,17916
1/19/2015,1,11754,959,3288,1005,0,18,17024
1/19/2015,2,11765,960,3453,1023,0,21,17222
1/19/2015,3,11769,1054,3353,907,0,20,17103
1/19/2015,4,11777,1128,3558,778,0,20,17261
1/19/2015,5,11780,1335,3584,668,0,21,17388
1/19/2015,6,11776,1848,3437,642,0,23,17726
1/19/2015,7,11769,2029,4332,535,0,36,18701
1/19/2015,8,11770,2232,5498,596,0,29,20125
1/19/2015,9,11767,2287,5810,637,0,46,20547
1/19/2015,10,11769,2442,5858,604,0,43,20716
1/19/2015,11,11768,2844,5785,496,0,46,20939
1/19/2015,12,11772,2874,5563,428,0,45,20682
1/19/2015,13,11777,2639,5292,492,0,48,20248
1/19/2015,14,11777,2312,5240,639,0,46,20014
1/19/2015,15,11773,2268,5251,586,0,47,19925
1/19/2015,16,11777,2390,5089,490,0,48,19794
1/19/2015,17,11775,2706,5177,369,0,44,20071
1/19/2015,18,11771,2897,5629,345,0,47,20689
1/19/2015,19,11775,2953,5630,306,0,44,20708
1/19/2015,20,11773,2860,5554,247,0,36,20470
1/19/2015,21,11770,2732,5431,214,0,35,20182
1/19/2015,22,11753,2179,5366,259,0,35,19592
1/19/2015,23,11762,1286,4967,241,0,34,18290
1/19/2015,24,11759,1035,4840,176,0,23,17833
1/20/2015,1,11757,984,4889,142,0,19,17791
1/20/2015,2,11768,973,4608,104,0,19,17472
1/20/2015,3,11771,973,4566,85,0,19,17414
1/20/2015,4,11763,980,4522,93,0,21,17379
1/20/2015,5,11768,1067,4533,104,0,23,17495
1/20/2015,6,11767,1476,4697,122,0,24,18086
1/20/2015,7,11763,2414,5071,149,0,39,19436
1/20/2015,8,11764,3122,5654,202,0,42,20784
1/20/2015,9,11768,3066,5641,241,0,37,20753
1/20/2015,10,11767,2634,5703,239,0,37,20380
1/20/2015,11,11769,2815,5370,153,0,36,20143
1/20/2015,12,11767,3008,5152,121,0,36,20084
1/20/2015,13,11769,3241,5004,106,0,36,20156
1/20/2015,14,11771,3126,4912,87,0,37,19933
1/20/2015,15,11772,3003,4978,85,0,37,19875
1/20/2015,16,11765,3131,5010,40,0,37,19983
1/20/2015,17,11768,3605,5049,53,0,38,20513
1/20/2015,18,11768,3738,5935,88,0,35,21564
1/20/2015,19,11764,3938,5998,118,0,39,21857
1/20/2015,20,11761,3896,6089,109,0,39,21894
1/20/2015,21,11759,3569,5767,147,0,35,21277
1/20/2015,22,11772,3529,5467,157,0,35,20960
1/20/2015,23,11771,2880,4901,180,0,35,19767
1/20/2015,24,11769,1770,4557,221,0,29,18346
1/21/2015,1,11773,1525,4433,244,0,25,18000
1/21/2015,2,11775,1373,4274,292,0,25,17739
1/21/2015,3,11764,1307,4039,371,0,22,17503
1/21/2015,4,11768,1596,4063,309,0,22,17758
1/21/2015,5,11769,2139,3868,296,0,24,18096
1/21/2015,6,11770,2656,3951,400,0,24,18801
1/21/2015,7,11769,3127,4610,516,0,32,20054
1/21/2015,8,11768,3595,5818,565,0,39,21785
1/21/2015,9,11764,3569,5930,684,0,46,21993
1/21/2015,10,11766,3393,5737,551,0,42,21489
1/21/2015,11,11769,3323,5621,430,0,38,21181
1/21/2015,12,11770,3264,5305,303,0,40,20682
1/21/2015,13,11767,3493,5161,195,0,45,20661
1/21/2015,14,11642,3803,5201,170,0,43,20859
1/21/2015,15,11751,4049,4937,131,0,46,20914
1/21/2015,16,11778,4073,4955,109,0,49,20964
1/21/2015,17,11784,4061,5484,115,0,45,21489
1/21/2015,18,11776,4458,5963,135,0,40,22372
1/21/2015,19,11773,4515,6070,161,0,42,22561
1/21/2015,20,11774,4403,6059,200,0,39,22475
1/21/2015,21,11771,4382,5943,174,0,38,22308
1/21/2015,22,11757,3921,5459,158,0,38,21333
1/21/2015,23,11761,2801,5125,121,0,37,19845
1/21/2015,24,11770,1733,4354,150,0,24,18031
1/22/2015,1,11774,1257,4329,166,0,20,17546
1/22/2015,2,11774,1124,4027,183,0,20,17128
1/22/2015,3,11777,1108,4038,173,0,20,17116
1/22/2015,4,11784,1215,3988,145,0,22,17154
1/22/2015,5,11793,1631,4105,136,0,23,17688
1/22/2015,6,11793,2225,4261,147,0,25,18451
1/22/2015,7,11785,2984,5379,154,0,34,20336
1/22/2015,8,11790,3441,5838,134,0,40,21243
1/22/2015,9,11788,3436,5958,118,0,43,21343
1/22/2015,10,11789,3015,5758,135,0,40,20737
1/22/2015,11,11794,3097,5214,134,0,40,20279
1/22/2015,12,11794,2754,4769,186,0,42,19545
1/22/2015,13,11794,2773,4832,266,0,44,19709
1/22/2015,14,11795,2559,4870,335,0,40,19599
1/22/2015,15,11801,2671,4862,371,0,41,19746
1/22/2015,16,11805,3025,4900,371,0,45,20146
1/22/2015,17,11809,3353,5310,460,0,49,20981
1/22/2015,18,11827,3533,5904,480,0,52,21796
1/22/2015,19,11874,3553,6005,524,0,51,22007
1/22/2015,20,11886,3740,5782,455,0,46,21909
1/22/2015,21,11864,3693,5726,563,0,40,21886
1/22/2015,22,11745,3127,5222,634,0,38,20766
1/22/2015,23,11369,2655,4864,752,0,38,19678
1/22/2015,24,11085,2098,4356,858,0,24,18421
1/23/2015,1,11087,1311,4233,919,0,20,17570
1/23/2015,2,11088,1186,4201,990,0,21,17486
1/23/2015,3,11089,1110,3943,1242,0,20,17404
1/23/2015,4,11085,1134,3900,1273,0,21,17413
1/23/2015,5,11081,1520,3889,1424,0,22,17936
1/23/2015,6,11090,2033,3722,1519,0,23,18387
1/23/2015,7,11100,2673,4681,1353,0,28,19835
1/23/2015,8,11105,2766,5405,1741,0,37,21054
1/23/2015,9,11103,2720,5348,1786,0,41,20998
1/23/2015,10,11100,2711,5297,1722,0,46,20876
1/23/2015,11,11100,2713,5111,1806,0,45,20775
1/23/2015,12,11106,2710,5108,1689,0,43,20656
1/23/2015,13,11096,2390,4629,1759,0,48,19922
1/23/2015,14,11095,2348,4750,2021,0,48,20262
1/23/2015,15,11092,2334,4607,1969,0,50,20052
1/23/2015,16,11101,2296,4525,1957,0,52,19931
1/23/2015,17,11100,2676,4819,1727,0,51,20373
1/23/2015,18,11100,2786,5624,1917,0,48,21475
1/23/2015,19,11097,2803,6044,1646,0,37,21627
1/23/2015,20,11100,2847,5966,1579,0,34,21526
1/23/2015,21,11099,2748,5637,1628,0,34,21146
1/23/2015,22,11088,2217,5416,1630,0,34,20385
1/23/2015,23,11093,1784,4994,1465,0,34,19370
1/23/2015,24,10703,1465,4857,1271,0,9,18305
1/24/2015,1,10208,1374,5024,1057,0,2,17665
1/24/2015,2,10209,1206,4174,839,0,2,16430
1/24/2015,3,10212,1128,4123,786,0,2,16251
1/24/2015,4,10220,1077,3815,659,0,2,15773
1/24/2015,5,10226,1305,3925,554,0,2,16012
1/24/2015,6,10232,1460,3557,503,0,1,15753
1/24/2015,7,10238,1565,4234,518,0,0,16555
1/24/2015,8,10236,1485,4762,529,0,0,17012
1/24/2015,9,10233,1579,5450,602,0,0,17864
1/24/2015,10,10235,1830,5506,733,0,0,18304
1/24/2015,11,10236,2149,5378,795,0,0,18558
1/24/2015,12,10236,2365,5022,850,0,0,18473
1/24/2015,13,10233,2657,5084,816,0,10,18800
1/24/2015,14,10193,2645,4687,937,0,16,18478
1/24/2015,15,10237,3034,4585,937,0,25,18818
1/24/2015,16,10219,3347,4662,930,0,22,19180
1/24/2015,17,10229,3685,4848,908,0,21,19691
1/24/2015,18,10214,3766,5360,930,0,18,20288
1/24/2015,19,10214,3722,5536,1129,0,0,20601
1/24/2015,20,10225,3255,5318,1335,0,0,20133
1/24/2015,21,10227,2754,4991,1546,0,1,19519
1/24/2015,22,10225,2376,4779,1681,0,2,19063
1/24/2015,23,10223,1761,4406,1591,0,2,17983
1/24/2015,24,10221,1660,4136,1431,0,2,17450
1/25/2015,1,10225,1063,4018,1292,0,2,16600
1/25/2015,2,10223,947,4145,1004,0,2,16321
1/25/2015,3,10222,969,3963,936,0,2,16092
1/25/2015,4,10417,888,3847,1069,0,2,16223
1/25/2015,5,10574,887,3685,1188,0,2,16336
1/25/2015,6,10630,891,3636,1136,0,2,16295
1/25/2015,7,10591,930,3854,1197,0,2,16574
1/25/2015,8,10591,1066,4370,1160,0,2,17189
1/25/2015,9,10634,1105,4382,1122,0,2,17245
1/25/2015,10,10789,1371,4292,1046,0,2,17500
1/25/2015,11,10790,1671,3930,994,0,2,17387
1/25/2015,12,10792,2087,3993,792,0,3,17667
1/25/2015,13,10791,2498,4273,593,0,3,18158
1/25/2015,14,10785,2670,4194,564,0,3,18216
1/25/2015,15,10789,2697,4171,589,0,3,18249
1/25/2015,16,10792,2883,4787,596,0,5,19063
1/25/2015,17,10795,3197,4796,706,0,3,19497
1/25/2015,18,10789,3958,5464,832,0,3,21046
1/25/2015,19,10782,4006,5613,1068,0,3,21472
1/25/2015,20,10787,3714,5481,1179,0,1,21162
1/25/2015,21,10784,3630,5357,1132,0,1,20904
1/25/2015,22,10845,3489,4879,1250,0,1,20464
1/25/2015,23,10849,2665,4484,1257,0,1,19256
1/25/2015,24,10846,1933,4463,1152,0,14,18408
1/26/2015,1,10852,1494,4536,1103,0,19,18004
1/26/2015,2,10852,1379,3947,1130,0,19,17327
1/26/2015,3,10849,1486,3779,1151,0,20,17285
1/26/2015,4,10845,1747,3661,1124,0,20,17397
1/26/2015,5,11201,2118,3609,1042,0,20,17990
1/26/2015,6,11432,2779,3757,928,0,20,18916
1/26/2015,7,11671,3096,4903,1147,0,25,20842
1/26/2015,8,11686,3978,5527,1306,0,34,22531
1/26/2015,9,11683,3953,5554,1346,0,37,22573
1/26/2015,10,11684,3650,5611,1235,0,36,22216
1/26/2015,11,11681,3709,5226,1039,0,35,21690
1/26/2015,12,11678,3715,5239,913,0,36,21581
1/26/2015,13,11681,3780,5185,879,0,37,21562
1/26/2015,14,11682,4120,5105,954,0,36,21897
1/26/2015,15,11691,3940,5041,876,0,37,21585
1/26/2015,16,11695,4068,5081,872,0,37,21753
1/26/2015,17,11698,4395,5158,914,0,38,22203
1/26/2015,18,11717,4485,5542,1026,0,45,22815
1/26/2015,19,11720,4320,5479,1039,0,44,22602
1/26/2015,20,11721,4150,5464,1022,0,49,22406
1/26/2015,21,11722,4325,5600,984,0,38,22669
1/26/2015,22,11713,4164,5099,979,0,35,21990
1/26/2015,23,11707,4004,4675,848,0,38,21272
1/26/2015,24,11708,3159,4357,731,0,32,19987
1/27/2015,1,11724,2570,4039,674,0,23,19030
1/27/2015,2,11724,2108,3986,650,0,22,18490
1/27/2015,3,11722,2003,3935,662,0,21,18343
1/27/2015,4,11720,2078,3901,692,0,21,18412
1/27/2015,5,11731,2108,3751,842,0,23,18455
1/27/2015,6,11750,2450,3839,815,0,24,18878
1/27/2015,7,11753,3173,4999,773,0,30,20728
1/27/2015,8,11756,3930,5745,783,0,41,22255
1/27/2015,9,11756,3974,5798,742,0,39,22309
1/27/2015,10,11765,3684,5433,657,0,38,21577
1/27/2015,11,11764,3505,5183,568,0,38,21058
1/27/2015,12,11757,3373,5157,515,0,38,20840
1/27/2015,13,11757,3323,5183,518,0,38,20819
1/27/2015,14,11757,3354,4836,545,0,37,20529
1/27/2015,15,11756,3242,5064,620,0,40,20722
1/27/2015,16,11753,3403,4922,757,0,42,20877
1/27/2015,17,11751,3949,5318,825,0,40,21883
1/27/2015,18,11758,4238,5764,758,0,45,22563
1/27/2015,19,11757,4729,5780,825,0,44,23135
1/27/2015,20,11765,4436,5715,879,0,39,22834
1/27/2015,21,11758,4172,5670,1034,0,35,22669
1/27/2015,22,11749,3403,5184,1068,0,35,21439
1/27/2015,23,11752,2973,4816,940,0,35,20516
1/27/2015,24,11758,2468,4325,726,0,27,19304
1/28/2015,1,11757,1769,3946,600,0,21,18093
1/28/2015,2,11758,1635,4039,523,0,20,17975
1/28/2015,3,11755,1680,4055,433,0,20,17943
1/28/2015,4,11752,1787,4013,419,0,23,17994
1/28/2015,5,11755,2033,4033,424,0,21,18266
1/28/2015,6,11755,2629,4110,377,0,25,18896
1/28/2015,7,11758,3389,4759,323,0,28,20257
1/28/2015,8,11761,3630,5611,356,0,33,21391
1/28/2015,9,11759,3920,5734,330,0,34,21777
1/28/2015,10,11749,3742,5570,182,0,41,21284
1/28/2015,11,11651,3556,5470,61,0,25,20763
1/28/2015,12,11689,3520,5391,43,0,4,20647
1/28/2015,13,11763,3357,5182,41,0,4,20347
1/28/2015,14,11763,3254,5149,66,0,2,20234
1/28/2015,15,11762,3130,4929,116,0,9,19946
1/28/2015,16,11758,3283,5054,168,0,8,20271
1/28/2015,17,11754,3610,5223,230,0,6,20823
1/28/2015,18,11760,4001,5824,306,0,14,21905
1/28/2015,19,11762,4245,5910,384,0,13,22314
1/28/2015,20,11761,4018,5839,439,0,7,22064
1/28/2015,21,11761,3947,5777,670,0,2,22157
1/28/2015,22,11756,3597,5164,1033,0,2,21552
1/28/2015,23,11746,2832,4368,1423,0,2,20371
1/28/2015,24,11747,1630,3778,1573,0,2,18730
1/29/2015,1,11736,1074,3561,1631,0,2,18004
1/29/2015,2,11751,1044,3726,1613,0,2,18136
1/29/2015,3,11753,1039,3761,1708,0,2,18263
1/29/2015,4,11763,1035,3554,1856,0,2,18210
1/29/2015,5,11767,1044,3417,1950,0,2,18180
1/29/2015,6,11767,1083,3387,1971,0,2,18210
1/29/2015,7,11768,1265,4354,2000,0,4,19391
1/29/2015,8,10907,1508,5386,2106,0,5,19912
1/29/2015,9,10885,1579,5285,2076,0,6,19831
1/29/2015,10,10888,1458,5595,1895,0,7,19843
1/29/2015,11,10893,1591,6031,1627,0,7,20149
1/29/2015,12,10895,1909,6059,1270,0,7,20140
1/29/2015,13,10837,2362,5675,1154,0,6,20034
1/29/2015,14,10856,2655,5239,919,0,6,19675
1/29/2015,15,10889,2587,5026,870,0,4,19376
1/29/2015,16,10896,2681,4974,954,0,4,19509
1/29/2015,17,10896,2936,4875,1353,0,7,20067
1/29/2015,18,10902,3162,5018,1621,0,8,20711
1/29/2015,19,10908,2921,5374,1767,0,5,20975
1/29/2015,20,10908,2743,5535,1974,0,2,21162
1/29/2015,21,10903,2720,5109,2088,0,2,20822
1/29/2015,22,10891,2345,5085,2135,0,2,20458
1/29/2015,23,10901,2193,4441,2242,0,2,19779
1/29/2015,24,10906,1988,3491,2261,0,2,18648
1/30/2015,1,10913,1448,3358,2308,0,2,18029
1/30/2015,2,10913,1233,3349,2273,0,2,17770
1/30/2015,3,10914,1232,3249,2413,0,2,17810
1/30/2015,4,10907,1228,3234,2291,0,2,17662
1/30/2015,5,10899,1229,3354,2456,0,2,17940
1/30/2015,6,10904,1249,3432,2313,0,2,17900
1/30/2015,7,10905,1555,4402,2281,0,4,19147
1/30/2015,8,10907,1954,5049,2225,0,4,20139
1/30/2015,9,10909,2024,5207,2622,0,7,20769
1/30/2015,10,10875,2147,5318,2532,0,3,20875
1/30/2015,11,10604,2329,5339,2391,0,3,20666
1/30/2015,12,10592,2662,5055,2252,0,1,20562
1/30/2015,13,10598,2982,4623,1999,0,1,20203
1/30/2015,14,10823,3225,4297,1976,0,1,20322
1/30/2015,15,10905,3156,4384,1946,0,2,20393
1/30/2015,16,10905,3348,4325,1724,0,3,20305
1/30/2015,17,10903,3671,4593,1381,0,6,20554
1/30/2015,18,10899,3864,5539,1012,0,8,21322
1/30/2015,19,10950,4518,5941,857,0,10,22276
1/30/2015,20,10956,4648,5933,684,0,6,22227
1/30/2015,21,10952,4447,5975,560,0,6,21940
1/30/2015,22,10945,4100,5753,383,0,2,21183
1/30/2015,23,10404,4217,5198,332,0,2,20153
1/30/2015,24,10116,3328,4732,315,0,2,18493
1/31/2015,1,10120,3229,4225,344,0,2,17920
1/31/2015,2,10129,3082,4212,372,0,2,17797
1/31/2015,3,10125,2931,4119,437,0,2,17614
1/31/2015,4,10125,2519,4052,584,0,2,17282
1/31/2015,5,10123,2260,3954,688,0,2,17027
1/31/2015,6,10127,2191,3997,791,0,3,17109
1/31/2015,7,10133,2308,4447,761,0,3,17652
1/31/2015,8,10149,3271,4862,701,0,3,18986
1/31/2015,9,10146,3857,4990,663,0,4,19660
1/31/2015,10,10143,4129,4828,738,0,3,19841
1/31/2015,11,10147,4116,4460,916,0,3,19642
1/31/2015,12,10143,3977,4443,945,0,3,19511
1/31/2015,13,10174,3576,4478,1049,0,2,19279
1/31/2015,14,10232,3423,4567,1186,0,3,19411
1/31/2015,15,10252,3149,4520,1215,0,3,19139
1/31/2015,16,10211,3517,4603,1160,0,3,19494
1/31/2015,17,10247,4120,4671,1180,0,3,20221
1/31/2015,18,10254,4330,5081,1232,0,3,20900
1/31/2015,19,10426,4140,5211,1199,0,2,20978
1/31/2015,20,10499,3884,5366,1065,0,3,20817
1/31/2015,21,10499,3792,5263,933,0,3,20490
1/31/2015,22,10484,3754,4917,942,0,3,20100
1/31/2015,23,10483,3665,4420,825,0,3,19396
1/31/2015,24,10487,2958,4185,693,0,3,18326
2/1/2015,1,10497,2283,3933,526,0,3,17242
2/1/2015,2,10503,2206,3830,531,0,3,17073
2/1/2015,3,10493,1962,3723,722,0,3,16903
2/1/2015,4,10491,1690,3558,781,0,3,16523
2/1/2015,5,10532,1748,3775,651,0,3,16709
2/1/2015,6,10587,2285,3814,556,0,3,17245
2/1/2015,7,10584,2589,3428,516,0,3,17120
2/1/2015,8,10588,2609,3765,772,0,2,17736
2/1/2015,9,10583,2662,4135,892,0,2,18274
2/1/2015,10,10582,3179,4617,901,0,0,19279
2/1/2015,11,10578,3891,4513,956,0,0,19938
2/1/2015,12,10576,4187,4593,1123,0,0,20479
2/1/2015,13,10572,4283,4666,1280,0,0,20801
2/1/2015,14,10573,4319,4325,1566,0,1,20784
2/1/2015,15,10576,4255,4229,1811,0,2,20873
2/1/2015,16,10576,4549,4263,1967,0,2,21357
2/1/2015,17,10574,4684,4492,2126,0,2,21878
2/1/2015,18,10558,4664,5104,2246,0,2,22574
2/1/2015,19,10570,4743,5033,2358,0,1,22705
2/1/2015,20,10582,4685,4905,2423,0,0,22595
2/1/2015,21,10586,4085,4795,2518,0,1,21985
2/1/2015,22,10576,3855,4489,2534,0,1,21455
2/1/2015,23,10591,3190,3942,2559,0,2,20284
2/1/2015,24,10590,2543,3539,2531,0,2,19205
2/2/2015,1,10594,2499,3123,2478,0,12,18706
2/2/2015,2,10599,2217,3112,2495,0,15,18438
2/2/2015,3,10597,2213,3070,2671,0,16,18567
2/2/2015,4,10599,2336,3016,2664,0,17,18632
2/2/2015,5,10597,2380,3104,2524,0,20,18625
2/2/2015,6,10607,2559,3237,2467,0,21,18891
2/2/2015,7,10613,3082,4243,2436,0,28,20402
2/2/2015,8,10612,3843,4840,2347,0,33,21675
2/2/2015,9,10610,4168,4990,2328,0,34,22130
2/2/2015,10,10788,4558,5225,2200,0,34,22805
2/2/2015,11,10837,5003,4982,2076,0,34,22932
2/2/2015,12,10842,4973,4826,1957,0,35,22633
2/2/2015,13,10839,5054,4853,1849,0,36,22631
2/2/2015,14,10842,4963,4804,1789,0,36,22434
2/2/2015,15,10850,4720,4891,1610,0,35,22106
2/2/2015,16,10890,4531,5061,1380,0,39,21901
2/2/2015,17,11197,4982,5253,1194,0,42,22668
2/2/2015,18,11265,5145,5588,939,0,46,22983
2/2/2015,19,11276,5795,5455,889,0,47,23462
2/2/2015,20,11281,5196,5521,956,0,49,23003
2/2/2015,21,11279,5251,5423,1015,0,53,23021
2/2/2015,22,11273,5291,4993,887,0,42,22486
2/2/2015,23,11272,5310,4735,808,0,35,22160
2/2/2015,24,11275,3535,4258,1059,0,29,20156
2/3/2015,1,11279,2578,4094,1386,0,26,19363
2/3/2015,2,11327,2234,4049,1568,0,23,19201
2/3/2015,3,11442,2179,3958,1637,0,22,19238
2/3/2015,4,11452,2182,3748,1675,0,22,19079
2/3/2015,5,11449,2418,3859,1670,0,22,19418
2/3/2015,6,11445,2793,4494,1628,0,23,20383
2/3/2015,7,11446,3606,4856,1651,0,29,21588
2/3/2015,8,11453,4219,5398,1742,0,35,22847
2/3/2015,9,11452,4485,5474,1879,0,35,23325
2/3/2015,10,11456,3734,5269,1931,0,35,22425
2/3/2015,11,11477,3688,4754,1854,0,36,21809
2/3/2015,12,11503,3433,4713,1781,0,36,21466
2/3/2015,13,11512,3379,4440,1699,0,36,21066
2/3/2015,14,11503,3359,4226,1729,0,36,20853
2/3/2015,15,11503,3198,4160,1877,0,36,20774
2/3/2015,16,11547,3123,4358,1774,0,41,20843
2/3/2015,17,11577,3602,5000,1662,0,41,21882
2/3/2015,18,11573,3989,5668,1810,0,42,23082
2/3/2015,19,11575,3826,5340,1948,0,44,22733
2/3/2015,20,11580,3740,5332,2028,0,49,22729
2/3/2015,21,11574,3742,5330,1860,0,44,22550
2/3/2015,22,11567,3423,4942,1677,0,37,21646
2/3/2015,23,11565,2951,4440,1561,0,35,20552
2/3/2015,24,11569,2553,4069,1485,0,26,19702
2/4/2015,1,11572,2029,3508,1496,0,22,18627
2/4/2015,2,11568,1686,3593,1477,0,22,18346
2/4/2015,3,11566,1719,3500,1462,0,22,18269
2/4/2015,4,11570,1845,3194,1345,0,21,17975
2/4/2015,5,11572,2024,3297,1268,0,22,18183
2/4/2015,6,11571,2548,3307,1213,0,25,18664
2/4/2015,7,11576,2947,4247,1079,0,32,19881
2/4/2015,8,11568,3250,5311,1358,0,35,21522
2/4/2015,9,11562,3226,4965,1371,0,35,21159
2/4/2015,10,11592,3226,4639,1238,0,36,20731
2/4/2015,11,11516,3387,4802,1142,0,35,20882
2/4/2015,12,11501,3547,4500,1303,0,36,20887
2/4/2015,13,11596,3572,4563,1105,0,37,20873
2/4/2015,14,11601,3547,4433,1189,0,35,20805
2/4/2015,15,11599,3390,4348,1359,0,35,20731
2/4/2015,16,11607,3362,4459,1276,0,35,20739
2/4/2015,17,11604,3414,4880,1386,0,36,21320
2/4/2015,18,11603,3711,5461,1207,0,36,22018
2/4/2015,19,11607,3978,5422,1195,0,37,22239
2/4/2015,20,11605,3937,5355,1367,0,39,22303
2/4/2015,21,11598,3378,5418,1489,0,35,21918
2/4/2015,22,11584,3306,4505,1790,0,35,21220
2/4/2015,23,11586,2811,3317,1905,0,35,19654
2/4/2015,24,11576,2016,3208,1786,0,24,18610
2/5/2015,1,11585,1752,3204,1762,0,21,18324
2/5/2015,2,11580,1335,3302,1886,0,19,18122
2/5/2015,3,11579,1241,3631,1918,0,19,18388
2/5/2015,4,11580,1305,3778,1757,0,20,18440
2/5/2015,5,11574,1711,3853,1646,0,19,18803
2/5/2015,6,11577,2443,3841,1565,0,22,19448
2/5/2015,7,11586,2907,4750,1440,0,30,20713
2/5/2015,8,11580,3857,5477,1359,0,42,22315
2/5/2015,9,11577,3568,5469,1245,0,42,21901
2/5/2015,10,11569,3467,5459,1089,0,48,21632
2/5/2015,11,11565,3645,5261,701,0,48,21220
2/5/2015,12,11564,4843,4867,353,0,51,21678
2/5/2015,13,11571,4263,4712,292,0,53,20891
2/5/2015,14,11573,3692,4688,325,0,48,20326
2/5/2015,15,11578,3215,4599,335,0,37,19764
2/5/2015,16,11562,3199,4633,370,0,36,19800
2/5/2015,17,11560,3752,4899,504,0,38,20753
2/5/2015,18,11573,4438,5531,846,0,39,22427
2/5/2015,19,11591,4206,5586,1357,0,42,22782
2/5/2015,20,11594,3927,5534,1967,0,38,23060
2/5/2015,21,11589,3905,5438,2180,0,36,23148
2/5/2015,22,11580,3359,4757,2426,0,36,22158
2/5/2015,23,11590,2910,4055,2597,0,36,21188
2/5/2015,24,11595,2071,3833,2619,0,28,20146
2/6/2015,1,11600,1474,3565,2657,0,22,19318
2/6/2015,2,11608,1244,3379,2636,0,20,18887
2/6/2015,3,11602,1242,3541,2607,0,20,19012
2/6/2015,4,11592,1323,3820,2590,0,20,19345
2/6/2015,5,11594,1646,3766,2481,0,22,19509
2/6/2015,6,11579,2381,3822,2481,0,25,20288
2/6/2015,7,11530,2800,4740,2332,0,32,21434
2/6/2015,8,11531,4009,5272,2141,0,38,22991
2/6/2015,9,11521,4164,5473,2013,0,39,23210
2/6/2015,10,11507,4121,5162,1714,0,39,22543
2/6/2015,11,11525,4065,4914,1477,0,38,22019
2/6/2015,12,11585,4121,4643,1398,0,37,21784
2/6/2015,13,11582,3432,4671,1396,0,37,21118
2/6/2015,14,11580,3094,4331,1342,0,37,20384
2/6/2015,15,11586,2765,4486,1371,0,37,20245
2/6/2015,16,11586,2923,4504,1312,0,37,20362
2/6/2015,17,11585,3322,4790,1229,0,37,20963
2/6/2015,18,11587,3744,5093,1303,0,37,21764
2/6/2015,19,11586,4061,5187,1322,0,35,22191
2/6/2015,20,11589,4001,5300,1284,0,34,22208
2/6/2015,21,11584,4280,4996,1263,0,35,22158
2/6/2015,22,11575,3648,4373,1219,0,34,20849
2/6/2015,23,11561,2857,3950,1246,0,34,19648
2/6/2015,24,11563,2333,3418,1271,0,18,18603
2/7/2015,1,11567,1908,3199,1174,0,4,17852
2/7/2015,2,11584,1636,3276,974,0,3,17473
2/7/2015,3,11583,1618,3589,652,0,3,17445
2/7/2015,4,11582,1811,3698,461,0,3,17555
2/7/2015,5,11585,1898,3670,441,0,3,17597
2/7/2015,6,11591,1969,3514,578,0,3,17655
2/7/2015,7,11591,1968,3742,571,0,3,17875
2/7/2015,8,11589,2406,3862,606,0,3,18466
2/7/2015,9,11588,2409,4088,670,0,3,18758
2/7/2015,10,11585,2542,4406,608,0,3,19144
2/7/2015,11,11580,2944,4373,383,0,3,19283
2/7/2015,12,11583,3248,4441,297,0,3,19572
2/7/2015,13,11581,3502,4348,269,0,3,19703
2/7/2015,14,11577,2822,4328,258,0,3,18988
2/7/2015,15,11574,3072,4323,238,0,3,19210
2/7/2015,16,11575,2902,4487,309,0,3,19276
2/7/2015,17,11581,2930,4657,478,0,3,19649
2/7/2015,18,11577,3163,5034,855,0,5,20634
2/7/2015,19,11562,3258,5046,1119,0,4,20989
2/7/2015,20,11566,2662,4970,1043,0,4,20245
2/7/2015,21,11558,2612,4949,936,0,3,20058
2/7/2015,22,11561,2721,4161,1049,0,3,19495
2/7/2015,23,11566,2662,3772,1020,0,3,19023
2/7/2015,24,11562,1717,3821,1005,0,3,18108
2/8/2015,1,11558,1486,3678,1048,0,2,17772
2/8/2015,2,11556,1340,3643,1330,0,2,17871
2/8/2015,3,11561,1276,3287,1558,0,3,17685
2/8/2015,4,11560,1272,3175,1804,0,3,17814
2/8/2015,5,11558,1273,3228,1744,0,3,17806
2/8/2015,6,11563,1296,3252,1603,0,3,17717
2/8/2015,7,11561,1305,3732,1735,0,2,18335
2/8/2015,8,11559,1367,4003,1609,0,3,18541
2/8/2015,9,11560,1552,4294,1416,0,2,18824
2/8/2015,10,11558,1860,4582,1270,0,2,19272
2/8/2015,11,11559,2492,4457,1112,0,2,19622
2/8/2015,12,11558,2755,4431,930,0,2,19676
2/8/2015,13,11558,2769,4289,931,0,2,19549
2/8/2015,14,11556,3004,4365,861,0,2,19788
2/8/2015,15,11549,2798,4415,898,0,2,19662
2/8/2015,16,11512,2665,4686,1082,0,2,19947
2/8/2015,17,11534,2957,4851,1117,0,2,20461
2/8/2015,18,11533,3350,5327,991,0,2,21203
2/8/2015,19,11548,3511,5198,998,0,1,21256
2/8/2015,20,11553,3257,4952,912,0,0,20674
2/8/2015,21,11547,2959,4838,979,0,0,20323
2/8/2015,22,11546,2556,4465,940,0,1,19508
2/8/2015,23,11543,2106,4195,890,0,16,18750
2/8/2015,24,11549,2093,3853,790,0,18,18303
2/9/2015,1,11553,1423,3931,762,0,17,17686
2/9/2015,2,11551,1346,4014,802,0,16,17729
2/9/2015,3,11555,1395,3841,774,0,16,17581
2/9/2015,4,11553,1601,3967,741,0,17,17879
2/9/2015,5,11556,2054,3861,666,0,18,18155
2/9/2015,6,11562,2812,3719,642,0,22,18757
2/9/2015,7,11562,3519,4551,661,0,31,20324
2/9/2015,8,11564,4570,5064,627,0,34,21859
2/9/2015,9,11559,4956,5320,558,0,35,22428
2/9/2015,10,11560,5134,5276,442,0,35,22447
2/9/2015,11,11557,5206,5190,369,0,35,22357
2/9/2015,12,11560,5170,5083,371,0,35,22219
2/9/2015,13,11568,4795,5011,481,0,35,21890
2/9/2015,14,11567,4994,4884,630,0,35,22110
2/9/2015,15,11566,5429,4760,641,0,35,22431
2/9/2015,16,11568,5263,4725,706,0,35,22297
2/9/2015,17,11569,5080,5195,779,0,36,22659
2/9/2015,18,11568,5259,5468,819,0,36,23150
2/9/2015,19,11567,4672,5646,793,0,41,22719
2/9/2015,20,11568,4750,5696,568,0,48,22630
2/9/2015,21,11566,5048,5627,420,0,45,22706
2/9/2015,22,11556,5183,4920,372,0,38,22069
2/9/2015,23,11552,4703,4562,397,0,35,21249
2/9/2015,24,11557,3155,4399,474,0,25,19610
2/10/2015,1,11563,2409,4157,442,0,22,18593
2/10/2015,2,11560,2134,3922,361,0,21,17998
2/10/2015,3,11562,2044,3910,274,0,18,17808
2/10/2015,4,11556,2086,3906,216,0,20,17784
2/10/2015,5,11565,2577,3989,152,0,20,18303
2/10/2015,6,11567,3669,3995,205,0,23,19459
2/10/2015,7,11567,3976,4558,220,0,38,20359
2/10/2015,8,11563,4958,5089,187,0,44,21841
2/10/2015,9,11563,4937,5174,188,0,48,21910
2/10/2015,10,11553,4761,5153,139,0,48,21654
2/10/2015,11,11552,4612,4760,112,0,48,21084
2/10/2015,12,11550,3849,4700,78,0,49,20226
2/10/2015,13,11550,3567,4701,63,0,49,19930
2/10/2015,14,11555,3537,4495,41,0,55,19683
2/10/2015,15,11558,3539,4068,18,0,90,19273
2/10/2015,16,11562,3587,4258,16,0,96,19519
2/10/2015,17,11560,3827,4694,9,0,89,20179
2/10/2015,18,11561,4458,5509,16,0,89,21633
2/10/2015,19,11568,4979,5694,38,0,95,22374
2/10/2015,20,11567,5208,5593,92,0,99,22559
2/10/2015,21,11557,4921,5358,186,0,104,22126
2/10/2015,22,11555,4152,4705,228,0,100,20740
2/10/2015,23,11555,3922,4073,373,0,100,20023
2/10/2015,24,11558,3251,3908,389,0,79,19185
2/11/2015,1,11554,2797,3635,360,0,31,18377
2/11/2015,2,11561,2200,3686,470,0,20,17937
2/11/2015,3,11570,2003,3356,633,0,22,17584
2/11/2015,4,11567,2193,3762,456,0,22,18000
2/11/2015,5,11573,2706,3576,585,0,20,18460
2/11/2015,6,11565,3247,3659,560,0,23,19054
2/11/2015,7,11572,4109,4598,698,0,27,21004
2/11/2015,8,11592,5269,5025,718,0,33,22637
2/11/2015,9,11588,5284,5147,770,0,34,22823
2/11/2015,10,11581,4453,5014,854,0,34,21936
2/11/2015,11,11588,4416,4834,896,0,34,21768
2/11/2015,12,11587,4531,4430,979,0,35,21562
2/11/2015,13,11589,4248,4291,1068,0,35,21231
2/11/2015,14,11589,4545,3954,1125,0,35,21248
2/11/2015,15,11589,4427,3900,1260,0,35,21211
2/11/2015,16,11567,4662,3972,1213,0,35,21449
2/11/2015,17,11530,4671,4502,1236,0,35,21974
2/11/2015,18,11538,5337,5045,1099,0,35,23054
2/11/2015,19,11536,5472,5352,995,0,35,23390
2/11/2015,20,11537,5666,5293,1057,0,35,23588
2/11/2015,21,11540,5003,4978,1424,0,35,22980
2/11/2015,22,11563,4012,4801,1238,0,35,21649
2/11/2015,23,11582,3735,4336,1169,0,35,20857
2/11/2015,24,11595,3002,3767,1250,0,25,19639
2/12/2015,1,11599,1585,3546,1214,0,20,17964
2/12/2015,2,11606,1166,3463,1397,0,21,17653
2/12/2015,3,11604,1124,3307,1582,0,22,17639
2/12/2015,4,11618,1151,3476,1573,0,22,17840
2/12/2015,5,11627,1502,3560,1655,0,22,18366
2/12/2015,6,11601,2192,3320,1711,0,26,18850
2/12/2015,7,11600,2798,4222,1947,0,31,20598
2/12/2015,8,11597,3709,4725,2014,0,34,22079
2/12/2015,9,11592,3655,4886,1961,0,35,22129
2/12/2015,10,11594,3342,4701,1980,0,35,21652
2/12/2015,11,11589,3114,4527,2007,0,36,21273
2/12/2015,12,11582,3450,4555,2064,0,36,21687
2/12/2015,13,11589,2986,4236,2057,0,36,20904
2/12/2015,14,11597,2996,3949,2119,0,36,20697
2/12/2015,15,11603,2974,3805,2172,0,36,20590
2/12/2015,16,11636,2877,4320,2097,0,36,20966
2/12/2015,17,11637,3683,4606,2009,0,43,21978
2/12/2015,18,11640,4217,5180,1863,0,43,22943
2/12/2015,19,11639,4687,5467,1580,0,47,23420
2/12/2015,20,11642,4454,5573,1372,0,47,23088
2/12/2015,21,11638,4867,5314,1202,0,45,23066
2/12/2015,22,11626,4633,4940,1126,0,39,22364
2/12/2015,23,11629,3907,4224,1269,0,36,21065
2/12/2015,24,11622,3462,4018,1348,0,25,20475
2/13/2015,1,11624,3257,3923,1316,0,23,20143
2/13/2015,2,11635,2930,3929,1212,0,23,19729
2/13/2015,3,11641,3008,3717,1019,0,23,19408
2/13/2015,4,11649,3180,3709,827,0,20,19385
2/13/2015,5,11649,3973,3645,618,0,26,19911
2/13/2015,6,11646,3821,3870,601,0,34,19972
2/13/2015,7,11648,4884,4812,546,0,37,21927
2/13/2015,8,11648,5369,5371,463,0,42,22893
2/13/2015,9,11648,5547,5398,347,0,55,22995
2/13/2015,10,11647,5789,5358,193,0,61,23048
2/13/2015,11,11647,5361,5114,131,0,58,22311
2/13/2015,12,11643,5413,4917,209,0,59,22241
2/13/2015,13,11649,5256,4665,500,0,59,22129
2/13/2015,14,11645,4998,4351,876,0,60,21930
2/13/2015,15,11652,4445,4255,1314,0,49,21715
2/13/2015,16,11658,4269,4206,1783,0,41,21957
2/13/2015,17,11662,3873,4463,1977,0,41,22016
2/13/2015,18,11663,4740,4976,1948,0,48,23375
2/13/2015,19,11668,5145,5086,1958,0,51,23908
2/13/2015,20,11663,4840,5122,2031,0,46,23702
2/13/2015,21,11662,4352,5101,2113,0,49,23277
2/13/2015,22,11658,4037,4518,2191,0,43,22447
2/13/2015,23,11642,3670,4297,2272,0,39,21920
2/13/2015,24,11635,2724,4067,2310,0,17,20753
2/14/2015,1,11632,2385,3421,2469,0,6,19913
2/14/2015,2,11621,1743,3500,2410,0,4,19278
2/14/2015,3,11637,1547,3490,2364,0,2,19040
2/14/2015,4,11623,1551,3482,2209,0,2,18867
2/14/2015,5,11599,1645,3707,1973,0,3,18927
2/14/2015,6,11611,1859,3623,1697,0,2,18792
2/14/2015,7,11614,2274,3945,1375,0,2,19210
2/14/2015,8,11618,2936,4273,1219,0,2,20048
2/14/2015,9,11615,3504,4410,1194,0,2,20725
2/14/2015,10,11611,3067,4422,1610,0,2,20712
2/14/2015,11,11622,3045,4341,1719,0,3,20730
2/14/2015,12,11650,3191,4248,1959,0,3,21051
2/14/2015,13,11655,2867,4203,2106,0,3,20834
2/14/2015,14,11658,2744,3902,2176,0,3,20483
2/14/2015,15,11656,2631,3931,2206,0,3,20427
2/14/2015,16,11656,2552,4270,2213,0,3,20694
2/14/2015,17,11653,2216,4385,2184,0,2,20440
2/14/2015,18,11656,2368,5107,2302,0,2,21435
2/14/2015,19,11650,3003,5332,2296,0,2,22283
2/14/2015,20,11644,3218,5312,2247,0,2,22423
2/14/2015,21,11636,3197,5307,2229,0,2,22371
2/14/2015,22,11626,3090,4677,2209,0,2,21604
2/14/2015,23,11634,3011,4232,2154,0,2,21033
2/14/2015,24,11639,2558,3879,2082,0,2,20160
2/15/2015,1,11638,1498,4162,2097,0,2,19397
2/15/2015,2,11637,1324,3930,2132,0,2,19025
2/15/2015,3,11638,1378,3947,2129,0,2,19094
2/15/2015,4,11640,1381,3893,2114,0,2,19030
2/15/2015,5,11641,1758,3763,2019,0,2,19183
2/15/2015,6,11645,2214,3693,1853,0,2,19407
2/15/2015,7,11647,2593,3856,1656,0,2,19754
2/15/2015,8,11643,2791,4158,1511,0,2,20105
2/15/2015,9,11639,3110,4511,1320,0,2,20582
2/15/2015,10,11638,3578,5057,1046,0,2,21321
2/15/2015,11,11620,4019,4522,882,0,2,21045
2/15/2015,12,11641,4007,4433,726,0,2,20809
2/15/2015,13,11640,3873,4335,635,0,2,20485
2/15/2015,14,11640,3584,4170,629,0,2,20025
2/15/2015,15,11638,3188,4171,677,0,2,19676
2/15/2015,16,11601,3993,4205,635,0,3,20437
2/15/2015,17,11643,4348,4524,663,0,4,21182
2/15/2015,18,11641,4862,5067,672,0,4,22246
2/15/2015,19,11639,5513,5197,660,0,9,23018
2/15/2015,20,11636,5105,5248,862,0,6,22857
2/15/2015,21,11634,5050,5063,811,0,2,22560
2/15/2015,22,11632,5186,4794,664,0,3,22279
2/15/2015,23,11630,5123,4133,553,0,3,21442
2/15/2015,24,11630,4939,3650,394,0,2,20615
2/16/2015,1,11631,4961,3477,331,0,2,20402
2/16/2015,2,11632,4981,3461,242,0,2,20318
2/16/2015,3,11634,4924,3305,213,0,3,20079
2/16/2015,4,11628,4982,3327,185,0,3,20125
2/16/2015,5,11628,5154,3170,128,0,3,20083
2/16/2015,6,11605,5414,3363,63,0,2,20447
2/16/2015,7,11627,5565,3867,49,0,2,21110
2/16/2015,8,11636,5624,4067,74,0,2,21403
2/16/2015,9,11634,5663,4217,107,0,2,21623
2/16/2015,10,11633,5401,4275,132,0,3,21444
2/16/2015,11,11494,5252,4386,80,0,3,21215
2/16/2015,12,11448,5253,4312,58,0,3,21074
2/16/2015,13,11453,5266,4356,64,0,3,21142
2/16/2015,14,11450,5127,4208,64,0,3,20852
2/16/2015,15,11447,4835,4201,68,0,4,20555
2/16/2015,16,11448,4921,4222,69,0,4,20664
2/16/2015,17,11448,5756,4533,64,0,4,21805
2/16/2015,18,11440,5671,4733,81,0,9,21934
2/16/2015,19,11445,5445,5077,91,0,13,22071
2/16/2015,20,11446,5358,5008,103,0,14,21929
2/16/2015,21,11442,5760,4848,109,0,7,22166
2/16/2015,22,11443,5869,4450,105,0,5,21872
2/16/2015,23,11446,5966,4018,110,0,4,21544
2/16/2015,24,11448,5571,3492,125,0,3,20639
2/17/2015,1,11452,5021,3601,124,0,3,20201
2/17/2015,2,11454,5177,3412,117,0,23,20183
2/17/2015,3,11446,5289,3232,115,0,26,20108
2/17/2015,4,11454,5383,3200,114,0,25,20176
2/17/2015,5,11447,5571,3376,93,0,24,20511
2/17/2015,6,11449,5465,3757,101,0,23,20795
2/17/2015,7,11449,5662,4426,120,0,24,21681
2/17/2015,8,11460,5879,4740,182,0,35,22296
2/17/2015,9,11452,5837,4803,354,0,52,22498
2/17/2015,10,11456,5707,4764,391,0,72,22390
2/17/2015,11,11456,5704,4345,381,0,88,21974
2/17/2015,12,11453,5596,4136,512,0,85,21782
2/17/2015,13,11454,4688,4150,779,0,84,21155
2/17/2015,14,11453,4412,4090,975,0,86,21016
2/17/2015,15,11453,4462,4156,1158,0,90,21319
2/17/2015,16,11460,4446,4320,1185,0,88,21499
2/17/2015,17,11460,5073,4429,1182,0,84,22228
2/17/2015,18,11456,5233,4943,1344,0,92,23068
2/17/2015,19,11453,5582,5250,1393,0,91,23769
2/17/2015,20,11450,5475,5188,1365,0,58,23536
2/17/2015,21,11441,5330,5144,1393,0,31,23339
2/17/2015,22,11444,5520,4971,1223,0,29,23187
2/17/2015,23,11452,5181,4515,874,0,31,22053
2/17/2015,24,11457,5109,3970,788,0,19,21343
2/18/2015,1,11464,4227,3929,727,0,17,20364
2/18/2015,2,11477,4030,3701,578,0,16,19802
2/18/2015,3,11484,4352,3560,458,0,17,19871
2/18/2015,4,11493,4235,3518,430,0,19,19695
2/18/2015,5,11492,4961,3530,442,0,19,20444
2/18/2015,6,11491,5033,3697,504,0,21,20746
2/18/2015,7,11494,5206,4849,497,0,47,22093
2/18/2015,8,11500,5442,5376,546,0,71,22935
2/18/2015,9,11496,5463,5348,542,0,55,22904
2/18/2015,10,11495,5456,4984,513,0,52,22500
2/18/2015,11,11492,5502,4567,515,0,51,22127
2/18/2015,12,11497,5248,4470,595,0,58,21868
2/18/2015,13,11489,4201,4569,570,0,356,21185
2/18/2015,14,11499,4012,4517,667,0,360,21055
2/18/2015,15,11499,3924,4338,933,0,83,20777
2/18/2015,16,11497,3657,4263,974,0,116,20507
2/18/2015,17,11502,4382,4654,1020,0,137,21695
2/18/2015,18,11511,5211,5044,989,0,143,22898
2/18/2015,19,11523,5263,5398,1296,0,150,23630
2/18/2015,20,11531,4690,5496,1441,0,149,23307
2/18/2015,21,11525,5609,5075,1300,0,121,23630
2/18/2015,22,11523,5101,4661,1537,0,92,22914
2/18/2015,23,11528,3676,4270,1778,0,83,21335
2/18/2015,24,11534,3099,3790,1791,0,59,20273
2/19/2015,1,11536,2548,3355,1642,0,59,19140
2/19/2015,2,11548,2343,3625,1550,0,62,19128
2/19/2015,3,11557,1740,4067,1485,0,70,18919
2/19/2015,4,11569,1889,3633,1568,0,69,18728
2/19/2015,5,11575,2202,3564,1503,0,71,18915
2/19/2015,6,11588,2761,3827,1500,0,78,19754
2/19/2015,7,11589,3584,4470,1504,0,92,21239
2/19/2015,8,11586,4401,5052,1446,0,137,22622
2/19/2015,9,11584,4359,5036,1322,0,100,22401
2/19/2015,10,11584,3960,4834,1156,0,87,21621
2/19/2015,11,11580,3828,4618,1069,0,87,21182
2/19/2015,12,11585,3510,4210,1228,0,83,20616
2/19/2015,13,11590,3235,4356,1416,0,80,20677
2/19/2015,14,11595,3157,4217,1590,0,85,20644
2/19/2015,15,11602,3302,4042,1641,0,87,20674
2/19/2015,16,11605,3749,3902,1744,0,104,21104
2/19/2015,17,11596,3816,4474,1815,0,111,21812
2/19/2015,18,11590,4287,5368,1500,0,113,22858
2/19/2015,19,11588,5399,5637,1157,0,111,23892
2/19/2015,20,11585,5610,5544,1025,0,108,23872
2/19/2015,21,11580,5493,5570,969,0,99,23711
2/19/2015,22,11573,5096,4696,919,0,94,22378
2/19/2015,23,11571,4632,4223,935,0,101,21462
2/19/2015,24,11583,4261,3866,1178,0,87,20975
2/20/2015,1,11579,3176,3898,1288,0,81,20022
2/20/2015,2,11591,3326,3992,1255,0,83,20247
2/20/2015,3,11588,3501,3937,1220,0,85,20331
2/20/2015,4,11587,3491,3940,1242,0,81,20341
2/20/2015,5,11590,3778,4003,1086,0,89,20546
2/20/2015,6,11592,4280,4053,920,0,150,20995
2/20/2015,7,11592,5206,4874,804,0,175,22651
2/20/2015,8,11589,5923,5431,685,0,163,23791
2/20/2015,9,11591,5771,5141,528,0,97,23128
2/20/2015,10,11592,5110,5138,346,0,95,22281
2/20/2015,11,11594,5698,4910,281,0,95,22578
2/20/2015,12,11597,5574,4402,379,0,95,22047
2/20/2015,13,11592,4857,4421,610,0,95,21575
2/20/2015,14,11594,4461,4315,802,0,96,21268
2/20/2015,15,11597,4177,4225,1070,0,96,21165
2/20/2015,16,11595,3934,4291,1146,0,96,21062
2/20/2015,17,11607,4299,4630,1115,0,99,21750
2/20/2015,18,11621,5001,5081,1155,0,121,22979
2/20/2015,19,11628,5327,5238,1303,0,145,23641
2/20/2015,20,11631,4800,5267,1592,0,173,23463
2/20/2015,21,11622,4916,4988,1982,0,54,23562
2/20/2015,22,11616,4631,4730,1902,0,36,22915
2/20/2015,23,11640,3565,4107,1940,0,35,21287
2/20/2015,24,11638,3138,4008,1918,0,19,20721
2/21/2015,1,11642,1965,3780,1907,0,13,19307
2/21/2015,2,11642,1670,3823,1643,0,28,18806
2/21/2015,3,11652,1793,3718,1292,0,25,18480
2/21/2015,4,11655,1970,3922,924,0,25,18496
2/21/2015,5,11657,2334,3995,809,0,31,18826
2/21/2015,6,11657,2523,3613,760,0,25,18578
2/21/2015,7,11656,3438,3903,633,0,20,19650
2/21/2015,8,11662,4140,4574,461,0,19,20856
2/21/2015,9,11660,4631,5103,424,0,24,21842
2/21/2015,10,11656,4830,4942,349,0,27,21804
2/21/2015,11,11653,4871,5060,251,0,20,21855
2/21/2015,12,11651,4593,4579,217,0,17,21057
2/21/2015,13,11653,4525,4239,184,0,11,20612
2/21/2015,14,11658,4408,4146,169,0,10,20391
2/21/2015,15,11654,4483,4341,113,0,5,20596
2/21/2015,16,11619,4893,4337,115,0,3,20967
2/21/2015,17,11647,5047,4512,107,0,3,21316
2/21/2015,18,11653,5449,4715,155,0,4,21976
2/21/2015,19,11649,5640,4930,179,0,3,22401
2/21/2015,20,11653,5195,4908,162,0,3,21921
2/21/2015,21,11643,4481,4717,176,0,3,21020
2/21/2015,22,11645,3371,4295,190,0,2,19503
2/21/2015,23,11645,3020,4075,224,0,2,18966
2/21/2015,24,11657,2560,3614,266,0,2,18099
2/22/2015,1,11656,1352,3675,373,0,2,17058
2/22/2015,2,11636,935,3837,424,0,3,16835
2/22/2015,3,11657,989,3561,469,0,3,16679
2/22/2015,4,11656,1115,3424,482,0,3,16680
2/22/2015,5,11658,1359,3396,526,0,3,16942
2/22/2015,6,11657,1369,3628,437,0,3,17094
2/22/2015,7,11657,1397,3755,329,0,3,17141
2/22/2015,8,11659,1452,4341,239,0,2,17693
2/22/2015,9,11649,1438,4822,240,0,2,18151
2/22/2015,10,11655,1598,4854,229,0,2,18338
2/22/2015,11,11655,1352,4647,338,0,2,17994
2/22/2015,12,11652,1494,4690,503,0,2,18341
2/22/2015,13,11655,1408,4328,554,0,2,17947
2/22/2015,14,11653,1406,4337,747,0,2,18145
2/22/2015,15,11648,1576,4265,1100,0,2,18591
2/22/2015,16,11652,2023,4541,871,0,2,19089
2/22/2015,17,11646,2044,4629,833,0,2,19154
2/22/2015,18,11647,2341,5323,743,0,2,20056
2/22/2015,19,11643,2523,5534,800,0,2,20502
2/22/2015,20,11649,2395,5482,881,0,2,20409
2/22/2015,21,11639,2702,5208,847,0,2,20398
2/22/2015,22,11639,2072,4621,1065,0,2,19399
2/22/2015,23,11642,1222,4013,1695,0,2,18574
2/22/2015,24,11643,1037,3434,1913,0,1,18028
2/23/2015,1,11644,1084,3423,1660,0,5,17816
2/23/2015,2,11645,1266,3385,1710,0,13,18019
2/23/2015,3,11648,1507,3427,1768,0,16,18366
2/23/2015,4,11647,1876,3698,1616,0,25,18862
2/23/2015,5,11646,2458,3889,1330,0,28,19351
2/23/2015,6,11648,3228,3626,927,0,44,19473
2/23/2015,7,11644,3556,4642,889,0,59,20790
2/23/2015,8,11645,4443,5303,853,0,46,22290
2/23/2015,9,11644,4607,5373,719,0,46,22389
2/23/2015,10,11648,4128,5553,567,0,58,21954
2/23/2015,11,11648,4466,5168,519,0,69,21870
2/23/2015,12,11638,3665,4792,503,0,69,20667
2/23/2015,13,11647,3539,5040,557,0,93,20876
2/23/2015,14,11657,3426,5012,609,0,132,20836
2/23/2015,15,11651,3613,4916,601,0,163,20944
2/23/2015,16,11648,4209,4913,618,0,149,21537
2/23/2015,17,11646,4954,5152,798,0,161,22711
2/23/2015,18,11645,5358,5291,1084,0,189,23567
2/23/2015,19,11643,5297,5365,1486,0,205,23996
2/23/2015,20,11645,4772,5537,1895,0,142,23991
2/23/2015,21,11646,4994,5415,2258,0,56,24369
2/23/2015,22,11632,5024,5044,2238,0,67,24005
2/23/2015,23,11631,4486,4476,2165,0,87,22845
2/23/2015,24,11641,4101,4034,2001,0,98,21875
2/24/2015,1,11644,3290,4029,2000,0,93,21056
2/24/2015,2,11641,3140,3883,2082,0,90,20836
2/24/2015,3,11641,2972,3786,2186,0,94,20679
2/24/2015,4,11644,2866,3753,2279,0,58,20600
2/24/2015,5,11654,2850,3713,2395,0,55,20667
2/24/2015,6,11648,3531,3659,2411,0,59,21308
2/24/2015,7,11649,4353,4091,2525,0,69,22687
2/24/2015,8,11654,5048,4561,2572,0,71,23906
2/24/2015,9,11651,4893,4686,2596,0,78,23904
2/24/2015,10,11649,4733,4708,2603,0,75,23768
2/24/2015,11,11650,4741,4485,2597,0,73,23546
2/24/2015,12,11649,4308,4405,2629,0,69,23060
2/24/2015,13,11656,3533,4384,2634,0,67,22274
2/24/2015,14,11655,3383,4366,2622,0,72,22098
2/24/2015,15,11653,3573,4335,2644,0,66,22271
2/24/2015,16,11649,3454,4387,2670,0,67,22227
2/24/2015,17,11654,3975,4643,2654,0,67,22993
2/24/2015,18,11655,4798,4742,2647,0,63,23905
2/24/2015,19,11662,5357,4981,2603,0,64,24667
2/24/2015,20,11661,5514,5057,2641,0,62,24935
2/24/2015,21,11662,5199,4931,2637,0,47,24476
2/24/2015,22,11662,4403,4828,2596,0,47,23536
2/24/2015,23,11664,3498,3934,2485,0,46,21627
2/24/2015,24,11669,1747,3577,2439,0,34,19466
2/25/2015,1,11658,1067,3520,2540,0,46,18831
2/25/2015,2,11626,1076,3616,2422,0,46,18786
2/25/2015,3,11621,1096,3605,2344,0,42,18708
2/25/2015,4,11621,1246,3678,2254,0,41,18840
2/25/2015,5,11618,1634,3431,2266,0,35,18984
2/25/2015,6,11613,2453,3256,2209,0,43,19574
2/25/2015,7,11612,3347,4149,2018,0,51,21177
2/25/2015,8,11613,4230,4866,1879,0,57,22645
2/25/2015,9,11616,4394,4897,1422,0,62,22391
2/25/2015,10,11604,3791,4693,1059,0,63,21210
2/25/2015,11,11605,3513,3981,942,0,64,20105
2/25/2015,12,11314,3380,3765,811,0,67,19337
2/25/2015,13,11093,2982,4283,763,0,68,19189
2/25/2015,14,10974,2766,4535,644,0,63,18982
2/25/2015,15,10985,2867,4523,637,0,64,19076
2/25/2015,16,11100,3210,4119,542,0,62,19033
2/25/2015,17,11105,3609,4971,494,0,62,20241
2/25/2015,18,11109,4580,5264,402,0,63,21418
2/25/2015,19,11107,4930,5310,365,0,62,21774
2/25/2015,20,11094,5007,5438,500,0,64,22103
2/25/2015,21,11087,5428,5319,537,0,65,22436
2/25/2015,22,11080,4848,5002,478,0,65,21473
2/25/2015,23,11081,4104,4473,526,0,66,20250
2/25/2015,24,11076,3322,3817,491,0,55,18761
2/26/2015,1,11086,2872,3748,570,0,50,18326
2/26/2015,2,11081,2573,3641,659,0,50,18004
2/26/2015,3,11073,2441,3430,738,0,49,17731
2/26/2015,4,11078,2343,3741,626,0,53,17841
2/26/2015,5,11071,2642,3722,770,0,56,18261
2/26/2015,6,11073,3550,4006,803,0,40,19472
2/26/2015,7,11075,4794,4875,681,0,40,21465
2/26/2015,8,11080,5834,5499,551,0,46,23010
2/26/2015,9,11077,5412,5517,462,0,52,22520
2/26/2015,10,11076,4832,5217,396,0,50,21571
2/26/2015,11,11072,4208,5078,274,0,45,20677
2/26/2015,12,11076,3804,4794,278,0,41,19993
2/26/2015,13,11079,3535,4690,372,0,24,19700
2/26/2015,14,11077,3519,4553,526,0,22,19697
2/26/2015,15,11074,3580,4561,570,0,22,19807
2/26/2015,16,11076,3612,4558,595,0,24,19865
2/26/2015,17,11077,3776,4735,731,0,24,20343
2/26/2015,18,11064,4289,5117,871,0,19,21360
2/26/2015,19,11060,4923,5258,897,0,22,22160
2/26/2015,20,11059,5352,5145,834,0,19,22409
2/26/2015,21,11054,5590,5158,723,0,19,22544
2/26/2015,22,11055,5663,4770,637,0,20,22145
2/26/2015,23,11059,5244,4379,555,0,18,21255
2/26/2015,24,11041,4792,4151,511,0,27,20522
2/27/2015,1,11048,3916,3959,605,0,29,19557
2/27/2015,2,11042,3788,3922,639,0,28,19419
2/27/2015,3,11046,3564,3792,586,0,29,19017
2/27/2015,4,11046,4145,3809,453,0,30,19483
2/27/2015,5,11049,4742,3838,337,0,28,19994
2/27/2015,6,11031,5185,4072,286,0,25,20599
2/27/2015,7,11026,5447,4793,266,0,28,21560
2/27/2015,8,11024,5982,5054,262,0,23,22345
2/27/2015,9,11019,5918,4967,273,0,27,22204
2/27/2015,10,11026,5295,4815,210,0,26,21372
2/27/2015,11,11025,4557,4583,211,0,27,20403
2/27/2015,12,11016,3756,4457,276,0,19,19524
2/27/2015,13,11009,3754,4379,368,0,22,19532
2/27/2015,14,11014,3529,4236,497,0,7,19283
2/27/2015,15,11015,3380,4278,525,0,6,19204
2/27/2015,16,11016,3397,4440,521,0,3,19377
2/27/2015,17,11014,3464,4475,609,0,4,19566
2/27/2015,18,11013,4089,4919,624,0,4,20649
2/27/2015,19,11007,4566,5247,781,0,4,21605
2/27/2015,20,11008,4177,5076,1073,0,4,21338
2/27/2015,21,11004,3993,4951,1268,0,4,21220
2/27/2015,22,10990,4407,4570,1308,0,3,21278
2/27/2015,23,10993,3450,4198,1385,0,3,20029
2/27/2015,24,10990,3063,3941,1384,0,5,19383
2/28/2015,1,10990,2187,3861,1501,0,3,18542
2/28/2015,2,10986,2252,3903,1367,0,4,18512
2/28/2015,3,10985,2061,3815,1152,0,3,18016
2/28/2015,4,10977,1666,3816,1014,0,3,17476
2/28/2015,5,10974,2001,3965,841,0,4,17785
2/28/2015,6,10972,2510,3812,730,0,3,18027
2/28/2015,7,10965,2695,4045,757,0,4,18466
2/28/2015,8,10969,2483,4542,675,0,3,18672
2/28/2015,9,10965,2494,4932,567,0,3,18961
2/28/2015,10,10959,2785,4867,401,0,3,19015
2/28/2015,11,10967,2878,4860,311,0,3,19019
2/28/2015,12,10961,2992,4611,301,0,11,18876
2/28/2015,13,10964,2917,4422,300,0,11,18614
2/28/2015,14,10929,2816,3971,389,0,22,18127
2/28/2015,15,10940,2808,3823,563,0,24,18158
2/28/2015,16,10385,2981,4099,582,0,21,18068
2/28/2015,17,10123,2917,4415,511,0,17,17983
2/28/2015,18,10121,3338,4807,386,0,19,18671
2/28/2015,19,10131,3770,5313,408,0,17,19639
2/28/2015,20,10129,3832,5064,484,0,21,19530
2/28/2015,21,10121,3432,4799,588,0,17,18957
2/28/2015,22,10123,3490,4471,681,0,16,18781
2/28/2015,23,10121,3578,4237,626,0,18,18580
2/28/2015,24,10123,2249,4185,612,0,15,17184
3/1/2015,1,10132,1778,4007,573,0,16,16506
3/1/2015,2,10132,1584,3918,521,0,16,16171
3/1/2015,3,10132,1526,3830,501,0,21,16010
3/1/2015,4,10135,1608,3889,353,0,16,16001
3/1/2015,5,10137,1879,3872,371,0,19,16278
3/1/2015,6,10140,2029,4036,312,0,20,16537
3/1/2015,7,10144,2231,4091,256,0,15,16737
3/1/2015,8,10148,2586,4317,253,0,18,17322
3/1/2015,9,10180,3075,4637,184,0,22,18098
3/1/2015,10,10155,2906,4757,128,0,19,17965
3/1/2015,11,10177,2889,4654,106,0,21,17847
3/1/2015,12,10186,2666,4284,125,0,21,17282
3/1/2015,13,10177,3019,4353,165,0,21,17735
3/1/2015,14,10182,3164,4256,148,0,21,17771
3/1/2015,15,10184,3266,4262,141,0,20,17873
3/1/2015,16,10172,3314,4243,136,0,22,17887
3/1/2015,17,10162,3350,4444,140,0,22,18118
3/1/2015,18,10164,3720,4795,180,0,23,18882
3/1/2015,19,10169,4075,5339,261,0,20,19864
3/1/2015,20,10175,4224,5222,486,0,25,20132
3/1/2015,21,10172,3858,5083,699,0,22,19834
3/1/2015,22,10174,3143,4585,859,0,13,18774
3/1/2015,23,10168,2302,3950,1103,0,9,17532
3/1/2015,24,10180,1483,3978,1369,0,8,17018
3/2/2015,1,10182,1146,4089,1335,0,22,16774
3/2/2015,2,10187,1223,4259,1154,0,24,16847
3/2/2015,3,10183,1351,4060,1242,0,20,16856
3/2/2015,4,10192,1357,3493,1599,0,23,16664
3/2/2015,5,10195,1478,3505,1691,0,28,16897
3/2/2015,6,10200,1913,3548,1358,0,27,17046
3/2/2015,7,10203,2173,4145,1796,0,38,18355
3/2/2015,8,10204,2419,4783,1939,0,48,19393
3/2/2015,9,10201,2752,4820,1780,0,50,19603
3/2/2015,10,10195,2495,4648,1684,0,52,19074
3/2/2015,11,10200,2530,4368,1584,0,56,18738
3/2/2015,12,10200,2879,4202,1594,0,51,18926
3/2/2015,13,10203,2880,4095,1533,0,46,18757
3/2/2015,14,10203,2806,4126,1423,0,42,18600
3/2/2015,15,10202,2638,4169,1296,0,43,18348
3/2/2015,16,10207,2849,4034,1154,0,34,18278
3/2/2015,17,10326,3233,4242,895,0,37,18733
3/2/2015,18,10402,3764,4775,730,0,38,19709
3/2/2015,19,10401,4376,5333,548,0,39,20697
3/2/2015,20,10400,4712,5277,522,0,41,20952
3/2/2015,21,10401,4073,5154,548,0,43,20219
3/2/2015,22,10458,4082,4696,525,0,38,19799
3/2/2015,23,10707,3059,4258,601,0,35,18660
3/2/2015,24,10871,2563,3680,672,0,26,17812
3/3/2015,1,10880,1594,3588,735,0,22,16819
3/3/2015,2,10880,1319,3655,772,0,18,16644
3/3/2015,3,10887,1212,3404,760,0,15,16278
3/3/2015,4,10889,1079,3696,706,0,14,16384
3/3/2015,5,10895,1347,4253,670,0,15,17180
3/3/2015,6,10899,1811,3897,766,0,18,17391
3/3/2015,7,10900,2730,4561,965,0,28,19184
3/3/2015,8,10899,3404,4988,1120,0,27,20438
3/3/2015,9,10900,2988,5073,1119,0,37,20117
3/3/2015,10,10901,2779,4956,1233,0,39,19908
3/3/2015,11,10905,2761,4626,1419,0,32,19743
3/3/2015,12,10902,2781,4589,1465,0,29,19766
3/3/2015,13,10975,2626,4542,1270,0,27,19440
3/3/2015,14,11087,2887,4231,1271,0,26,19502
3/3/2015,15,11098,2846,4239,1423,0,26,19632
3/3/2015,16,10821,3361,4409,1399,0,26,20016
3/3/2015,17,10294,3937,4466,1289,0,27,20013
3/3/2015,18,10212,4536,4825,1327,0,27,20927
3/3/2015,19,10214,4439,4950,1750,0,31,21384
3/3/2015,20,10202,3572,4817,2046,0,37,20674
3/3/2015,21,10019,3326,4690,1847,0,27,19909
3/3/2015,22,10023,3163,3991,1774,0,27,18978
3/3/2015,23,10023,2537,4184,1625,0,27,18396
3/3/2015,24,10027,2212,3823,1465,0,21,17548
3/4/2015,1,10024,2190,3798,1467,0,17,17496
3/4/2015,2,10018,2119,3648,1268,0,15,17068
3/4/2015,3,10020,1709,3469,1204,0,14,16416
3/4/2015,4,10024,1731,3515,1112,0,14,16396
3/4/2015,5,10034,1699,3578,970,0,15,16296
3/4/2015,6,10189,1912,3500,848,0,21,16470
3/4/2015,7,10844,2161,3924,852,0,21,17802
3/4/2015,8,11148,2341,4325,817,0,26,18657
3/4/2015,9,11151,2418,4406,788,0,26,18789
3/4/2015,10,11153,2527,4357,770,0,28,18835
3/4/2015,11,11154,2534,4442,835,0,27,18992
3/4/2015,12,11161,2423,4314,887,0,27,18812
3/4/2015,13,11164,2481,4384,911,0,27,18967
3/4/2015,14,11004,2146,4355,964,0,27,18496
3/4/2015,15,11020,2022,4335,1065,0,27,18469
3/4/2015,16,10987,2197,4375,1126,0,28,18713
3/4/2015,17,11139,2360,4548,1018,0,29,19094
3/4/2015,18,11151,2372,4920,1320,0,29,19792
3/4/2015,19,11149,2367,5182,1492,0,29,20219
3/4/2015,20,11148,2291,4923,1834,0,37,20233
3/4/2015,21,11148,2090,4365,2124,0,56,19783
3/4/2015,22,11148,1708,3788,2117,0,85,18846
3/4/2015,23,11145,1518,3559,2096,0,85,18403
3/4/2015,24,11141,1111,3384,2300,0,78,18014
3/5/2015,1,11135,951,3611,2110,0,71,17878
3/5/2015,2,11131,1077,3871,1799,0,72,17950
3/5/2015,3,11136,1356,4011,1411,0,91,18005
3/5/2015,4,11132,1607,3683,1006,0,90,17518
3/5/2015,5,11135,2052,4024,649,0,129,17989
3/5/2015,6,11136,2491,3837,478,0,101,18043
3/5/2015,7,11138,3031,4253,305,0,85,18812
3/5/2015,8,11135,3327,4937,216,0,161,19776
3/5/2015,9,11134,3334,5269,154,0,160,20051
3/5/2015,10,11132,2924,4899,118,0,103,19176
3/5/2015,11,11132,2827,4886,136,0,96,19077
3/5/2015,12,11139,2957,4502,187,0,97,18882
3/5/2015,13,11123,3188,4614,242,0,103,19270
3/5/2015,14,11133,3250,4456,338,0,90,19267
3/5/2015,15,11132,2965,4390,413,0,86,18986
3/5/2015,16,11135,3121,4223,360,0,87,18926
3/5/2015,17,11130,3430,4645,316,0,91,19612
3/5/2015,18,11129,3661,5138,255,0,107,20290
3/5/2015,19,11130,4455,5556,212,0,137,21490
3/5/2015,20,11132,5042,5453,280,0,137,22044
3/5/2015,21,11131,4921,5344,389,0,123,21908
3/5/2015,22,11129,4305,5040,519,0,129,21122
3/5/2015,23,11131,3232,4827,575,0,128,19893
3/5/2015,24,11135,2971,4316,713,0,77,19212
3/6/2015,1,11134,2771,4347,858,0,73,19183
3/6/2015,2,11133,2359,4172,890,0,70,18624
3/6/2015,3,11130,2644,4103,888,0,67,18832
3/6/2015,4,11127,2776,3979,973,0,75,18930
3/6/2015,5,11125,3164,4020,948,0,83,19340
3/6/2015,6,11126,3376,4272,898,0,72,19744
3/6/2015,7,11124,4403,4977,835,0,75,21414
3/6/2015,8,11122,4692,5079,833,0,82,21808
3/6/2015,9,11123,4126,4897,852,0,82,21080
3/6/2015,10,11125,3756,4854,840,0,82,20657
3/6/2015,11,11124,3243,4366,1014,0,81,19828
3/6/2015,12,11119,2300,4503,1430,0,82,19434
3/6/2015,13,11116,1607,4302,1969,0,83,19077
3/6/2015,14,11120,1536,4119,2069,0,82,18926
3/6/2015,15,11128,1627,4120,2341,0,83,19299
3/6/2015,16,11140,1768,4250,2430,0,82,19670
3/6/2015,17,11135,2191,4235,2478,0,82,20121
3/6/2015,18,11144,2423,4508,2478,0,83,20636
3/6/2015,19,11182,2892,5089,2451,0,84,21698
3/6/2015,20,11188,2915,5063,2538,0,80,21784
3/6/2015,21,11202,2592,5025,2589,0,80,21488
3/6/2015,22,11224,2072,4414,2643,0,79,20432
3/6/2015,23,11262,1521,4212,2689,0,80,19764
3/6/2015,24,11334,1424,3818,2580,0,69,19225
3/7/2015,1,11385,1370,3440,2160,0,64,18419
3/7/2015,2,11385,1366,3353,1755,0,61,17920
3/7/2015,3,11395,1033,3427,1758,0,60,17673
3/7/2015,4,11392,961,3366,1745,0,60,17524
3/7/2015,5,11392,963,3326,1769,0,62,17512
3/7/2015,6,11389,963,3549,1795,0,62,17758
3/7/2015,7,11389,1035,4180,1475,0,80,18159
3/7/2015,8,11389,1026,4372,1296,0,69,18152
3/7/2015,9,11388,1073,4736,1300,0,93,18590
3/7/2015,10,11385,1162,4264,1231,0,74,18116
3/7/2015,11,11387,1154,4129,1339,0,61,18070
3/7/2015,12,11398,1277,3916,1417,0,62,18070
3/7/2015,13,11392,1430,4309,1367,0,62,18560
3/7/2015,14,11402,1620,4419,1513,0,66,19020
3/7/2015,15,11423,1566,4362,1619,0,62,19032
3/7/2015,16,11420,1743,4281,1587,0,61,19092
3/7/2015,17,11427,1765,4572,1477,0,62,19303
3/7/2015,18,11424,1820,4992,1393,0,63,19692
3/7/2015,19,11418,1913,5365,1319,0,62,20077
3/7/2015,20,11421,1950,5366,1174,0,67,19978
3/7/2015,21,11415,1897,5376,1023,0,65,19776
3/7/2015,22,11411,1809,4708,870,0,62,18860
3/7/2015,23,11413,1415,4762,698,0,66,18354
3/7/2015,24,11415,1284,4035,611,0,66,17411
3/8/2015,1,11414,1047,4043,612,0,82,17198
3/8/2015,2,11416,972,3428,1071,0,63,16950
3/8/2015,3,11410,971,3648,754,0,60,16843
3/8/2015,4,11416,969,3766,694,0,60,16905
3/8/2015,5,11414,969,3390,963,0,60,16796
3/8/2015,6,11428,970,3360,1032,0,22,16812
3/8/2015,7,11520,923,3767,1112,0,14,17336
3/8/2015,8,11581,925,4074,1004,0,14,17598
3/8/2015,9,11587,1033,4452,768,0,14,17854
3/8/2015,10,11586,1023,4070,767,0,14,17460
3/8/2015,11,11581,972,4078,597,0,14,17242
3/8/2015,12,11585,991,4271,496,0,14,17357
3/8/2015,13,11588,1005,4286,513,0,14,17406
3/8/2015,14,11557,957,4086,494,0,15,17109
3/8/2015,15,11583,953,4073,557,0,14,17180
3/8/2015,16,11592,950,3693,760,0,14,17009
3/8/2015,17,11585,955,4275,1333,0,14,18162
3/8/2015,18,11587,957,4341,1528,0,16,18429
3/8/2015,19,11586,959,4831,1788,0,14,19178
3/8/2015,20,11597,963,4559,2092,0,14,19225
3/8/2015,21,11587,966,4239,2166,0,14,18972
3/8/2015,22,11636,983,3991,2196,0,14,18820
3/8/2015,23,11659,964,3408,1877,0,14,17922
3/8/2015,24,11700,965,3345,1490,0,15,17515
3/9/2015,1,11464,965,3284,1298,0,15,17026
3/9/2015,2,11298,1003,3290,1293,0,19,16903
3/9/2015,3,11260,1047,3300,1285,0,14,16906
3/9/2015,4,11259,1167,3401,1255,0,14,17096
3/9/2015,5,11265,1306,4019,932,0,15,17537
3/9/2015,6,11527,1531,4527,628,0,24,18237
3/9/2015,7,11842,1864,5080,333,0,30,19149
3/9/2015,8,11845,2004,4963,240,0,31,19083
3/9/2015,9,11846,1678,4563,254,0,31,18372
3/9/2015,10,11849,1368,4218,318,0,31,17784
3/9/2015,11,11853,1363,4213,341,0,31,17801
3/9/2015,12,11858,1361,4164,351,0,31,17765
3/9/2015,13,11857,1389,4179,634,0,31,18090
3/9/2015,14,11839,1236,3809,845,0,31,17760
3/9/2015,15,11838,1266,3796,768,0,31,17699
3/9/2015,16,11831,1392,3982,714,0,32,17951
3/9/2015,17,11914,1376,3900,720,0,32,17942
3/9/2015,18,12040,1504,4344,775,0,31,18694
3/9/2015,19,12053,1541,5012,970,0,31,19607
3/9/2015,20,12062,1549,5129,1145,0,16,19901
3/9/2015,21,12190,1543,4707,1172,0,23,19635
3/9/2015,22,12229,1460,4036,1218,0,31,18974
3/9/2015,23,12151,1356,3512,1065,0,23,18107
3/9/2015,24,11839,1347,3435,1063,0,17,17701
3/10/2015,1,11660,1018,3626,1032,0,14,17350
3/10/2015,2,11658,964,3609,1037,0,14,17282
3/10/2015,3,11641,962,3608,1093,0,14,17318
3/10/2015,4,11648,957,3292,1154,0,15,17066
3/10/2015,5,11648,960,3415,1242,0,17,17282
3/10/2015,6,11937,965,3926,1117,0,26,17971
3/10/2015,7,12223,964,4819,995,0,31,19032
3/10/2015,8,12224,1005,5022,896,0,31,19178
3/10/2015,9,12231,967,4686,802,0,31,18717
3/10/2015,10,11992,1006,5042,693,0,31,18764
3/10/2015,11,11805,1118,5250,657,0,31,18861
3/10/2015,12,11805,1072,4917,621,0,30,18445
3/10/2015,13,11776,1087,4738,636,0,27,18264
3/10/2015,14,11765,1004,4247,751,0,26,17793
3/10/2015,15,11794,949,3872,840,0,24,17479
3/10/2015,16,11817,942,4498,848,0,29,18134
3/10/2015,17,11820,1011,5011,853,0,31,18726
3/10/2015,18,11822,1020,5033,993,0,31,18899
3/10/2015,19,11824,959,5064,1148,0,32,19027
3/10/2015,20,11825,959,4771,1449,0,32,19036
3/10/2015,21,11823,953,4358,1676,0,31,18841
3/10/2015,22,11822,930,3657,1593,0,29,18031
3/10/2015,23,11674,942,3313,1560,0,20,17509
3/10/2015,24,11253,950,3348,1849,0,19,17419
3/11/2015,1,11240,953,3216,1664,0,21,17094
3/11/2015,2,11228,954,3204,1548,0,21,16955
3/11/2015,3,11240,955,3195,1450,0,18,16858
3/11/2015,4,11240,956,3344,1484,0,20,17044
3/11/2015,5,11286,957,3564,1278,0,26,17111
3/11/2015,6,11564,924,4122,1061,0,25,17696
3/11/2015,7,11862,955,4611,960,0,32,18420
3/11/2015,8,11859,973,4584,858,0,34,18308
3/11/2015,9,11850,960,4446,741,0,34,18031
3/11/2015,10,11834,963,4287,593,0,35,17712
3/11/2015,11,11828,960,4464,606,0,35,17893
3/11/2015,12,11844,961,4200,695,0,33,17733
3/11/2015,13,11847,958,4043,841,0,34,17723
3/11/2015,14,11821,958,3844,800,0,33,17456
3/11/2015,15,11803,959,3673,821,0,34,17290
3/11/2015,16,11799,960,3926,760,0,32,17477
3/11/2015,17,11810,965,4136,729,0,36,17676
3/11/2015,18,11829,1014,4487,757,0,33,18120
3/11/2015,19,11842,1038,4911,838,0,33,18662
3/11/2015,20,11879,1054,4904,1140,0,32,19009
3/11/2015,21,11865,1057,4150,1329,0,31,18432
3/11/2015,22,11707,1068,3685,1350,0,32,17842
3/11/2015,23,11074,1062,3535,1696,0,25,17392
3/11/2015,24,11099,1064,3351,1592,0,18,17124
3/12/2015,1,11100,1047,3440,1362,0,17,16966
3/12/2015,2,11103,1038,3293,1314,0,18,16766
3/12/2015,3,11112,1073,3256,1265,0,17,16723
3/12/2015,4,11118,1110,3301,1218,0,17,16764
3/12/2015,5,11118,1276,3879,1061,0,19,17353
3/12/2015,6,11120,1634,4325,868,0,25,17972
3/12/2015,7,11126,1787,4936,755,0,30,18634
3/12/2015,8,11125,1535,4680,713,0,32,18085
3/12/2015,9,11104,1404,4553,568,0,33,17662
3/12/2015,10,11089,1398,4578,479,0,32,17576
3/12/2015,11,11097,1559,4940,341,0,32,17969
3/12/2015,12,11096,1231,4840,308,0,33,17508
3/12/2015,13,11089,1269,4846,311,0,52,17567
3/12/2015,14,11093,1419,4720,216,0,88,17536
3/12/2015,15,11090,1586,4590,175,0,116,17557
3/12/2015,16,11077,1641,4695,183,0,161,17757
3/12/2015,17,11085,1829,4780,198,0,152,18044
3/12/2015,18,11078,1829,5045,292,0,170,18414
3/12/2015,19,11090,1948,5478,368,0,211,19095
3/12/2015,20,11093,2100,5159,579,0,222,19153
3/12/2015,21,11079,1988,4909,881,0,213,19070
3/12/2015,22,11088,1529,4083,1295,0,156,18151
3/12/2015,23,11094,1079,3925,1591,0,83,17772
3/12/2015,24,11093,976,3425,1767,0,71,17332
3/13/2015,1,11092,984,3199,1704,0,69,17048
3/13/2015,2,11079,1009,3168,1604,0,72,16932
3/13/2015,3,11076,1012,2998,1477,0,74,16637
3/13/2015,4,11075,1030,3071,1476,0,68,16720
3/13/2015,5,11096,1108,3263,1673,0,71,17211
3/13/2015,6,11091,1158,3792,1549,0,117,17707
3/13/2015,7,11090,1229,4609,1517,0,173,18618
3/13/2015,8,11093,1178,4547,1649,0,198,18665
3/13/2015,9,11082,1179,4734,1470,0,161,18626
3/13/2015,10,11103,1252,4821,1192,0,111,18479
3/13/2015,11,11112,1293,5098,899,0,84,18486
3/13/2015,12,11109,1286,4965,636,0,131,18127
3/13/2015,13,11106,1279,4641,511,0,108,17645
3/13/2015,14,11093,1259,4674,430,0,91,17547
3/13/2015,15,11108,1281,4477,399,0,90,17355
3/13/2015,16,11086,1346,4504,440,0,85,17461
3/13/2015,17,11103,1418,4735,646,0,85,17987
3/13/2015,18,11105,1434,4771,1017,0,90,18417
3/13/2015,19,11124,1376,4838,1392,0,90,18820
3/13/2015,20,11228,1367,4973,1541,0,131,19240
3/13/2015,21,11317,1176,4396,1777,0,151,18817
3/13/2015,22,11302,988,3564,1948,0,93,17895
3/13/2015,23,11435,956,3190,1801,0,83,17465
3/13/2015,24,11318,953,2981,1686,0,74,17012
3/14/2015,1,11195,952,2875,1527,0,57,16606
3/14/2015,2,11232,941,2848,1552,0,11,16584
3/14/2015,3,11248,900,2869,1579,0,4,16600
3/14/2015,4,11331,884,2897,1385,0,5,16502
3/14/2015,5,11389,844,3045,1488,0,3,16769
3/14/2015,6,11451,844,3122,1354,0,5,16776
3/14/2015,7,11671,848,3553,1219,0,3,17294
3/14/2015,8,11672,850,4071,1038,0,3,17634
3/14/2015,9,11668,920,4587,1135,0,3,18313
3/14/2015,10,11669,898,4980,1190,0,1,18738
3/14/2015,11,11666,864,4833,1030,0,2,18395
3/14/2015,12,11670,853,4427,1322,0,19,18291
3/14/2015,13,11668,839,4240,1493,0,43,18283
3/14/2015,14,11658,840,4382,1334,0,62,18276
3/14/2015,15,11661,828,4140,1505,0,61,18195
3/14/2015,16,11669,845,4172,1612,0,63,18361
3/14/2015,17,11748,858,4253,1575,0,60,18494
3/14/2015,18,11740,925,4657,1527,0,60,18909
3/14/2015,19,11750,875,4746,1520,0,60,18951
3/14/2015,20,11740,866,4359,1874,0,60,18899
3/14/2015,21,11739,896,3577,1975,0,54,18241
3/14/2015,22,11600,901,3176,1984,0,10,17671
3/14/2015,23,11080,902,3121,2205,0,0,17308
3/14/2015,24,10694,924,3215,2273,0,0,17106
3/15/2015,1,10546,949,3012,2156,0,0,16663
3/15/2015,2,10378,906,2945,2067,0,1,16297
3/15/2015,3,10457,908,2923,1873,0,1,16162
3/15/2015,4,10485,908,2958,1844,0,2,16197
3/15/2015,5,10492,909,3050,1885,0,2,16338
3/15/2015,6,10508,910,3562,1804,0,2,16786
3/15/2015,7,10793,916,3951,1734,0,1,17395
3/15/2015,8,11308,938,3837,1721,0,1,17805
3/15/2015,9,11678,946,3918,1658,0,1,18201
3/15/2015,10,11922,913,3855,1478,0,1,18169
3/15/2015,11,11951,877,4087,1327,0,1,18243
3/15/2015,12,11970,902,4136,1205,0,1,18214
3/15/2015,13,11964,900,3780,970,0,1,17615
3/15/2015,14,11874,896,3939,739,0,1,17449
3/15/2015,15,11873,906,3950,646,0,1,17376
3/15/2015,16,11923,926,4230,598,0,1,17678
3/15/2015,17,11920,940,4667,461,0,1,17989
3/15/2015,18,11952,1077,5049,411,0,1,18490
3/15/2015,19,11981,1127,5229,537,0,18,18892
3/15/2015,20,11979,1360,4930,742,0,53,19064
3/15/2015,21,11979,1313,4590,1060,0,112,19054
3/15/2015,22,12095,1051,3579,1373,0,86,18184
3/15/2015,23,12103,909,3057,1326,0,59,17454
3/15/2015,24,11992,912,3083,1386,0,42,17415
3/16/2015,1,11606,926,3044,1481,0,8,17065
3/16/2015,2,11580,939,2968,1263,0,15,16765
3/16/2015,3,11575,944,2898,1328,0,18,16763
3/16/2015,4,11582,942,2910,1444,0,18,16896
3/16/2015,5,11724,942,3022,1665,0,18,17371
3/16/2015,6,12129,943,3305,1479,0,43,17899
3/16/2015,7,12146,947,3712,1491,0,64,18360
3/16/2015,8,12150,949,4260,1329,0,169,18857
3/16/2015,9,12148,935,4547,986,0,210,18826
3/16/2015,10,12152,915,4750,651,0,221,18689
3/16/2015,11,12148,914,4637,310,0,236,18245
3/16/2015,12,12150,936,4726,288,0,236,18336
3/16/2015,13,12146,923,4306,440,0,195,18010
3/16/2015,14,12154,914,4121,550,0,156,17895
3/16/2015,15,12149,910,4147,844,0,148,18198
3/16/2015,16,12146,923,4376,938,0,169,18552
3/16/2015,17,12208,944,4247,1179,0,176,18754
3/16/2015,18,12312,975,4170,1408,0,102,18967
3/16/2015,19,12337,1121,4647,1228,0,106,19439
3/16/2015,20,12327,1131,4406,1341,0,97,19302
3/16/2015,21,12329,1129,4042,991,0,97,18588
3/16/2015,22,12337,1135,3696,624,0,83,17875
3/16/2015,23,12335,1013,3208,993,0,25,17574
3/16/2015,24,12330,945,3047,972,0,18,17312
3/17/2015,1,12240,943,2885,897,0,15,16980
3/17/2015,2,11830,948,2845,811,0,15,16449
3/17/2015,3,11176,950,2885,1211,0,14,16236
3/17/2015,4,10933,952,2942,1444,0,15,16286
3/17/2015,5,10998,954,3039,1702,0,20,16713
3/17/2015,6,11177,956,3196,2103,0,24,17456
3/17/2015,7,11186,967,4042,2430,0,33,18658
3/17/2015,8,11730,990,4404,2359,0,33,19516
3/17/2015,9,12253,959,4081,2176,0,33,19502
3/17/2015,10,12332,960,4021,1812,0,32,19157
3/17/2015,11,12332,959,3903,1540,0,32,18766
3/17/2015,12,12169,958,3798,1701,0,33,18659
3/17/2015,13,12149,959,3651,1567,0,33,18359
3/17/2015,14,12155,958,3657,1693,0,33,18496
3/17/2015,15,12175,959,3696,1807,0,32,18669
3/17/2015,16,12331,957,3856,1479,0,32,18655
3/17/2015,17,12434,954,3812,1465,0,31,18696
3/17/2015,18,12431,959,4124,1522,0,30,19066
3/17/2015,19,12438,985,4789,1396,0,32,19640
3/17/2015,20,12435,1260,4967,1455,0,33,20150
3/17/2015,21,12429,1310,4028,1550,0,33,19350
3/17/2015,22,12427,1157,3774,1613,0,33,19004
3/17/2015,23,12434,979,3639,1576,0,22,18650
3/17/2015,24,12440,990,3425,1237,0,18,18110
3/18/2015,1,12442,974,3150,1128,0,16,17710
3/18/2015,2,12440,982,3080,908,0,14,17424
3/18/2015,3,12436,985,3055,755,0,14,17245
3/18/2015,4,12443,992,3272,687,0,14,17408
3/18/2015,5,12438,992,3643,611,0,19,17703
3/18/2015,6,12441,1142,3967,578,0,28,18156
3/18/2015,7,12446,1131,4348,634,0,31,18590
3/18/2015,8,12444,1269,4304,588,0,40,18645
3/18/2015,9,12448,1250,4409,465,0,40,18612
3/18/2015,10,12440,1253,4102,439,0,35,18269
3/18/2015,11,12442,1310,4012,576,0,38,18378
3/18/2015,12,12438,1317,3940,728,0,42,18465
3/18/2015,13,12425,1302,4064,968,0,36,18795
3/18/2015,14,12418,1243,3806,1160,0,35,18662
3/18/2015,15,12414,1085,3684,1161,0,30,18374
3/18/2015,16,12416,1001,3726,1034,0,32,18209
3/18/2015,17,12428,1131,4013,879,0,37,18488
3/18/2015,18,12436,1138,4331,699,0,43,18647
3/18/2015,19,12441,1193,5049,411,0,83,19177
3/18/2015,20,12439,1400,5393,285,0,177,19694
3/18/2015,21,12442,1322,4996,278,0,151,19189
3/18/2015,22,12433,1047,4670,364,0,144,18658
3/18/2015,23,12426,1017,4209,389,0,153,18194
3/18/2015,24,12419,970,4001,388,0,154,17932
3/19/2015,1,12410,1014,3813,293,0,153,17683
3/19/2015,2,12402,1047,3615,261,0,154,17479
3/19/2015,3,12402,1109,3599,212,0,147,17469
3/19/2015,4,12391,1212,3665,177,0,144,17589
3/19/2015,5,12392,1440,3857,171,0,141,18001
3/19/2015,6,12397,1998,4330,166,0,155,19046
3/19/2015,7,12398,1990,4740,223,0,145,19496
3/19/2015,8,12394,1871,4925,237,0,108,19535
3/19/2015,9,12392,1827,4683,146,0,99,19147
3/19/2015,10,12388,1819,4495,132,0,56,18890
3/19/2015,11,12389,1815,4314,124,0,43,18685
3/19/2015,12,12392,1295,4512,138,0,44,18381
3/19/2015,13,12392,1031,4502,185,0,42,18152
3/19/2015,14,12377,942,4236,217,0,40,17812
3/19/2015,15,12380,1072,4076,244,0,39,17811
3/19/2015,16,12390,1297,4100,275,0,59,18121
3/19/2015,17,12397,1521,4409,294,0,89,18710
3/19/2015,18,12391,1524,4577,280,0,91,18863
3/19/2015,19,12392,1528,4878,349,0,92,19239
3/19/2015,20,12392,1531,4950,424,0,90,19387
3/19/2015,21,12386,1581,4892,540,0,102,19501
3/19/2015,22,12388,1554,4132,774,0,104,18952
3/19/2015,23,12398,1237,3585,1082,0,76,18378
3/19/2015,24,12389,962,3210,992,0,75,17628
3/20/2015,1,12165,940,3114,946,0,100,17265
3/20/2015,2,12096,943,3021,874,0,62,16996
3/20/2015,3,12096,943,3067,537,0,22,16665
3/20/2015,4,12103,951,3370,520,0,23,16967
3/20/2015,5,12256,1041,3963,324,0,28,17612
3/20/2015,6,12424,1255,4242,257,0,32,18210
3/20/2015,7,12428,1347,4643,248,0,37,18703
3/20/2015,8,12425,1421,5291,203,0,37,19377
3/20/2015,9,12411,1302,5206,103,0,37,19059
3/20/2015,10,12411,1252,5075,68,0,37,18843
3/20/2015,11,12415,1249,4695,87,0,37,18483
3/20/2015,12,12415,1333,4308,160,0,37,18253
3/20/2015,13,12421,1016,4156,229,0,37,17859
3/20/2015,14,12411,933,4066,260,0,37,17707
3/20/2015,15,12406,937,3932,309,0,37,17621
3/20/2015,16,12413,942,4051,373,0,38,17817
3/20/2015,17,12410,943,4083,540,0,38,18014
3/20/2015,18,12412,951,4361,657,0,38,18419
3/20/2015,19,12414,958,4501,851,0,39,18763
3/20/2015,20,12415,963,4634,1100,0,39,19151
3/20/2015,21,12398,963,4121,1209,0,39,18730
3/20/2015,22,12403,966,3388,1309,0,39,18105
3/20/2015,23,12376,967,2943,1310,0,28,17624
3/20/2015,24,12053,974,2911,1195,0,9,17142
3/21/2015,1,11803,974,2573,1450,0,6,16806
3/21/2015,2,11808,972,2468,1655,0,7,16910
3/21/2015,3,11805,971,2430,1515,0,7,16728
3/21/2015,4,11814,973,2400,1577,0,6,16770
3/21/2015,5,11828,973,2428,1563,0,6,16798
3/21/2015,6,11774,971,2562,1652,0,6,16965
3/21/2015,7,11731,973,2924,1875,0,6,17509
3/21/2015,8,11726,974,3524,2016,0,6,18246
3/21/2015,9,12002,905,3661,2226,0,6,18800
3/21/2015,10,12361,897,3765,2137,0,7,19167
3/21/2015,11,12370,920,3827,2166,0,7,19290
3/21/2015,12,12372,918,3843,2025,0,7,19165
3/21/2015,13,12372,918,3431,1956,0,7,18684
3/21/2015,14,12275,945,3304,1466,0,8,17998
3/21/2015,15,12076,947,3280,1505,0,6,17814
3/21/2015,16,12077,974,3322,1284,0,6,17663
3/21/2015,17,12150,1117,3369,1494,0,6,18136
3/21/2015,18,12416,1154,3478,1530,0,7,18585
3/21/2015,19,12437,1159,4211,1360,0,6,19173
3/21/2015,20,12439,1164,4358,1489,0,6,19456
3/21/2015,21,12431,1163,4213,1457,0,6,19270
3/21/2015,22,12381,1165,3628,1371,0,7,18552
3/21/2015,23,12423,1160,3116,1185,0,7,17891
3/21/2015,24,12424,1132,2900,1061,0,6,17523
3/22/2015,1,12289,1154,2638,1066,0,6,17153
3/22/2015,2,12135,1167,2494,1115,0,6,16917
3/22/2015,3,12140,1172,2469,1125,0,6,16912
3/22/2015,4,12140,1174,2492,1122,0,6,16934
3/22/2015,5,12149,1170,2641,1161,0,6,17127
3/22/2015,6,12231,1178,3457,772,0,6,17644
3/22/2015,7,12389,1174,3699,545,0,6,17813
3/22/2015,8,12384,1172,4218,392,0,6,18172
3/22/2015,9,12385,1154,4573,307,0,7,18426
3/22/2015,10,12383,1142,4428,244,0,6,18203
3/22/2015,11,12385,1121,4227,340,0,6,18079
3/22/2015,12,12388,1117,4184,461,0,6,18156
3/22/2015,13,12444,1127,3777,608,0,6,17962
3/22/2015,14,12463,1224,3416,730,0,6,17839
3/22/2015,15,12461,1216,3342,918,0,6,17943
3/22/2015,16,12459,1291,3619,1006,0,15,18390
3/22/2015,17,12459,1518,4233,879,0,42,19131
3/22/2015,18,12458,1602,4455,794,0,100,19409
3/22/2015,19,12459,1688,5140,714,0,145,20146
3/22/2015,20,12452,1812,5227,449,0,68,20008
3/22/2015,21,12447,1736,4987,307,0,76,19553
3/22/2015,22,12432,1575,4095,304,0,30,18436
3/22/2015,23,12433,1291,3987,334,0,6,18051
3/22/2015,24,12435,1180,3685,295,0,6,17601
3/23/2015,1,12435,1257,3605,277,0,6,17580
3/23/2015,2,12444,1170,3268,265,0,21,17168
3/23/2015,3,12446,1341,3357,290,0,23,17457
3/23/2015,4,12450,1502,3165,302,0,23,17442
3/23/2015,5,12441,1902,3893,274,0,25,18535
3/23/2015,6,12442,2405,4204,369,0,29,19449
3/23/2015,7,12450,2831,4775,508,0,35,20599
3/23/2015,8,12449,2720,5296,500,0,37,21002
3/23/2015,9,12453,2351,5173,412,0,37,20426
3/23/2015,10,12452,2195,4900,348,0,38,19933
3/23/2015,11,12451,2172,4630,291,0,57,19601
3/23/2015,12,12458,1951,4651,242,0,104,19406
3/23/2015,13,12464,2017,4071,262,0,179,18993
3/23/2015,14,12467,2163,3931,204,0,233,18998
3/23/2015,15,12469,1930,4046,162,0,232,18839
3/23/2015,16,12465,2236,4127,147,0,226,19201
3/23/2015,17,12460,2417,4222,148,0,231,19478
3/23/2015,18,12465,2351,4787,179,0,230,20012
3/23/2015,19,12464,2437,5413,195,0,226,20735
3/23/2015,20,12462,3020,5504,157,0,230,21373
3/23/2015,21,12456,2681,5499,166,0,224,21026
3/23/2015,22,12450,2182,4864,156,0,233,19885
3/23/2015,23,12456,2087,4218,184,0,201,19146
3/23/2015,24,12454,1520,3884,260,0,108,18226
3/24/2015,1,12456,1270,3653,280,0,31,17690
3/24/2015,2,12458,1379,3395,257,0,20,17509
3/24/2015,3,12454,1596,3375,200,0,24,17649
3/24/2015,4,12463,2061,3388,144,0,27,18083
3/24/2015,5,12460,2459,3730,163,0,26,18838
3/24/2015,6,12455,3016,4473,170,0,32,20146
3/24/2015,7,12455,3508,5346,139,0,39,21487
3/24/2015,8,12453,3131,5290,122,0,41,21037
3/24/2015,9,12458,2885,4617,114,0,50,20124
3/24/2015,10,12456,2114,4577,116,0,66,19329
3/24/2015,11,12456,2045,4341,98,0,62,19002
3/24/2015,12,12461,1987,3982,87,0,59,18576
3/24/2015,13,12466,1970,3735,98,0,58,18327
3/24/2015,14,12466,1859,3738,136,0,53,18252
3/24/2015,15,12462,1772,3609,181,0,50,18074
3/24/2015,16,12463,1720,4013,206,0,53,18455
3/24/2015,17,12459,1897,4181,231,0,58,18826
3/24/2015,18,12461,1920,4365,235,0,59,19040
3/24/2015,19,12457,1802,5165,282,0,58,19764
3/24/2015,20,12454,2238,5261,436,0,65,20454
3/24/2015,21,12454,1791,4633,715,0,60,19653
3/24/2015,22,12456,1669,3551,1051,0,41,18768
3/24/2015,23,12455,1286,2904,1387,0,23,18055
3/24/2015,24,12456,1031,2677,1423,0,17,17604
3/25/2015,1,12458,970,2476,1416,N/A,17,17337
3/25/2015,2,12456,975,2517,1415,N/A,19,17382
3/25/2015,3,12449,975,2541,1429,N/A,19,17413
3/25/2015,4,12446,984,2511,1620,N/A,20,17581
3/25/2015,5,12453,943,2667,1769,N/A,34,17866
3/25/2015,6,12458,1044,3622,2098,N/A,41,19263
3/25/2015,7,12463,993,4198,2231,N/A,55,19940
3/25/2015,8,12465,961,4034,2167,N/A,53,19680
3/25/2015,9,12461,948,4003,1782,N/A,50,19244
3/25/2015,10,12461,953,3659,2014,0,48,19135
3/25/2015,11,12457,947,3478,2260,0,41,19183
3/25/2015,12,12455,943,3538,2423,0,50,19409
3/25/2015,13,12342,964,3858,2359,0,51,19574
3/25/2015,14,12342,944,3780,2331,0,49,19446
3/25/2015,15,12468,940,3676,2464,0,39,19587
3/25/2015,16,12476,943,3975,2446,0,37,19877
3/25/2015,17,12477,943,3870,2559,0,41,19890
3/25/2015,18,12479,941,3679,2563,0,39,19701
3/25/2015,19,12477,944,4199,2125,0,37,19782
3/25/2015,20,12479,944,4392,2231,0,37,20083
3/25/2015,21,12471,943,4093,2221,0,39,19767
3/25/2015,22,12468,942,3262,1686,0,37,18395
3/25/2015,23,12465,945,2699,1820,0,37,17966
3/25/2015,24,12473,950,2618,1381,0,28,17450
3/26/2015,1,12472,952,2396,1300,0,23,17143
3/26/2015,2,12470,953,2419,1254,0,23,17119
3/26/2015,3,12464,955,2476,1106,0,21,17022
3/26/2015,4,12467,956,2673,854,0,22,16972
3/26/2015,5,12478,957,3310,573,0,26,17344
3/26/2015,6,12478,988,4293,456,0,31,18246
3/26/2015,7,12477,1059,4973,315,0,41,18865
3/26/2015,8,12476,1075,5169,224,0,55,18999
3/26/2015,9,12466,1122,5256,201,0,100,19145
3/26/2015,10,12469,1039,4848,193,0,159,18708
3/26/2015,11,12478,1041,4661,242,0,204,18626
3/26/2015,12,12469,990,4586,242,0,222,18509
3/26/2015,13,12466,1051,4544,230,0,222,18513
3/26/2015,14,12472,1059,4361,255,0,177,18324
3/26/2015,15,12471,953,4248,311,0,160,18143
3/26/2015,16,12468,983,4276,343,0,192,18262
3/26/2015,17,12474,1009,4270,432,0,185,18370
3/26/2015,18,12470,1007,4282,453,0,146,18358
3/26/2015,19,12472,1021,4472,546,0,95,18606
3/26/2015,20,12474,1034,4524,660,0,95,18787
3/26/2015,21,12463,1055,4391,765,0,156,18830
3/26/2015,22,12462,1109,3771,1006,0,223,18571
3/26/2015,23,12461,1054,3205,1082,0,149,17951
3/26/2015,24,12468,1025,2713,1197,0,41,17444
3/27/2015,1,12462,964,2430,1172,0,26,17054
3/27/2015,2,12468,965,2307,1200,0,25,16965
3/27/2015,3,12461,967,2367,1242,0,20,17057
3/27/2015,4,12466,967,2435,1216,0,20,17104
3/27/2015,5,12466,966,2639,1409,0,25,17505
3/27/2015,6,12469,968,3412,1249,1,31,18130
3/27/2015,7,12478,963,4103,1395,1,36,18976
3/27/2015,8,12489,968,4291,1545,3,36,19332
3/27/2015,9,12485,967,4656,1455,7,36,19606
3/27/2015,10,12484,970,4656,1427,10,38,19585
3/27/2015,11,12483,969,4546,1396,14,35,19443
3/27/2015,12,12489,970,4217,1546,22,36,19280
3/27/2015,13,12351,967,4003,1604,10,65,19000
3/27/2015,14,12439,968,3685,1686,15,95,18888
3/27/2015,15,12488,966,3425,1817,36,91,18823
3/27/2015,16,12493,970,3543,1897,39,89,19031
3/27/2015,17,12489,968,3799,1931,19,88,19294
3/27/2015,18,12491,968,3530,1917,8,89,19003
3/27/2015,19,12493,973,4553,1774,1,123,19917
3/27/2015,20,12488,979,5247,1546,0,184,20444
3/27/2015,21,12505,1026,5053,1321,0,165,20070
3/27/2015,22,12223,1043,4379,1192,0,213,19050
3/27/2015,23,11649,948,4327,1062,0,197,18183
3/27/2015,24,11651,940,3870,894,0,115,17470
3/28/2015,1,11646,917,3872,817,0,20,17272
3/28/2015,2,11643,916,3583,721,0,4,16867
3/28/2015,3,11643,965,3533,750,0,3,16894
3/28/2015,4,11642,1031,3264,768,0,3,16708
3/28/2015,5,11646,1011,3331,900,0,3,16891
3/28/2015,6,11646,956,3331,968,0,3,16904
3/28/2015,7,11650,956,4017,920,3,3,17549
3/28/2015,8,11647,964,4232,849,28,3,17723
3/28/2015,9,11643,964,4189,1051,63,3,17913
3/28/2015,10,11646,984,3693,1140,90,3,17556
3/28/2015,11,11650,1035,3818,1156,95,3,17757
3/28/2015,12,11648,1048,3894,1141,95,3,17829
3/28/2015,13,11644,1123,4009,1083,95,4,17958
3/28/2015,14,11642,1202,3825,980,95,4,17748
3/28/2015,15,11650,1318,3565,948,94,3,17578
3/28/2015,16,11650,1467,3507,927,86,3,17640
3/28/2015,17,11645,1528,3797,822,58,4,17854
3/28/2015,18,11643,1671,4298,646,23,6,18287
3/28/2015,19,11639,1840,4825,439,2,6,18751
3/28/2015,20,11640,2071,5140,410,0,6,19267
3/28/2015,21,11634,2009,5007,367,0,3,19020
3/28/2015,22,11632,1941,4405,353,0,3,18334
3/28/2015,23,11631,1867,3627,414,0,3,17542
3/28/2015,24,11620,1210,3348,568,0,3,16749
3/29/2015,1,11616,1108,3093,803,0,3,16623
3/29/2015,2,11626,1011,3049,966,0,4,16656
3/29/2015,3,11633,906,3193,1058,0,3,16793
3/29/2015,4,11631,903,3134,1163,0,3,16834
3/29/2015,5,11635,907,3263,1204,0,3,17012
3/29/2015,6,11643,915,3463,1305,0,3,17329
3/29/2015,7,11644,840,3381,1416,4,3,17288
3/29/2015,8,11637,824,3811,1320,30,4,17626
3/29/2015,9,11640,836,3781,1343,63,3,17666
3/29/2015,10,11645,842,3746,1565,90,3,17891
3/29/2015,11,11648,838,3821,1384,95,3,17789
3/29/2015,12,11653,829,3612,1538,95,2,17729
3/29/2015,13,11647,801,3388,1894,95,3,17828
3/29/2015,14,11641,817,3335,1828,94,3,17718
3/29/2015,15,11649,824,3409,1759,91,3,17735
3/29/2015,16,11659,833,3350,2293,64,3,18202
3/29/2015,17,11659,839,3785,2538,26,3,18850
3/29/2015,18,11659,848,4045,2636,8,3,19199
3/29/2015,19,11656,855,4029,2649,1,4,19194
3/29/2015,20,11652,871,4213,2493,0,4,19233
3/29/2015,21,11654,853,4108,2488,0,4,19107
3/29/2015,22,11629,828,3410,2568,0,4,18439
3/29/2015,23,11625,834,3071,2196,0,3,17729
3/29/2015,24,11628,855,2821,2038,0,6,17348
3/30/2015,1,11629,855,2568,2197,0,19,17268
3/30/2015,2,11631,855,2441,2326,0,21,17274
3/30/2015,3,11634,855,2434,2261,0,21,17205
3/30/2015,4,11638,853,2481,2069,0,22,17063
3/30/2015,5,11635,854,2909,2194,0,24,17616
3/30/2015,6,11639,855,3661,2401,0,34,18590
3/30/2015,7,11640,868,4303,2406,0,36,19253
3/30/2015,8,11634,882,4460,2408,5,36,19425
3/30/2015,9,11626,892,4449,2415,11,36,19429
3/30/2015,10,11624,862,4414,2275,13,36,19224
3/30/2015,11,11632,876,4258,1861,41,36,18704
3/30/2015,12,11642,884,3832,2422,48,35,18863
3/30/2015,13,11642,898,3896,2379,26,35,18876
3/30/2015,14,11644,900,3644,2269,37,36,18530
3/30/2015,15,11648,920,3704,2038,35,35,18380
3/30/2015,16,11649,1041,3740,2039,63,35,18567
3/30/2015,17,11658,1080,4203,1875,34,36,18886
3/30/2015,18,11687,1103,4414,1567,23,35,18829
3/30/2015,19,11885,1141,4988,1257,2,35,19308
3/30/2015,20,12047,1153,5475,963,0,34,19672
3/30/2015,21,12266,1145,5053,670,0,34,19168
3/30/2015,22,12321,1146,4446,388,0,35,18336
3/30/2015,23,12327,984,4217,318,0,29,17875
3/30/2015,24,12301,964,3760,309,0,22,17356
3/31/2015,1,12310,957,3151,446,0,20,16884
3/31/2015,2,12311,964,2803,583,0,21,16682
3/31/2015,3,12356,965,2545,622,0,21,16509
3/31/2015,4,12424,964,2567,701,0,23,16679
3/31/2015,5,12428,966,3131,735,0,24,17284
3/31/2015,6,12432,963,3714,859,0,26,17994
3/31/2015,7,12434,946,4299,1021,0,26,18726
3/31/2015,8,12434,929,4373,941,3,26,18706
3/31/2015,9,12433,920,4342,881,10,28,18614
3/31/2015,10,12429,912,4512,803,20,30,18706
3/31/2015,11,12435,857,4413,591,31,27,18354
3/31/2015,12,12461,821,4245,337,23,29,17916
3/31/2015,13,12462,835,3999,336,46,27,17705
3/31/2015,14,12473,858,3453,397,85,27,17293
3/31/2015,15,12473,993,3215,462,93,29,17265
3/31/2015,16,12470,918,3740,411,41,27,17607
3/31/2015,17,12471,890,4229,328,23,25,17966
3/31/2015,18,12473,889,4394,230,12,23,18021
3/31/2015,19,12468,893,5023,161,2,23,18570
3/31/2015,20,12457,946,5612,174,0,23,19212
3/31/2015,21,12455,917,5058,231,0,23,18684
3/31/2015,22,12455,899,4267,251,0,24,17896
3/31/2015,23,12450,958,3765,286,0,23,17482
3/31/2015,24,12457,974,3322,278,0,22,17053
4/1/2015,1,12131,970,2938,210,0,22,16271
4/1/2015,2,10963,996,3366,223,0,23,15571
4/1/2015,3,10962,956,3259,330,0,23,15530
4/1/2015,4,10962,1020,3128,345,0,24,15479
4/1/2015,5,10964,1048,3560,339,0,23,15934
4/1/2015,6,10963,1205,4185,287,0,27,16667
4/1/2015,7,10965,1308,4792,243,3,35,17346
4/1/2015,8,10972,1257,4760,207,22,35,17253
4/1/2015,9,11663,1247,4142,126,22,35,17235
4/1/2015,10,12450,1169,3827,135,72,35,17688
4/1/2015,11,12428,1346,3487,143,97,36,17537
4/1/2015,12,12453,1353,3093,156,98,36,17189
4/1/2015,13,12468,1335,3271,172,98,36,17380
4/1/2015,14,12461,1271,3350,199,97,41,17419
4/1/2015,15,12464,1158,3460,174,96,42,17394
4/1/2015,16,12462,1127,3665,231,85,35,17605
4/1/2015,17,12471,1125,3817,356,55,35,17859
4/1/2015,18,12468,1127,3998,456,22,40,18111
4/1/2015,19,12470,1134,4231,614,2,42,18493
4/1/2015,20,12469,1129,4179,1051,0,49,18877
4/1/2015,21,12461,954,3908,1371,0,38,18732
4/1/2015,22,12453,945,3345,1322,0,35,18100
4/1/2015,23,12313,940,2921,1611,0,24,17809
4/1/2015,24,12158,934,2682,1848,0,22,17644
4/2/2015,1,12156,934,2553,1585,0,21,17249
4/2/2015,2,12156,930,2473,1473,0,21,17053
4/2/2015,3,12142,932,2351,1175,0,22,16622
4/2/2015,4,11928,932,2360,1748,0,22,16990
4/2/2015,5,11856,931,2613,1930,0,27,17357
4/2/2015,6,11920,930,2943,2241,1,29,18064
4/2/2015,7,12360,934,3606,2408,4,35,19347
4/2/2015,8,12471,940,4164,2126,29,35,19765
4/2/2015,9,12471,936,3927,1865,64,35,19298
4/2/2015,10,12473,935,3820,1602,87,35,18952
4/2/2015,11,12474,928,3754,1634,94,35,18919
4/2/2015,12,12226,922,3691,1828,42,35,18744
4/2/2015,13,12177,916,3240,2294,65,35,18727
4/2/2015,14,12177,921,3351,2565,40,35,19089
4/2/2015,15,12178,921,3137,1153,32,35,17456
4/2/2015,16,12170,928,3124,2554,10,35,18821
4/2/2015,17,12289,926,3526,2664,9,35,19449
4/2/2015,18,12472,926,3734,2275,3,35,19445
4/2/2015,19,12475,926,4143,1740,0,35,19319
4/2/2015,20,12469,918,4163,1645,0,35,19230
4/2/2015,21,12464,917,4135,1792,0,35,19343
4/2/2015,22,12453,905,3452,1469,0,35,18314
4/2/2015,23,12459,686,3056,1201,0,12,17414
4/2/2015,24,12457,639,2655,1140,0,2,16893
4/3/2015,1,12459,640,2382,929,0,1,16411
4/3/2015,2,12461,639,2445,692,0,1,16238
4/3/2015,3,12457,642,2529,737,0,1,16366
4/3/2015,4,12460,646,2405,793,0,1,16305
4/3/2015,5,12461,645,2453,954,0,5,16518
4/3/2015,6,12462,600,2599,766,0,8,16435
4/3/2015,7,12463,597,2805,811,0,21,16697
4/3/2015,8,12462,605,3349,895,4,29,17344
4/3/2015,9,12457,607,3699,543,18,32,17356
4/3/2015,10,12456,608,3597,343,17,34,17055
4/3/2015,11,12457,609,3652,420,26,37,17201
4/3/2015,12,12459,608,3528,466,40,29,17130
4/3/2015,13,12463,662,3553,502,55,21,17256
4/3/2015,14,12466,671,3081,641,40,16,16915
4/3/2015,15,12463,672,3347,562,31,3,17078
4/3/2015,16,12479,673,3331,831,23,1,17338
4/3/2015,17,12476,672,4005,740,11,1,17905
4/3/2015,18,12476,675,4351,663,1,1,18167
4/3/2015,19,12475,675,4309,596,0,1,18056
4/3/2015,20,12471,678,4320,807,0,1,18277
4/3/2015,21,12475,678,4010,706,0,1,17870
4/3/2015,22,12447,677,3554,905,0,1,17584
4/3/2015,23,12218,678,2987,1055,0,1,16939
4/3/2015,24,11897,678,2608,1255,0,1,16439
4/4/2015,1,11624,681,2697,1360,0,1,16363
4/4/2015,2,11594,680,2376,1082,0,1,15733
4/4/2015,3,11590,627,2438,1636,0,1,16292
4/4/2015,4,11585,627,2468,1566,0,1,16247
4/4/2015,5,11588,631,2510,1756,0,1,16486
4/4/2015,6,11589,630,2880,1431,0,1,16531
4/4/2015,7,11736,629,3466,1213,4,1,17049
4/4/2015,8,12085,631,3759,1007,31,1,17514
4/4/2015,9,12146,633,3739,785,66,1,17370
4/4/2015,10,12152,630,3739,714,87,1,17323
4/4/2015,11,12154,629,3580,686,80,1,17130
4/4/2015,12,12152,640,3304,860,73,1,17030
4/4/2015,13,12123,638,3256,1085,84,1,17187
4/4/2015,14,12156,638,2965,1319,92,1,17171
4/4/2015,15,12157,637,2914,1326,76,1,17111
4/4/2015,16,12249,638,2986,1486,72,1,17432
4/4/2015,17,12447,635,3154,1621,38,1,17896
4/4/2015,18,12442,631,3385,1711,18,1,18188
4/4/2015,19,12440,636,3932,1408,3,2,18421
4/4/2015,20,12430,642,4187,1369,0,3,18631
4/4/2015,21,12424,644,4180,1251,0,1,18500
4/4/2015,22,12419,647,3782,1205,0,1,18054
4/4/2015,23,12432,679,3050,1004,0,1,17166
4/4/2015,24,12436,707,2627,881,0,1,16652
4/5/2015,1,12442,689,2751,740,0,1,16623
4/5/2015,2,12442,640,2682,561,0,2,16327
4/5/2015,3,12444,673,2499,428,0,1,16045
4/5/2015,4,12436,698,2627,322,0,1,16084
4/5/2015,5,12170,699,2751,214,0,2,15836
4/5/2015,6,12140,703,2697,307,0,1,15848
4/5/2015,7,12137,701,3016,295,1,1,16151
4/5/2015,8,12116,701,3694,253,2,1,16767
4/5/2015,9,12288,701,3966,163,5,1,17124
4/5/2015,10,12438,700,3948,163,6,1,17256
4/5/2015,11,12436,694,3526,214,6,1,16877
4/5/2015,12,12437,694,3433,253,12,1,16830
4/5/2015,13,12430,694,3223,353,22,1,16723
4/5/2015,14,12397,695,3096,499,22,1,16710
4/5/2015,15,12443,695,3087,412,28,2,16667
4/5/2015,16,12442,695,3415,360,25,3,16940
4/5/2015,17,12438,696,3436,326,8,3,16907
4/5/2015,18,12432,704,3595,84,5,3,16823
4/5/2015,19,12180,726,3902,377,0,3,17188
4/5/2015,20,12139,762,4195,554,0,3,17653
4/5/2015,21,12136,817,4159,676,0,3,17791
4/5/2015,22,12117,813,3877,906,0,3,17716
4/5/2015,23,12100,808,3329,1054,0,3,17294
4/5/2015,24,12090,813,2644,945,0,3,16495
4/6/2015,1,12095,821,2480,649,0,3,16048
4/6/2015,2,12090,823,2574,885,0,10,16382
4/6/2015,3,12083,819,2608,917,0,18,16445
4/6/2015,4,12068,811,2552,915,0,22,16368
4/6/2015,5,12071,822,2668,764,0,21,16346
4/6/2015,6,12145,826,3350,789,0,23,17133
4/6/2015,7,12371,868,3554,675,4,27,17499
4/6/2015,8,12365,898,4194,561,29,28,18075
4/6/2015,9,12363,915,4306,409,63,26,18082
4/6/2015,10,12367,897,4398,323,87,1,18073
4/6/2015,11,12367,908,4246,273,86,1,17881
4/6/2015,12,12368,935,3978,297,80,9,17667
4/6/2015,13,12368,953,3975,232,64,15,17607
4/6/2015,14,12369,1004,3679,223,18,47,17340
4/6/2015,15,12362,1048,3525,289,15,56,17295
4/6/2015,16,12366,1187,3678,367,7,55,17660
4/6/2015,17,12373,1300,3806,482,4,51,18016
4/6/2015,18,12373,1301,3961,414,1,54,18104
4/6/2015,19,12374,1304,4237,325,0,49,18289
4/6/2015,20,12368,1305,4540,414,0,40,18667
4/6/2015,21,12367,1168,4379,455,0,36,18405
4/6/2015,22,12366,950,3723,492,0,31,17562
4/6/2015,23,12363,913,3307,719,0,24,17326
4/6/2015,24,12365,913,2556,884,0,15,16733
4/7/2015,1,12366,916,2570,763,0,13,16628
4/7/2015,2,12361,915,2662,826,0,13,16777
4/7/2015,3,12357,924,2471,988,0,13,16753
4/7/2015,4,12360,927,2477,965,0,13,16742
4/7/2015,5,12363,927,2730,1075,0,17,17112
4/7/2015,6,12361,931,3473,1067,0,23,17855
4/7/2015,7,12365,941,4023,1361,1,29,18720
4/7/2015,8,12367,944,4081,1465,5,39,18901
4/7/2015,9,12370,950,3869,1443,24,42,18698
4/7/2015,10,12365,949,3915,1311,41,46,18627
4/7/2015,11,12369,949,3817,1108,65,45,18353
4/7/2015,12,12364,951,3550,1094,77,45,18081
4/7/2015,13,12371,980,3211,1285,67,35,17949
4/7/2015,14,12368,946,3025,1265,88,28,17720
4/7/2015,15,12371,942,3053,1430,78,28,17902
4/7/2015,16,12375,931,3367,1517,31,28,18249
4/7/2015,17,12378,922,3521,1825,12,29,18687
4/7/2015,18,12375,921,3763,1440,9,39,18547
4/7/2015,19,12374,924,4044,1562,1,41,18946
4/7/2015,20,12374,924,4369,1923,0,36,19626
4/7/2015,21,12372,926,4249,1870,0,30,19447
4/7/2015,22,12371,924,3596,1650,0,29,18570
4/7/2015,23,12373,920,2954,1679,0,27,17953
4/7/2015,24,12381,916,2479,1835,0,17,17628
4/8/2015,1,12371,916,2330,1932,0,14,17563
4/8/2015,2,12370,918,2273,1702,0,14,17277
4/8/2015,3,12388,917,2219,1740,0,14,17278
4/8/2015,4,12384,916,2298,1783,0,14,17395
4/8/2015,5,12388,916,2432,2157,0,21,17914
4/8/2015,6,12385,918,3137,2180,0,30,18650
4/8/2015,7,12376,919,3822,2474,0,32,19623
4/8/2015,8,12367,924,3958,2539,2,37,19827
4/8/2015,9,12366,1010,3878,2068,7,40,19369
4/8/2015,10,12361,1034,4608,1349,7,42,19401
4/8/2015,11,12360,1125,4684,1008,4,42,19223
4/8/2015,12,12356,1623,4456,861,6,43,19345
4/8/2015,13,12196,1886,4007,826,8,41,18964
4/8/2015,14,12321,1933,3855,612,6,29,18756
4/8/2015,15,12346,1983,3997,547,5,30,18908
4/8/2015,16,12348,2631,4253,659,7,34,19932
4/8/2015,17,12348,2487,4338,661,3,37,19874
4/8/2015,18,12387,1982,4540,697,2,42,19650
4/8/2015,19,12406,1771,4495,747,0,49,19468
4/8/2015,20,12266,1588,4828,763,0,48,19493
4/8/2015,21,11732,1232,4725,721,0,38,18448
4/8/2015,22,11592,1100,4504,720,0,36,17952
4/8/2015,23,11590,920,4051,747,0,24,17332
4/8/2015,24,11595,920,3396,799,0,20,16730
4/9/2015,1,11589,924,3361,842,0,21,16737
4/9/2015,2,11600,1044,3170,962,0,21,16797
4/9/2015,3,11601,1244,2974,1000,0,21,16840
4/9/2015,4,11606,1366,2792,1251,0,21,17036
4/9/2015,5,11607,1471,2798,1332,0,21,17229
4/9/2015,6,11602,1776,3481,1327,0,12,18198
4/9/2015,7,11608,2487,4143,1575,0,28,19841
4/9/2015,8,11607,2417,4119,1611,4,34,19792
4/9/2015,9,11604,2208,3980,1351,5,36,19184
4/9/2015,10,11602,2171,3752,1328,17,36,18906
4/9/2015,11,11598,2224,3675,1383,19,36,18935
4/9/2015,12,11594,2335,3473,1505,26,42,18975
4/9/2015,13,11593,2380,3451,1448,18,37,18927
4/9/2015,14,11592,2225,3257,1700,20,35,18829
4/9/2015,15,11593,1987,3232,1926,7,37,18782
4/9/2015,16,11595,2047,3311,2043,7,54,19057
4/9/2015,17,11594,1987,3356,2211,8,84,19240
4/9/2015,18,11596,1982,3524,2277,3,134,19516
4/9/2015,19,11596,1751,3575,2252,0,209,19383
4/9/2015,20,11587,1716,3830,2381,0,221,19735
4/9/2015,21,11588,1366,3724,2393,0,215,19286
4/9/2015,22,11592,949,3057,2330,0,218,18146
4/9/2015,23,11597,888,2680,2424,0,148,17737
4/9/2015,24,11598,916,2463,2036,0,30,17043
4/10/2015,1,11593,913,2439,1963,0,18,16926
4/10/2015,2,11605,911,2325,1936,0,20,16797
4/10/2015,3,11396,910,2212,1936,0,20,16474
4/10/2015,4,11324,908,2232,2154,0,19,16637
4/10/2015,5,11324,907,2310,1941,0,23,16505
4/10/2015,6,11323,908,2866,2022,0,28,17147
4/10/2015,7,11332,918,3752,2476,0,34,18512
4/10/2015,8,11323,920,4404,2692,5,29,19373
4/10/2015,9,11321,923,4384,2704,3,27,19362
4/10/2015,10,11310,920,4451,2724,18,27,19450
4/10/2015,11,11576,924,3808,2764,60,27,19159
4/10/2015,12,11615,925,3432,2753,75,28,18828
4/10/2015,13,11464,924,3424,2867,33,29,18741
4/10/2015,14,11438,923,3206,2599,45,31,18242
4/10/2015,15,11581,924,3196,2276,50,30,18057
4/10/2015,16,11616,923,3167,2551,38,30,18325
4/10/2015,17,11607,927,3706,2637,28,29,18934
4/10/2015,18,11603,926,3789,2440,19,29,18806
4/10/2015,19,11604,927,4236,1881,2,29,18679
4/10/2015,20,11603,927,4556,1559,0,28,18673
4/10/2015,21,11592,930,3879,1998,0,29,18428
4/10/2015,22,11603,917,3317,1530,0,31,17398
4/10/2015,23,11605,743,3005,1481,0,15,16849
4/10/2015,24,11613,722,2573,1616,0,1,16525
4/11/2015,1,11395,707,2436,1673,0,1,16212
4/11/2015,2,11141,688,2512,1990,0,1,16332
4/11/2015,3,11010,692,2682,1865,0,1,16250
4/11/2015,4,11008,686,2751,1614,0,1,16060
4/11/2015,5,11011,683,2932,1489,0,1,16116
4/11/2015,6,11018,683,3102,1505,0,1,16309
4/11/2015,7,11026,679,3517,1301,2,1,16526
4/11/2015,8,11032,676,3975,1154,28,1,16866
4/11/2015,9,11251,674,4290,998,46,1,17260
4/11/2015,10,11262,674,4259,997,38,1,17231
4/11/2015,11,11260,668,3666,1043,36,1,16674
4/11/2015,12,11263,663,3422,904,51,1,16304
4/11/2015,13,11263,661,3378,742,59,1,16104
4/11/2015,14,11276,658,3373,508,84,1,15900
4/11/2015,15,11321,661,3374,559,86,2,16003
4/11/2015,16,11319,659,3400,376,80,1,15835
4/11/2015,17,11319,656,3563,776,54,1,16369
4/11/2015,18,11324,659,3902,772,23,1,16681
4/11/2015,19,11422,659,4254,684,2,1,17022
4/11/2015,20,11626,662,4607,719,0,1,17615
4/11/2015,21,11630,663,4473,731,0,1,17498
4/11/2015,22,11627,666,3828,789,0,1,16911
4/11/2015,23,11626,670,3345,763,0,1,16405
4/11/2015,24,11536,673,3015,646,0,1,15871
4/12/2015,1,11267,671,2816,687,0,1,15442
4/12/2015,2,11097,674,2825,845,0,1,15442
4/12/2015,3,11093,675,3131,766,0,1,15666
4/12/2015,4,11093,675,3162,782,0,1,15713
4/12/2015,5,11096,673,3258,730,0,1,15758
4/12/2015,6,11096,675,3622,603,0,8,16004
4/12/2015,7,11078,675,3771,524,5,5,16058
4/12/2015,8,11071,669,3694,417,31,1,15883
4/12/2015,9,11085,666,3817,291,61,1,15921
4/12/2015,10,11093,664,4014,287,84,1,16143
4/12/2015,11,11095,667,4260,411,91,1,16525
4/12/2015,12,11094,664,4234,506,86,1,16585
4/12/2015,13,11095,662,4095,602,86,1,16541
4/12/2015,14,11093,662,3813,686,85,1,16340
4/12/2015,15,11093,656,3843,728,84,1,16405
4/12/2015,16,11094,658,4005,682,73,1,16513
4/12/2015,17,11089,658,4450,503,48,1,16749
4/12/2015,18,11091,661,4477,474,20,1,16724
4/12/2015,19,11097,664,4771,527,2,1,17062
4/12/2015,20,11094,858,4621,831,0,7,17411
4/12/2015,21,11205,944,3801,1019,0,10,16979
4/12/2015,22,11309,829,3615,1280,0,32,17065
4/12/2015,23,11335,676,3106,1332,0,39,16488
4/12/2015,24,11340,677,2691,1415,0,41,16164
4/13/2015,1,11340,681,2582,1237,0,43,15883
4/13/2015,2,11343,680,2514,1077,0,55,15669
4/13/2015,3,11346,682,2510,1027,0,52,15617
4/13/2015,4,11345,682,2437,1149,0,51,15664
4/13/2015,5,11347,698,2663,1256,0,53,16017
4/13/2015,6,11351,766,2947,1466,0,53,16583
4/13/2015,7,11544,871,3497,1699,2,48,17661
4/13/2015,8,11648,893,3764,1597,18,42,17962
4/13/2015,9,11642,890,4073,1327,46,43,18021
4/13/2015,10,11642,885,4089,1416,77,41,18150
4/13/2015,11,11652,879,4073,1931,82,32,18649
4/13/2015,12,11656,879,4006,1871,79,30,18521
4/13/2015,13,11656,866,3624,2547,79,30,18802
4/13/2015,14,11660,863,3418,2677,67,30,18715
4/13/2015,15,11662,864,3436,2341,80,31,18414
4/13/2015,16,11650,863,3548,2484,64,29,18638
4/13/2015,17,11653,867,3858,2378,11,30,18797
4/13/2015,18,11662,873,3827,1514,0,29,17905
4/13/2015,19,11659,875,3976,1755,0,28,18293
4/13/2015,20,11646,882,4008,1687,0,29,18252
4/13/2015,21,11639,884,4091,1525,0,29,18168
4/13/2015,22,11642,884,3877,829,0,30,17262
4/13/2015,23,11639,860,3704,528,0,20,16751
4/13/2015,24,11641,859,3112,445,0,14,16071
4/14/2015,1,11333,856,2458,486,0,23,15156
4/14/2015,2,10790,836,2379,373,0,22,14400
4/14/2015,3,10497,838,2358,875,0,23,14591
4/14/2015,4,10615,837,2792,1002,0,23,15269
4/14/2015,5,11093,839,3085,969,0,26,16012
4/14/2015,6,11419,851,3507,835,0,34,16646
4/14/2015,7,11652,854,3942,545,6,43,17042
4/14/2015,8,11648,862,4883,336,31,53,17813
4/14/2015,9,11649,880,4432,192,36,99,17288
4/14/2015,10,11614,875,4169,169,65,187,17079
4/14/2015,11,11353,873,4175,234,83,221,16939
4/14/2015,12,11344,918,4051,270,77,225,16885
4/14/2015,13,11339,1007,4292,328,67,222,17255
4/14/2015,14,11338,921,4216,413,64,218,17170
4/14/2015,15,11048,937,4522,459,45,223,17234
4/14/2015,16,10678,1046,5098,474,33,226,17555
4/14/2015,17,10749,933,4575,520,33,223,17033
4/14/2015,18,10751,912,4362,482,33,207,16747
4/14/2015,19,10757,925,4704,448,33,149,17016
4/14/2015,20,10754,953,4991,399,33,51,17181
4/14/2015,21,10757,999,4991,332,33,35,17147
4/14/2015,22,10750,913,4378,334,33,28,16436
4/14/2015,23,10749,899,3686,387,33,19,15773
4/14/2015,24,10755,929,3085,213,33,15,15030
4/15/2015,1,10616,937,2966,418,33,15,14985
4/15/2015,2,10455,936,3478,465,33,13,15380
4/15/2015,3,10459,969,3518,560,33,15,15554
4/15/2015,4,10456,979,3179,702,33,16,15365
4/15/2015,5,10461,979,3205,741,2,16,15404
4/15/2015,6,10597,982,3798,830,0,20,16227
4/15/2015,7,10759,995,4151,589,0,28,16522
4/15/2015,8,10566,1011,4274,364,0,49,16264
4/15/2015,9,9947,1046,4659,416,0,89,16157
4/15/2015,10,9944,1106,4565,382,0,190,16187
4/15/2015,11,9753,1136,4233,450,71,216,15859
4/15/2015,12,9112,1180,4327,560,83,215,15477
4/15/2015,13,9110,1203,4554,496,80,224,15667
4/15/2015,14,8927,1278,4170,476,78,215,15144
4/15/2015,15,8283,1401,4483,705,76,206,15154
4/15/2015,16,8284,1450,4529,799,62,201,15325
4/15/2015,17,8284,1544,4925,825,38,201,15817
4/15/2015,18,8281,1528,5034,846,19,210,15918
4/15/2015,19,8280,1564,5349,712,3,145,16053
4/15/2015,20,8278,1714,5475,778,0,56,16301
4/15/2015,21,8269,1762,5335,978,0,35,16379
4/15/2015,22,8261,1443,4888,1304,0,31,15927
4/15/2015,23,8271,1314,4153,1588,0,23,15349
4/15/2015,24,8274,1314,3627,1302,0,18,14535
4/16/2015,1,8280,985,3359,1820,0,17,14461
4/16/2015,2,8281,921,3240,1644,0,17,14103
4/16/2015,3,8275,929,3266,1692,0,18,14180
4/16/2015,4,8278,935,3357,1998,0,20,14588
4/16/2015,5,8273,930,3593,1998,0,20,14814
4/16/2015,6,8275,932,4304,1962,0,26,15499
4/16/2015,7,8277,936,4632,2003,5,30,15883
4/16/2015,8,8274,936,4889,1930,24,49,16102
4/16/2015,9,8273,932,4937,1635,44,97,15918
4/16/2015,10,8274,935,5102,1394,62,129,15896
4/16/2015,11,8275,1062,5218,1126,67,130,15878
4/16/2015,12,8275,1078,4987,1072,74,198,15684
4/16/2015,13,8273,1127,4526,1391,76,223,15616
4/16/2015,14,8274,1318,4115,1284,41,224,15256
4/16/2015,15,8279,1476,4155,1227,17,225,15379
4/16/2015,16,8272,1650,4704,1137,22,222,16007
4/16/2015,17,8275,1815,4824,1362,11,223,16510
4/16/2015,18,8285,1723,5107,1222,2,223,16562
4/16/2015,19,8285,1734,5059,987,1,220,16286
4/16/2015,20,8282,1782,5259,928,0,165,16416
4/16/2015,21,8282,1736,5260,1021,0,50,16349
4/16/2015,22,8286,1582,4865,904,0,32,15669
4/16/2015,23,8290,1058,4731,955,0,25,15059
4/16/2015,24,8293,946,4642,975,0,19,14875
4/17/2015,1,8293,929,4356,917,0,18,14513
4/17/2015,2,8292,934,4127,782,0,19,14154
4/17/2015,3,8295,941,4006,695,0,19,13956
4/17/2015,4,8285,945,4177,640,0,19,14066
4/17/2015,5,8362,973,4581,494,0,20,14430
4/17/2015,6,8468,1128,4954,350,0,25,14925
4/17/2015,7,8468,1248,4993,402,0,30,15141
4/17/2015,8,8469,1202,5117,345,0,31,15164
4/17/2015,9,8467,1209,5226,260,38,32,15232
4/17/2015,10,8463,1315,5037,138,60,33,15046
4/17/2015,11,8419,1262,5012,147,84,33,14957
4/17/2015,12,8277,1284,4977,172,88,32,14830
4/17/2015,13,8163,1323,4914,279,89,32,14800
4/17/2015,14,8276,1283,4610,489,94,32,14784
4/17/2015,15,8279,1574,4413,272,94,32,14664
4/17/2015,16,8277,1886,4425,575,94,32,15289
4/17/2015,17,8282,1951,4470,638,94,32,15467
4/17/2015,18,8279,1921,4688,627,17,32,15564
4/17/2015,19,8284,1924,4792,548,2,32,15582
4/17/2015,20,8281,1933,5176,524,0,32,15946
4/17/2015,21,8281,1972,5166,600,0,32,16051
4/17/2015,22,8274,1599,4734,663,0,31,15301
4/17/2015,23,8276,1305,4421,766,0,10,14778
4/17/2015,24,8294,1277,3949,927,0,1,14448
4/18/2015,1,8590,966,3601,850,0,1,14008
4/18/2015,2,8727,877,3314,821,0,1,13740
4/18/2015,3,8725,879,3140,814,0,1,13559
4/18/2015,4,8496,879,3158,777,0,1,13311
4/18/2015,5,8334,879,3528,934,0,1,13676
4/18/2015,6,8335,878,3541,1065,0,1,13820
4/18/2015,7,8338,879,4197,1108,0,1,14523
4/18/2015,8,8339,853,4982,985,0,1,15160
4/18/2015,9,8340,835,5126,1108,0,2,15411
4/18/2015,10,8347,837,5108,1265,0,1,15558
4/18/2015,11,8613,817,4720,1591,0,1,15742
4/18/2015,12,8634,853,4507,1477,90,2,15563
4/18/2015,13,8705,875,4232,1413,94,2,15321
4/18/2015,14,8726,875,4064,1453,95,1,15214
4/18/2015,15,8737,872,4050,1565,85,1,15310
4/18/2015,16,8901,872,4081,1304,79,1,15238
4/18/2015,17,9039,875,4206,1218,56,2,15396
4/18/2015,18,9092,878,4412,1239,25,2,15648
4/18/2015,19,9117,882,4586,1131,3,1,15720
4/18/2015,20,9119,885,5164,1040,0,1,16209
4/18/2015,21,9113,888,4883,1253,0,1,16138
4/18/2015,22,9111,888,4062,1300,0,1,15362
4/18/2015,23,9115,883,3927,1197,0,1,15123
4/18/2015,24,8958,890,3722,993,0,1,14564
4/19/2015,1,8539,888,3384,1594,0,1,14406
4/19/2015,2,8520,888,3096,1680,0,1,14185
4/19/2015,3,8517,887,3008,1908,0,1,14321
4/19/2015,4,8521,888,3005,2097,0,1,14512
4/19/2015,5,8519,837,2983,2285,0,1,14625
4/19/2015,6,8519,838,2997,2442,0,1,14797
4/19/2015,7,8513,837,3305,2451,7,1,15114
4/19/2015,8,8654,837,3608,2428,38,1,15566
4/19/2015,9,8966,837,3750,2204,56,1,15814
4/19/2015,10,9108,832,3592,2286,78,1,15897
4/19/2015,11,9120,828,3697,2257,95,1,15998
4/19/2015,12,9128,829,3587,2402,95,1,16042
4/19/2015,13,9119,826,3395,2420,95,1,15856
4/19/2015,14,9116,818,3386,2484,86,1,15891
4/19/2015,15,9118,814,3450,2642,56,1,16081
4/19/2015,16,9118,812,3668,2685,59,1,16343
4/19/2015,17,9114,812,4416,2672,28,1,17043
4/19/2015,18,9121,815,4392,2661,10,1,17000
4/19/2015,19,9123,813,4636,2640,1,1,17214
4/19/2015,20,9124,823,4788,2581,0,1,17317
4/19/2015,21,9117,827,4643,2495,0,1,17083
4/19/2015,22,9104,842,4353,2263,0,1,16563
4/19/2015,23,9042,877,3940,2322,0,1,16182
4/19/2015,24,9056,878,3335,2407,0,1,15677
4/20/2015,1,9069,872,3042,2114,0,10,15107
4/20/2015,2,9065,872,2922,1893,0,14,14766
4/20/2015,3,9066,870,2864,2242,0,14,15056
4/20/2015,4,9064,869,2951,2162,0,15,15061
4/20/2015,5,9064,874,3000,2502,0,23,15463
4/20/2015,6,9073,874,3395,2166,0,29,15537
4/20/2015,7,9075,894,4321,2833,0,41,17164
4/20/2015,8,9076,928,4945,2772,0,44,17765
4/20/2015,9,9131,926,5184,2702,4,46,17993
4/20/2015,10,9145,923,4907,2703,42,46,17766
4/20/2015,11,9142,923,4739,2658,50,33,17545
4/20/2015,12,9147,923,4570,2273,23,36,16972
4/20/2015,13,9156,957,4517,2223,8,39,16900
4/20/2015,14,9161,962,4470,2181,48,32,16854
4/20/2015,15,9164,1008,4568,2372,28,31,17171
4/20/2015,16,9165,1081,4504,2478,56,31,17315
4/20/2015,17,9172,1125,4539,2662,24,31,17553
4/20/2015,18,9177,1126,4454,2270,15,29,17071
4/20/2015,19,9177,1126,4675,2089,5,29,17101
4/20/2015,20,9175,1126,4726,2327,0,30,17384
4/20/2015,21,9171,1128,4459,2257,0,29,17044
4/20/2015,22,9171,1131,4250,1839,0,26,16417
4/20/2015,23,9166,976,3787,1948,0,19,15896
4/20/2015,24,9166,913,3458,1724,0,15,15276
4/21/2015,1,9164,913,3230,1592,0,15,14914
4/21/2015,2,9157,915,3389,1438,0,15,14914
4/21/2015,3,9158,920,3338,1375,0,15,14806
4/21/2015,4,9157,934,3159,1600,0,15,14865
4/21/2015,5,9167,952,3314,1632,0,24,15089
4/21/2015,6,9175,969,3684,1895,0,27,15750
4/21/2015,7,9183,1093,4197,1841,8,32,16354
4/21/2015,8,9176,1448,4549,1410,30,33,16646
4/21/2015,9,9169,1509,4585,1737,54,32,17086
4/21/2015,10,9158,1518,4681,2151,59,32,17599
4/21/2015,11,9169,1523,4529,1932,81,32,17266
4/21/2015,12,9166,1552,4512,1862,90,32,17214
4/21/2015,13,9164,1537,4396,2196,89,32,17414
4/21/2015,14,9163,1505,4365,1790,87,31,16941
4/21/2015,15,9150,1495,4357,1879,86,27,16994
4/21/2015,16,9150,1477,4427,2232,83,28,17397
4/21/2015,17,9156,1472,4366,2094,51,27,17166
4/21/2015,18,9153,1236,4514,2158,22,28,17111
4/21/2015,19,9153,955,4943,1988,5,32,17076
4/21/2015,20,9154,944,5324,1631,0,35,17088
4/21/2015,21,9141,935,5247,1276,0,36,16635
4/21/2015,22,9147,934,4905,1011,0,34,16031
4/21/2015,23,9146,925,4204,1183,0,26,15484
4/21/2015,24,9148,924,4003,1235,0,22,15332
4/22/2015,1,9152,926,3606,1162,0,20,14866
4/22/2015,2,9150,927,3553,1593,0,18,15241
4/22/2015,3,9139,928,3639,1680,0,18,15404
4/22/2015,4,9149,931,3794,1689,0,19,15582
4/22/2015,5,9155,932,3794,1714,0,25,15620
4/22/2015,6,9156,937,4412,1636,0,29,16170
4/22/2015,7,9160,943,5085,1448,0,34,16670
4/22/2015,8,9160,946,5359,1457,0,35,16957
4/22/2015,9,9162,944,5130,1735,64,35,17070
4/22/2015,10,9159,941,4660,1738,67,35,16600
4/22/2015,11,9163,941,4432,1773,49,35,16393
4/22/2015,12,9171,949,4608,1817,14,35,16594
4/22/2015,13,9030,1042,4824,1895,11,35,16837
4/22/2015,14,9001,1091,4987,1936,17,35,17067
4/22/2015,15,9138,1102,4831,2111,21,35,17238
4/22/2015,16,9164,1203,4935,2135,10,35,17482
4/22/2015,17,9162,1251,4726,2274,10,35,17458
4/22/2015,18,9162,1328,4591,2280,12,35,17408
4/22/2015,19,9165,1333,4759,1906,2,35,17200
4/22/2015,20,9166,1337,5293,1654,0,35,17485
4/22/2015,21,9164,1344,5401,1398,0,34,17341
4/22/2015,22,9163,1177,5037,1322,0,35,16734
4/22/2015,23,9156,1118,4582,1290,0,26,16172
4/22/2015,24,9156,956,4483,1325,0,23,15943
4/23/2015,1,9163,934,3903,1459,0,22,15481
4/23/2015,2,9167,933,3716,1512,0,22,15350
4/23/2015,3,9167,937,3657,1370,0,24,15155
4/23/2015,4,9165,1043,3684,1321,0,23,15236
4/23/2015,5,9169,1226,3698,1559,0,26,15678
4/23/2015,6,9172,1352,3822,1741,1,30,16118
4/23/2015,7,9174,1357,4346,1451,5,35,16368
4/23/2015,8,9170,1358,4705,1721,15,35,17004
4/23/2015,9,9167,1354,4588,1608,25,34,16776
4/23/2015,10,9156,1357,4510,1790,50,35,16898
4/23/2015,11,9162,1359,4425,1698,52,36,16732
4/23/2015,12,9168,1040,4531,1864,43,36,16682
4/23/2015,13,9167,950,4620,1940,41,36,16754
4/23/2015,14,9156,1040,4438,1909,29,34,16606
4/23/2015,15,9163,1189,4395,1947,22,33,16749
4/23/2015,16,9162,1377,4891,1960,15,34,17439
4/23/2015,17,9158,1447,5029,1848,8,34,17524
4/23/2015,18,9158,1641,5215,1616,6,31,17667
4/23/2015,19,9164,1578,5439,1251,1,31,17464
4/23/2015,20,9163,1766,5677,1091,0,32,17729
4/23/2015,21,9165,1740,5385,898,0,32,17220
4/23/2015,22,9162,1394,4714,859,0,33,16162
4/23/2015,23,9158,1328,4346,743,0,25,15600
4/23/2015,24,9165,1044,4516,845,0,22,15592
4/24/2015,1,9161,957,4204,1150,0,22,15494
4/24/2015,2,9159,1071,3758,1172,0,22,15182
4/24/2015,3,9150,1240,3660,1137,0,21,15208
4/24/2015,4,9158,1385,3662,1113,0,21,15339
4/24/2015,5,9165,1421,3825,1099,0,24,15534
4/24/2015,6,9164,1516,4740,1087,0,29,16536
4/24/2015,7,9163,1603,5297,898,8,34,17003
4/24/2015,8,9163,1597,5514,822,38,35,17169
4/24/2015,9,9161,1562,5313,958,54,34,17082
4/24/2015,10,9164,1560,5048,941,60,34,16807
4/24/2015,11,9167,1243,5072,990,67,34,16573
4/24/2015,12,9169,1150,4865,1147,75,34,16440
4/24/2015,13,9167,1147,4619,1150,76,35,16194
4/24/2015,14,9168,1043,4617,1107,73,36,16044
4/24/2015,15,9170,1012,4716,973,76,34,15981
4/24/2015,16,9167,1110,5054,834,76,34,16275
4/24/2015,17,9168,1151,4936,755,57,34,16101
4/24/2015,18,9170,1159,5127,576,25,34,16091
4/24/2015,19,9174,1173,5446,422,4,34,16253
4/24/2015,20,9174,1216,5748,362,0,35,16535
4/24/2015,21,9166,1486,5437,334,0,35,16458
4/24/2015,22,9169,1421,5184,295,0,34,16103
4/24/2015,23,9162,998,5134,262,0,22,15578
4/24/2015,24,9157,905,4766,282,0,4,15114
4/25/2015,1,9152,905,4693,214,0,3,14967
4/25/2015,2,9153,927,4760,130,0,3,14973
4/25/2015,3,9147,941,4729,106,0,3,14926
4/25/2015,4,9152,953,4609,115,0,3,14832
4/25/2015,5,9159,992,4905,144,0,2,15202
4/25/2015,6,9166,1109,4746,221,1,0,15243
4/25/2015,7,9171,1131,4733,297,12,0,15344
4/25/2015,8,9170,1129,5195,246,38,0,15778
4/25/2015,9,9169,1161,5635,232,70,0,16267
4/25/2015,10,9161,1278,5653,277,84,0,16453
4/25/2015,11,9161,1200,5281,311,92,0,16045
4/25/2015,12,9165,1054,4958,481,93,0,15751
4/25/2015,13,9163,917,4467,588,92,0,15227
4/25/2015,14,9156,917,4530,792,90,0,15485
4/25/2015,15,9154,915,4342,977,84,0,15472
4/25/2015,16,9154,914,4338,975,80,0,15461
4/25/2015,17,9147,913,5008,871,43,0,15982
4/25/2015,18,9142,912,5260,704,24,0,16042
4/25/2015,19,9141,918,5463,584,4,0,16110
4/25/2015,20,9145,919,5302,775,0,0,16141
4/25/2015,21,9146,921,5148,1146,0,0,16361
4/25/2015,22,9149,921,4467,1260,0,0,15797
4/25/2015,23,9159,895,4108,1317,0,1,15480
4/25/2015,24,9153,892,3835,1335,0,0,15215
4/26/2015,1,9152,891,3732,1294,0,0,15069
4/26/2015,2,9151,891,3918,1206,0,0,15166
4/26/2015,3,9146,894,3579,1303,0,0,14922
4/26/2015,4,9127,894,3255,1288,0,0,14564
4/26/2015,5,9156,919,3362,1266,0,0,14703
4/26/2015,6,9166,926,3555,1143,0,0,14790
4/26/2015,7,9168,924,3931,765,8,0,14796
4/26/2015,8,9165,924,4332,402,38,0,14861
4/26/2015,9,9168,934,4650,294,43,0,15089
4/26/2015,10,9142,902,4600,435,88,0,15167
4/26/2015,11,9166,902,4667,588,87,0,15410
4/26/2015,12,9165,927,4612,808,72,0,15584
4/26/2015,13,9168,915,4322,1040,52,0,15497
4/26/2015,14,9175,896,4058,1232,33,0,15394
4/26/2015,15,9173,908,4019,1594,24,0,15718
4/26/2015,16,9172,911,4377,1678,9,0,16147
4/26/2015,17,9172,913,4664,1705,6,0,16460
4/26/2015,18,9170,923,4646,1635,6,0,16380
4/26/2015,19,9173,925,4844,1384,1,0,16327
4/26/2015,20,9164,929,5303,1152,0,2,16550
4/26/2015,21,9166,951,5386,1107,0,3,16613
4/26/2015,22,9161,927,4902,1069,0,3,16062
4/26/2015,23,9165,899,4480,953,0,4,15501
4/26/2015,24,9167,939,4166,841,0,4,15117
4/27/2015,1,9164,954,4041,779,0,3,14941
4/27/2015,2,9165,1001,4163,728,0,6,15063
4/27/2015,3,9164,1025,3919,814,0,21,14943
4/27/2015,4,9173,1045,3883,945,0,23,15069
4/27/2015,5,9176,1089,4004,1099,0,23,15391
4/27/2015,6,9178,1226,4351,1219,1,29,16004
4/27/2015,7,9180,1278,4627,1372,1,33,16491
4/27/2015,8,9176,1346,4796,1571,6,35,16930
4/27/2015,9,9176,1363,4649,1745,8,33,16974
4/27/2015,10,9174,1426,4426,1614,24,32,16696
4/27/2015,11,9176,1522,4441,1585,37,34,16795
4/27/2015,12,9179,1569,4588,1533,53,36,16958
4/27/2015,13,9175,1792,4824,1474,50,36,17351
4/27/2015,14,9179,2079,4430,1443,32,36,17199
4/27/2015,15,9174,2057,4313,1432,22,36,17034
4/27/2015,16,9176,2014,4414,1428,8,36,17076
4/27/2015,17,9181,1947,4462,1433,9,36,17068
4/27/2015,18,9182,1947,4517,1372,6,36,17060
4/27/2015,19,9182,1945,4853,1180,1,36,17197
4/27/2015,20,9177,1947,5149,1018,0,36,17327
4/27/2015,21,9174,1652,5086,1064,0,36,17012
4/27/2015,22,9171,1219,4625,1289,0,35,16339
4/27/2015,23,9168,974,4526,1146,0,25,15839
4/27/2015,24,9176,921,4340,1088,0,24,15549
4/28/2015,1,9181,929,4150,1041,0,50,15351
4/28/2015,2,9177,1044,3815,753,0,172,14961
4/28/2015,3,9176,1199,3770,481,0,172,14798
4/28/2015,4,9179,1331,3710,677,0,175,15072
4/28/2015,5,9180,1334,4131,680,0,176,15501
4/28/2015,6,9176,1312,4473,689,0,187,15837
4/28/2015,7,9181,1345,4745,545,6,197,16019
4/28/2015,8,9177,1359,5275,276,29,208,16324
4/28/2015,9,9180,1354,4835,359,54,210,15992
4/28/2015,10,9179,1346,4614,573,70,210,15992
4/28/2015,11,9180,1336,4357,751,77,208,15909
4/28/2015,12,9175,1337,4539,757,83,205,16096
4/28/2015,13,9170,1332,4296,753,94,207,15852
4/28/2015,14,9175,1331,4476,737,93,207,16019
4/28/2015,15,9186,1329,4560,683,94,209,16061
4/28/2015,16,9174,1331,4904,574,80,210,16273
4/28/2015,17,9173,1329,5180,434,41,208,16365
4/28/2015,18,9175,1326,5266,347,12,208,16334
4/28/2015,19,9172,1331,5093,292,3,204,16095
4/28/2015,20,9170,1337,5103,284,0,201,16095
4/28/2015,21,9174,1341,5156,302,0,198,16171
4/28/2015,22,8663,1377,4996,408,0,185,15629
4/28/2015,23,8656,1279,4585,543,0,174,15237
4/28/2015,24,8662,939,4318,529,0,171,14619
4/29/2015,1,8659,889,4308,497,0,170,14523
4/29/2015,2,8662,934,4218,479,0,170,14463
4/29/2015,3,8661,1116,4157,372,0,170,14476
4/29/2015,4,8656,1511,3890,287,0,170,14514
4/29/2015,5,8656,1791,4113,226,0,172,14958
4/29/2015,6,8661,1938,4424,176,1,36,15236
4/29/2015,7,8667,2002,5251,154,9,38,16121
4/29/2015,8,8667,1928,5285,100,35,48,16063
4/29/2015,9,8665,1896,4985,90,61,55,15752
4/29/2015,10,8665,1898,4844,132,82,52,15673
4/29/2015,11,8666,1918,4881,160,89,39,15753
4/29/2015,12,8664,1953,4791,190,91,34,15723
4/29/2015,13,8657,1875,4663,311,92,34,15632
4/29/2015,14,8655,2056,4362,431,95,34,15633
4/29/2015,15,8661,1974,4368,535,92,34,15664
4/29/2015,16,8663,1801,4890,625,76,34,16089
4/29/2015,17,8668,1806,4720,836,51,34,16115
4/29/2015,18,8667,1807,4783,847,23,34,16161
4/29/2015,19,8667,1528,5343,708,4,45,16295
4/29/2015,20,8668,1480,5621,805,0,38,16612
4/29/2015,21,8666,1455,4970,1006,0,37,16134
4/29/2015,22,8659,1436,4233,1004,0,34,15366
4/29/2015,23,8659,907,4102,1029,0,26,14723
4/29/2015,24,8662,854,3905,1015,0,21,14457
4/30/2015,1,8662,856,3806,1136,0,19,14479
4/30/2015,2,8666,971,3412,1166,0,18,14233
4/30/2015,3,8664,1099,3435,1009,0,18,14225
4/30/2015,4,8665,1262,3285,837,0,18,14067
4/30/2015,5,8664,1263,3762,725,0,20,14434
4/30/2015,6,8665,1268,4238,599,0,28,14798
4/30/2015,7,8668,1291,4760,565,3,34,15321
4/30/2015,8,8667,1292,5203,562,18,34,15776
4/30/2015,9,8667,1291,5046,591,20,33,15648
4/30/2015,10,8667,1302,5329,645,35,34,16012
4/30/2015,11,8665,1029,5313,777,39,35,15858
4/30/2015,12,8667,1016,5052,840,64,34,15673
4/30/2015,13,8667,1213,4836,862,88,35,15701
4/30/2015,14,8666,1270,4693,841,93,34,15597
4/30/2015,15,8664,1432,4432,1027,87,35,15677
4/30/2015,16,8662,1478,4691,972,48,34,15885
4/30/2015,17,8668,1466,4993,821,38,34,16020
4/30/2015,18,8664,1465,4801,823,22,34,15809
4/30/2015,19,8661,1302,5223,828,4,34,16052
4/30/2015,20,8658,1280,5310,995,0,34,16277
4/30/2015,21,8659,1278,5167,1233,0,34,16371
4/30/2015,22,8658,1282,4381,1242,0,35,15598
4/30/2015,23,8662,1118,3956,1326,0,26,15088
4/30/2015,24,8668,900,3910,1175,0,22,14675
5/1/2015,1,8668,870,3888,1056,0,21,14503
5/1/2015,2,8668,873,4088,948,0,18,14595
5/1/2015,3,8665,881,3806,766,0,17,14135
5/1/2015,4,8663,942,4033,605,0,17,14260
5/1/2015,5,8670,1001,4353,497,0,20,14541
5/1/2015,6,8668,1129,4545,464,0,29,14835
5/1/2015,7,8667,1140,5110,470,8,34,15429
5/1/2015,8,8664,1180,5579,177,22,34,15656
5/1/2015,9,8665,1201,5504,106,33,34,15543
5/1/2015,10,8667,1213,5363,126,40,34,15443
5/1/2015,11,8667,1155,5092,277,47,34,15272
5/1/2015,12,8655,988,4694,527,77,34,14975
5/1/2015,13,8652,1069,4501,815,75,35,15147
5/1/2015,14,8652,1014,4258,890,71,35,14920
5/1/2015,15,8651,1141,4439,877,69,36,15213
5/1/2015,16,8668,1288,4310,865,49,35,15215
5/1/2015,17,8670,1343,4488,882,48,35,15466
5/1/2015,18,8673,1360,4526,808,18,35,15420
5/1/2015,19,8678,1354,4905,631,3,36,15607
5/1/2015,20,8679,1348,5346,472,0,36,15881
5/1/2015,21,8672,1450,5581,371,0,36,16110
5/1/2015,22,8676,1436,5138,363,0,35,15648
5/1/2015,23,8671,1239,4730,330,0,27,14997
5/1/2015,24,8668,1189,4262,276,0,10,14405
5/2/2015,1,8662,854,4289,229,0,3,14037
5/2/2015,2,8655,776,4241,236,0,3,13911
5/2/2015,3,8658,764,3997,179,0,3,13601
5/2/2015,4,8664,727,4197,140,0,3,13731
5/2/2015,5,8669,725,4213,116,0,2,13725
5/2/2015,6,8677,725,4296,95,0,2,13795
5/2/2015,7,8679,723,4581,77,10,2,14072
5/2/2015,8,8679,724,5329,38,34,2,14806
5/2/2015,9,8665,729,5467,11,64,3,14939
5/2/2015,10,8668,761,5229,29,82,3,14772
5/2/2015,11,8674,761,5033,87,95,3,14653
5/2/2015,12,8671,765,4797,200,95,3,14531
5/2/2015,13,8677,816,4782,349,93,3,14720
5/2/2015,14,8679,752,4622,568,93,4,14718
5/2/2015,15,8680,743,4565,703,93,3,14787
5/2/2015,16,8679,741,4572,736,79,6,14813
5/2/2015,17,8677,837,4931,651,53,4,15153
5/2/2015,18,8676,869,5022,563,25,3,15158
5/2/2015,19,8674,876,5053,501,4,4,15112
5/2/2015,20,8673,827,5388,495,0,3,15386
5/2/2015,21,8670,779,5427,533,0,3,15412
5/2/2015,22,8675,808,5277,661,0,3,15424
5/2/2015,23,8674,778,4023,874,0,3,14352
5/2/2015,24,8676,777,3731,1040,0,3,14227
5/3/2015,1,8678,776,3605,904,0,3,13966
5/3/2015,2,8685,776,3410,862,0,2,13735
5/3/2015,3,8691,775,3253,734,0,2,13455
5/3/2015,4,8690,772,3520,633,0,2,13617
5/3/2015,5,8682,773,3431,749,0,3,13638
5/3/2015,6,8679,769,3254,922,0,2,13626
5/3/2015,7,8680,766,3407,827,6,4,13690
5/3/2015,8,8676,764,4135,510,36,3,14124
5/3/2015,9,8677,758,4493,382,63,3,14376
5/3/2015,10,8626,752,4824,427,84,3,14716
5/3/2015,11,8634,744,4668,576,95,3,14720
5/3/2015,12,8661,738,4569,875,96,3,14942
5/3/2015,13,8535,733,4337,1236,95,4,14940
5/3/2015,14,8568,730,4188,1395,95,3,14979
5/3/2015,15,8656,731,4266,1393,92,4,15142
5/3/2015,16,8650,730,4538,1430,76,4,15428
5/3/2015,17,8641,734,5063,1261,52,4,15755
5/3/2015,18,8645,744,5531,971,24,4,15919
5/3/2015,19,8648,755,5342,901,4,6,15656
5/3/2015,20,8650,742,5605,1113,0,3,16113
5/3/2015,21,8647,743,5334,1390,0,3,16117
5/3/2015,22,8635,748,4689,1709,0,5,15786
5/3/2015,23,8640,755,4060,1866,0,16,15337
5/3/2015,24,8640,753,3461,1802,0,17,14673
5/4/2015,1,8636,756,3013,1761,0,18,14184
5/4/2015,2,8641,732,3031,1444,0,17,13865
5/4/2015,3,8642,721,3023,1520,0,17,13923
5/4/2015,4,8645,738,3026,1571,0,17,13997
5/4/2015,5,8651,785,3102,1789,0,23,14350
5/4/2015,6,8653,858,3571,2017,0,30,15129
5/4/2015,7,8653,876,4312,1839,2,42,15724
5/4/2015,8,8649,962,4412,1802,32,41,15898
5/4/2015,9,8655,1063,4388,1754,56,37,15953
5/4/2015,10,8650,1124,4434,1898,78,42,16226
5/4/2015,11,8648,1152,4649,2099,65,34,16647
5/4/2015,12,8653,1232,4699,2086,70,34,16774
5/4/2015,13,8648,1334,4609,1940,58,35,16624
5/4/2015,14,8644,1599,4332,1982,32,51,16640
5/4/2015,15,8651,1636,4326,2011,9,84,16717
5/4/2015,16,8654,1615,4375,1973,21,91,16729
5/4/2015,17,8657,1615,4541,1818,21,91,16743
5/4/2015,18,8660,1619,4615,1522,11,91,16518
5/4/2015,19,8658,1624,4780,1106,4,96,16268
5/4/2015,20,8656,1626,5360,718,0,100,16460
5/4/2015,21,8651,1632,5192,691,0,108,16274
5/4/2015,22,8103,1353,5050,557,0,110,15173
5/4/2015,23,7876,1101,5093,529,0,103,14702
5/4/2015,24,7878,968,4462,560,0,78,13946
5/5/2015,1,7870,922,3878,629,0,31,13330
5/5/2015,2,7877,994,3543,657,0,19,13090
5/5/2015,3,7882,1073,3555,411,0,19,12940
5/5/2015,4,7882,1328,3632,326,0,20,13188
5/5/2015,5,7881,1728,3643,245,0,24,13521
5/5/2015,6,7878,2058,3988,269,0,31,14224
5/5/2015,7,7882,2354,4449,121,10,55,14871
5/5/2015,8,7881,2464,4849,76,29,82,15381
5/5/2015,9,7879,2463,5114,65,49,102,15672
5/5/2015,10,7878,2459,4975,75,46,168,15601
5/5/2015,11,7880,2406,5197,93,36,214,15826
5/5/2015,12,7877,2394,5093,246,29,214,15853
5/5/2015,13,7875,2080,5103,375,11,215,15659
5/5/2015,14,7877,1995,5260,269,28,215,15644
5/5/2015,15,7876,2025,5381,177,22,226,15707
5/5/2015,16,7875,2312,5414,151,11,225,15988
5/5/2015,17,7872,2217,5335,208,7,171,15810
5/5/2015,18,7874,1934,5449,196,6,100,15559
5/5/2015,19,7869,1550,5401,132,2,96,15050
5/5/2015,20,7865,1705,5723,103,0,124,15520
5/5/2015,21,7856,2167,5746,121,0,169,16059
5/5/2015,22,7857,1809,5428,134,0,183,15411
5/5/2015,23,7861,1319,5021,186,0,124,14511
5/5/2015,24,7869,1019,4376,207,0,84,13555
5/6/2015,1,7876,922,4150,217,0,36,13201
5/6/2015,2,7874,925,4269,237,0,20,13325
5/6/2015,3,7879,1046,4349,250,0,21,13545
5/6/2015,4,7879,1177,4281,290,0,22,13649
5/6/2015,5,7885,1346,4521,354,0,30,14136
5/6/2015,6,7886,1358,4661,470,0,38,14413
5/6/2015,7,7887,1425,5131,534,0,72,15049
5/6/2015,8,7880,1594,5207,386,26,121,15214
5/6/2015,9,7881,1718,5212,311,47,130,15299
5/6/2015,10,7877,1774,5300,325,57,129,15462
5/6/2015,11,7878,1843,5263,291,80,141,15496
5/6/2015,12,7874,2045,5010,220,81,204,15434
5/6/2015,13,7868,2227,4956,154,73,226,15504
5/6/2015,14,7873,2090,5025,126,79,230,15423
5/6/2015,15,7870,2081,5280,137,79,214,15661
5/6/2015,16,7870,2069,5301,141,76,211,15668
5/6/2015,17,7868,2115,5548,134,51,212,15928
5/6/2015,18,7875,2192,5390,141,24,213,15835
5/6/2015,19,7872,2032,5502,151,4,208,15769
5/6/2015,20,7875,2041,5604,236,0,151,15907
5/6/2015,21,7874,2218,4952,355,0,91,15490
5/6/2015,22,7873,2078,4679,362,0,87,15079
5/6/2015,23,7870,1222,4887,353,0,77,14409
5/6/2015,24,7873,1022,4721,332,0,72,14020
5/7/2015,1,7877,923,4642,366,0,73,13881
5/7/2015,2,7882,1040,4302,430,0,71,13725
5/7/2015,3,7883,1199,4013,392,0,71,13558
5/7/2015,4,7885,1410,4015,380,0,71,13761
5/7/2015,5,7887,1566,4320,361,0,75,14209
5/7/2015,6,7889,1725,4488,307,0,80,14489
5/7/2015,7,7885,1847,4922,263,5,87,15009
5/7/2015,8,7885,1971,5046,168,35,106,15211
5/7/2015,9,7885,2090,5120,81,63,184,15423
5/7/2015,10,7883,2240,5176,85,82,211,15677
5/7/2015,11,7884,2341,5089,100,94,213,15721
5/7/2015,12,7883,2414,5083,121,95,213,15809
5/7/2015,13,7880,2772,5151,106,95,212,16216
5/7/2015,14,7879,3011,5131,116,94,213,16444
5/7/2015,15,7882,3028,5180,106,91,212,16499
5/7/2015,16,7877,3272,5302,129,74,210,16864
5/7/2015,17,7872,3663,5391,129,50,209,17314
5/7/2015,18,7875,3607,5333,213,24,160,17212
5/7/2015,19,7876,3363,5627,355,5,172,17398
5/7/2015,20,7872,2969,5631,558,0,156,17186
5/7/2015,21,8005,2927,5423,842,0,175,17372
5/7/2015,22,8176,1797,4955,1192,0,128,16248
5/7/2015,23,8288,1207,4758,1371,0,93,15717
5/7/2015,24,8300,1019,4082,1458,0,103,14962
5/8/2015,1,8436,897,3727,1330,0,61,14451
5/8/2015,2,8448,1020,3714,1067,0,21,14270
5/8/2015,3,8401,1180,3654,1180,0,19,14434
5/8/2015,4,8157,1315,3685,1232,0,20,14409
5/8/2015,5,8159,1297,3895,1369,0,23,14743
5/8/2015,6,8226,1374,4561,1356,0,30,15547
5/8/2015,7,8452,1459,4788,1063,0,34,15796
5/8/2015,8,8453,1649,5281,689,31,39,16142
5/8/2015,9,8394,2052,5586,398,50,64,16544
5/8/2015,10,8389,2102,5357,369,77,123,16417
5/8/2015,11,8388,2171,5364,397,89,108,16517
5/8/2015,12,8389,1912,5537,669,90,89,16686
5/8/2015,13,8387,2028,5111,967,69,90,16652
5/8/2015,14,8408,1999,5022,1063,91,90,16673
5/8/2015,15,8564,2296,5154,1131,88,91,17324
5/8/2015,16,8597,2423,5152,1088,73,92,17425
5/8/2015,17,8602,2676,5252,982,49,92,17653
5/8/2015,18,8604,2699,5298,795,21,92,17509
5/8/2015,19,8605,2496,5525,697,4,63,17390
5/8/2015,20,8607,2516,5707,693,0,43,17566
5/8/2015,21,8600,2514,5167,762,0,45,17088
5/8/2015,22,8608,1764,4705,768,0,38,15883
5/8/2015,23,8616,972,4802,939,0,6,15335
5/8/2015,24,8625,846,4722,822,0,2,15017
5/9/2015,1,8627,830,4695,593,0,2,14747
5/9/2015,2,8621,836,4595,439,0,2,14493
5/9/2015,3,8611,837,4283,342,0,2,14075
5/9/2015,4,8609,837,4014,294,0,2,13756
5/9/2015,5,8613,849,3783,340,0,0,13585
5/9/2015,6,8598,849,3805,283,0,0,13535
5/9/2015,7,8603,845,4216,399,0,0,14063
5/9/2015,8,8599,882,4977,414,0,15,14887
5/9/2015,9,8597,932,5582,496,0,57,15664
5/9/2015,10,8601,957,5636,564,0,149,15907
5/9/2015,11,8596,1113,5322,659,0,178,15868
5/9/2015,12,8615,1076,4978,855,0,114,15638
5/9/2015,13,8618,1072,5032,1176,0,71,15969
5/9/2015,14,8623,1248,5044,1283,0,63,16261
5/9/2015,15,8625,1605,5335,1077,1,127,16770
5/9/2015,16,8629,1876,5415,816,2,159,16897
5/9/2015,17,8627,1940,5422,571,13,126,16699
5/9/2015,18,8628,2075,5509,412,8,113,16745
5/9/2015,19,8628,1904,4944,775,4,70,16325
5/9/2015,20,8631,1876,4992,764,0,61,16324
5/9/2015,21,8630,2005,5583,565,0,58,16841
5/9/2015,22,8628,1657,5542,376,0,58,16261
5/9/2015,23,8638,1183,5040,501,0,16,15378
5/9/2015,24,8637,907,5112,310,0,3,14969
5/10/2015,1,8639,942,5034,206,0,2,14823
5/10/2015,2,8635,875,4535,213,0,2,14260
5/10/2015,3,8633,878,4255,231,0,2,13999
5/10/2015,4,8631,882,4048,173,0,2,13736
5/10/2015,5,8635,880,4240,149,0,2,13906
5/10/2015,6,8641,878,4082,221,0,2,13824
5/10/2015,7,8641,876,4162,154,8,3,13844
5/10/2015,8,8635,883,4525,141,22,18,14224
5/10/2015,9,8640,888,5006,112,45,52,14743
5/10/2015,10,8637,963,5450,126,56,62,15294
5/10/2015,11,8636,1305,5503,136,37,61,15678
5/10/2015,12,8634,1678,5331,131,32,61,15867
5/10/2015,13,8494,2075,5323,187,48,57,16184
5/10/2015,14,8516,2157,5217,163,89,59,16201
5/10/2015,15,8619,2480,5256,252,88,59,16754
5/10/2015,16,8622,2421,5393,329,73,57,16895
5/10/2015,17,8624,2411,5420,343,47,57,16902
5/10/2015,18,8742,2243,5573,233,20,56,16867
5/10/2015,19,8819,2228,5584,258,3,56,16948
5/10/2015,20,8817,2137,5763,293,0,66,17076
5/10/2015,21,8808,2232,5421,245,0,94,16800
5/10/2015,22,8863,1637,5399,232,0,53,16184
5/10/2015,23,9035,1501,4845,297,0,13,15691
5/10/2015,24,9056,981,4128,283,0,9,14457
5/11/2015,1,9225,933,4245,254,0,10,14667
5/11/2015,2,9407,941,4498,250,0,11,15107
5/11/2015,3,9494,1097,4110,285,0,10,14996
5/11/2015,4,9588,1283,3966,293,0,9,15139
5/11/2015,5,9688,1406,4043,270,0,10,15417
5/11/2015,6,9691,1437,4633,322,1,19,16103
5/11/2015,7,9945,1589,5003,252,12,26,16827
5/11/2015,8,9986,1614,5071,363,34,29,17097
5/11/2015,9,9993,1455,5020,582,59,27,17136
5/11/2015,10,9995,1595,5086,500,39,45,17260
5/11/2015,11,10004,1819,5098,539,34,83,17577
5/11/2015,12,10008,1698,4491,527,77,83,16884
5/11/2015,13,10021,1648,4945,858,75,85,17632
5/11/2015,14,10162,1504,4899,1071,86,83,17805
5/11/2015,15,10407,1360,5033,1146,89,81,18116
5/11/2015,16,10406,1511,5236,1026,66,45,18290
5/11/2015,17,10601,1609,5293,1104,47,31,18685
5/11/2015,18,10805,1379,5368,750,20,31,18353
5/11/2015,19,10876,1164,5213,982,1,42,18278
5/11/2015,20,10873,1058,4988,1697,0,49,18665
5/11/2015,21,10875,1028,4652,1627,0,32,18214
5/11/2015,22,10891,1016,4430,1700,0,32,18069
5/11/2015,23,10746,980,4148,1204,0,25,17103
5/11/2015,24,10310,918,3992,1061,0,21,16302
5/12/2015,1,10062,917,3733,898,0,19,15629
5/12/2015,2,9926,918,3700,812,0,19,15375
5/12/2015,3,9676,917,3560,1131,0,18,15302
5/12/2015,4,9449,918,3593,877,0,19,14856
5/12/2015,5,9353,920,3704,1427,0,23,15427
5/12/2015,6,9603,919,3804,1865,0,29,16220
5/12/2015,7,9834,935,4323,2008,12,34,17146
5/12/2015,8,10188,934,4637,2153,34,30,17976
5/12/2015,9,10422,944,4666,2051,46,30,18159
5/12/2015,10,10651,948,4565,2258,50,30,18502
5/12/2015,11,10844,973,4339,2316,69,31,18572
5/12/2015,12,10993,1089,4127,2184,64,30,18487
5/12/2015,13,11009,1120,4160,1803,30,30,18152
5/12/2015,14,11013,1119,3881,1846,25,30,17914
5/12/2015,15,11021,1127,3917,1936,9,30,18040
5/12/2015,16,11042,1126,3913,1797,12,30,17920
5/12/2015,17,11018,1127,4066,1745,17,30,18003
5/12/2015,18,11056,1113,4105,1725,11,30,18040
5/12/2015,19,11063,940,4653,1857,2,31,18546
5/12/2015,20,11070,935,4628,1640,0,31,18304
5/12/2015,21,11070,939,4477,1425,0,31,17942
5/12/2015,22,11065,936,4188,1182,0,31,17402
5/12/2015,23,11001,934,3740,1128,0,24,16827
5/12/2015,24,10710,934,3539,497,0,18,15698
5/13/2015,1,10174,928,3515,696,0,19,15332
5/13/2015,2,9640,936,3547,1046,0,21,15190
5/13/2015,3,9378,935,3491,1292,0,18,15114
5/13/2015,4,9381,924,3575,1264,0,18,15162
5/13/2015,5,9477,944,3914,1310,0,22,15667
5/13/2015,6,9944,975,4296,1402,2,30,16649
5/13/2015,7,10561,976,4562,1158,6,32,17295
5/13/2015,8,11070,958,4558,797,12,27,17422
5/13/2015,9,11181,919,4310,731,22,27,17190
5/13/2015,10,11183,918,3917,803,33,26,16880
5/13/2015,11,11168,914,4258,806,24,26,17196
5/13/2015,12,11200,916,4247,879,29,26,17297
5/13/2015,13,11277,910,4176,911,29,26,17329
5/13/2015,14,11291,906,4041,914,24,27,17203
5/13/2015,15,11287,904,4047,275,18,29,16560
5/13/2015,16,11308,902,4216,755,22,38,17241
5/13/2015,17,11326,906,4352,848,23,55,17510
5/13/2015,18,11342,909,4512,733,17,62,17575
5/13/2015,19,11343,883,4782,376,5,62,17451
5/13/2015,20,11346,877,4969,277,0,63,17532
5/13/2015,21,11337,896,5163,333,0,61,17790
5/13/2015,22,11340,910,4878,218,0,62,17408
5/13/2015,23,11342,889,4100,228,0,38,16597
5/13/2015,24,11344,874,3443,272,0,15,15948
5/14/2015,1,11146,890,3331,216,0,12,15595
5/14/2015,2,10594,914,3346,125,0,13,14992
5/14/2015,3,10167,922,3589,146,0,13,14837
5/14/2015,4,10147,921,3904,150,0,19,15141
5/14/2015,5,10294,924,4241,206,0,15,15680
5/14/2015,6,10621,932,4446,222,2,19,16242
5/14/2015,7,11104,947,5014,151,14,29,17259
5/14/2015,8,11491,939,4495,35,41,30,17031
5/14/2015,9,11511,930,4385,46,69,30,16971
5/14/2015,10,11422,938,4195,76,88,32,16751
5/14/2015,11,10715,940,4229,129,95,31,16139
5/14/2015,12,10780,944,4631,185,95,31,16666
5/14/2015,13,11415,928,4183,216,96,31,16869
5/14/2015,14,11521,927,3980,186,96,31,16741
5/14/2015,15,11530,949,4087,152,94,31,16843
5/14/2015,16,11524,956,4094,122,80,30,16806
5/14/2015,17,11501,956,4570,108,55,31,17221
5/14/2015,18,11504,963,4869,115,26,31,17508
5/14/2015,19,11510,970,4680,162,7,30,17359
5/14/2015,20,11498,963,5190,287,0,30,17968
5/14/2015,21,11501,1020,5029,382,0,31,17963
5/14/2015,22,11506,1058,4300,474,0,30,17368
5/14/2015,23,11480,1055,3572,316,0,19,16442
5/14/2015,24,11037,1056,3374,261,0,15,15743
5/15/2015,1,10335,1052,3339,450,0,16,15192
5/15/2015,2,9826,1033,3352,561,0,15,14787
5/15/2015,3,9763,1038,3344,518,0,15,14678
5/15/2015,4,9761,1036,3417,509,0,16,14739
5/15/2015,5,9770,969,3744,730,0,22,15235
5/15/2015,6,10169,922,4113,782,1,27,16014
5/15/2015,7,10661,889,4465,643,12,35,16705
5/15/2015,8,11128,822,4393,616,32,39,17030
5/15/2015,9,11343,892,4312,500,28,38,17113
5/15/2015,10,11492,919,4303,678,23,37,17452
5/15/2015,11,11497,914,4167,777,48,36,17439
5/15/2015,12,11490,910,3935,1011,52,35,17433
5/15/2015,13,11377,915,3818,1208,22,29,17369
5/15/2015,14,11404,914,3781,1364,29,33,17525
5/15/2015,15,11487,911,3863,1145,36,33,17475
5/15/2015,16,11489,907,4336,917,39,26,17714
5/15/2015,17,11488,907,4767,685,19,26,17892
5/15/2015,18,11473,905,4610,486,10,26,17510
5/15/2015,19,11463,903,4525,371,3,26,17291
5/15/2015,20,11478,902,4797,326,0,28,17531
5/15/2015,21,11468,904,4706,298,0,26,17402
5/15/2015,22,11468,892,4300,187,0,26,16873
5/15/2015,23,11450,542,4050,240,0,7,16289
5/15/2015,24,11187,407,3727,316,0,0,15637
5/16/2015,1,10877,405,3430,347,0,0,15059
5/16/2015,2,10549,403,3428,331,0,0,14711
5/16/2015,3,10290,404,3431,368,0,0,14493
5/16/2015,4,10274,405,3500,285,0,0,14464
5/16/2015,5,10271,404,3687,153,0,0,14515
5/16/2015,6,10274,396,3861,174,0,0,14705
5/16/2015,7,10276,396,4187,248,4,0,15111
5/16/2015,8,10432,399,4571,133,21,0,15556
5/16/2015,9,10850,398,4644,83,51,0,16026
5/16/2015,10,11272,399,4642,76,79,0,16468
5/16/2015,11,11465,395,4553,107,71,0,16591
5/16/2015,12,11461,395,4647,139,66,1,16709
5/16/2015,13,11456,393,4553,217,51,0,16670
5/16/2015,14,11460,394,4193,242,67,0,16356
5/16/2015,15,11462,394,4233,295,72,0,16456
5/16/2015,16,11464,393,4143,251,52,0,16303
5/16/2015,17,11465,398,4336,246,32,0,16477
5/16/2015,18,11466,399,4563,229,18,1,16676
5/16/2015,19,11467,404,4647,176,8,1,16703
5/16/2015,20,11468,410,4741,135,0,1,16755
5/16/2015,21,11340,413,5051,134,0,0,16938
5/16/2015,22,11134,416,5007,175,0,0,16732
5/16/2015,23,11084,416,4228,251,0,0,15979
5/16/2015,24,10779,414,3599,428,0,0,15220
5/17/2015,1,10261,417,3317,517,0,0,14512
5/17/2015,2,9935,419,3350,534,0,0,14238
5/17/2015,3,10011,417,3327,315,0,0,14070
5/17/2015,4,10009,416,3365,245,0,0,14035
5/17/2015,5,10010,417,3301,277,0,0,14005
5/17/2015,6,10008,417,3296,314,3,5,14043
5/17/2015,7,10021,415,3525,421,12,1,14395
5/17/2015,8,10554,410,3790,389,35,0,15178
5/17/2015,9,11177,412,3691,324,53,0,15657
5/17/2015,10,11451,410,3812,302,85,0,16060
5/17/2015,11,11451,408,3962,343,94,0,16258
5/17/2015,12,11440,408,4011,466,88,0,16413
5/17/2015,13,11440,408,3956,559,96,0,16459
5/17/2015,14,11435,407,3703,673,96,0,16314
5/17/2015,15,11439,406,3530,723,91,0,16189
5/17/2015,16,11439,373,3979,818,72,0,16681
5/17/2015,17,10848,391,4702,824,50,0,16815
5/17/2015,18,10657,676,4741,954,26,0,17054
5/17/2015,19,10655,678,4495,998,5,0,16831
5/17/2015,20,10650,444,4668,769,0,1,16532
5/17/2015,21,10647,412,5066,943,0,0,17068
5/17/2015,22,10650,413,4463,1180,0,0,16706
5/17/2015,23,10420,412,3603,1680,0,14,16129
5/17/2015,24,9944,412,3377,1502,0,6,15241
5/18/2015,1,9655,408,3335,1184,0,1,14583
5/18/2015,2,9513,408,3368,963,0,1,14253
5/18/2015,3,9522,410,3325,929,0,1,14187
5/18/2015,4,9547,406,3217,962,0,1,14133
5/18/2015,5,9561,411,3249,866,0,0,14087
5/18/2015,6,9586,412,3245,747,0,0,13990
5/18/2015,7,9628,412,3447,892,12,0,14391
5/18/2015,8,10019,410,3618,1156,28,0,15231
5/18/2015,9,10619,408,3608,1136,30,0,15801
5/18/2015,10,10719,407,3896,1099,68,0,16189
5/18/2015,11,10719,405,4117,1106,96,0,16443
5/18/2015,12,10700,399,4256,1414,93,0,16862
5/18/2015,13,10691,397,4217,1295,96,0,16696
5/18/2015,14,10695,396,4203,1535,96,0,16925
5/18/2015,15,10720,388,4231,1623,82,0,17044
5/18/2015,16,10737,389,4643,1520,76,0,17365
5/18/2015,17,10739,391,5292,1448,24,0,17894
5/18/2015,18,10741,392,5257,1432,16,0,17838
5/18/2015,19,10738,393,5361,1348,5,0,17845
5/18/2015,20,10730,396,5248,1319,0,0,17693
5/18/2015,21,10718,398,5146,1322,0,0,17584
5/18/2015,22,10715,403,4600,1426,0,0,17144
5/18/2015,23,10711,400,4195,1583,0,0,16889
5/18/2015,24,10559,406,3986,1407,0,0,16358
5/19/2015,1,10021,403,3710,1585,0,0,15719
5/19/2015,2,9871,402,3359,1669,0,0,15301
5/19/2015,3,9873,404,3355,1458,0,0,15090
5/19/2015,4,9873,456,3429,1245,0,0,15003
5/19/2015,5,10203,505,3612,1032,0,6,15358
5/19/2015,6,10568,570,3833,829,0,7,15807
5/19/2015,7,10739,717,4276,819,12,12,16575
5/19/2015,8,10739,746,4484,853,39,18,16879
5/19/2015,9,10744,757,4567,665,69,24,16826
5/19/2015,10,10755,780,4444,1170,88,25,17262
5/19/2015,11,10739,840,4417,1388,80,25,17489
5/19/2015,12,10740,887,4276,1307,72,23,17305
5/19/2015,13,10736,942,4093,1121,47,29,16968
5/19/2015,14,10747,943,4041,1138,36,15,16920
5/19/2015,15,10745,941,4123,1390,39,1,17239
5/19/2015,16,10753,936,4189,1603,25,2,17508
5/19/2015,17,10753,936,4411,1497,6,1,17604
5/19/2015,18,10757,943,4565,1304,6,1,17576
5/19/2015,19,10757,944,4814,1209,2,1,17727
5/19/2015,20,10746,942,4894,1271,0,0,17853
5/19/2015,21,10740,916,4776,1261,0,0,17693
5/19/2015,22,10751,913,4334,1395,0,1,17394
5/19/2015,23,10594,911,3756,1355,0,2,16618
5/19/2015,24,9918,910,3425,1399,0,8,15660
5/20/2015,1,9635,912,3422,1287,0,1,15257
5/20/2015,2,9635,914,3397,1097,0,1,15044
5/20/2015,3,9632,914,3307,1084,0,2,14939
5/20/2015,4,9625,914,3359,1134,0,2,15034
5/20/2015,5,9773,908,3434,1318,0,4,15437
5/20/2015,6,10125,912,3885,1019,2,24,15967
5/20/2015,7,10520,912,4728,955,8,53,17176
5/20/2015,8,10781,911,4557,701,36,65,17051
5/20/2015,9,10782,905,4486,432,61,76,16742
5/20/2015,10,10780,902,4339,358,88,79,16546
5/20/2015,11,10781,902,4500,366,91,80,16720
5/20/2015,12,10782,899,4410,409,92,82,16674
5/20/2015,13,10783,894,4208,531,95,82,16593
5/20/2015,14,10782,890,4112,504,96,78,16462
5/20/2015,15,10783,888,4134,696,96,75,16672
5/20/2015,16,10783,888,4125,668,83,68,16615
5/20/2015,17,10779,888,4509,592,60,83,16911
5/20/2015,18,10780,892,4813,603,31,80,17199
5/20/2015,19,10786,894,4923,461,7,89,17160
5/20/2015,20,10783,898,5073,399,1,90,17244
5/20/2015,21,10768,898,5164,259,0,89,17178
5/20/2015,22,10776,899,4387,226,0,85,16373
5/20/2015,23,10777,895,3809,195,0,41,15717
5/20/2015,24,10634,890,3698,192,0,26,15440
5/21/2015,1,10474,893,3581,394,0,19,15361
5/21/2015,2,10471,894,3293,330,0,19,15007
5/21/2015,3,10288,894,3334,469,0,12,14997
5/21/2015,4,10237,898,3352,539,0,1,15027
5/21/2015,5,10392,895,3667,516,0,1,15471
5/21/2015,6,10752,904,3996,424,1,2,16079
5/21/2015,7,10778,915,4467,367,10,33,16570
5/21/2015,8,10787,950,4353,304,30,59,16483
5/21/2015,9,10787,965,4343,308,69,56,16528
5/21/2015,10,10773,955,4236,446,87,48,16545
5/21/2015,11,10683,951,4140,581,96,57,16508
5/21/2015,12,10685,951,4180,697,97,70,16680
5/21/2015,13,10686,953,4114,970,96,78,16897
5/21/2015,14,10683,984,4131,1019,95,78,16990
5/21/2015,15,10681,1001,4251,1247,69,74,17323
5/21/2015,16,10682,1007,4256,1497,57,76,17575
5/21/2015,17,10679,1019,4261,1286,46,82,17373
5/21/2015,18,10684,1101,4672,1252,21,83,17813
5/21/2015,19,10677,1139,4868,1291,7,78,18060
5/21/2015,20,10672,1149,4958,1237,0,81,18097
5/21/2015,21,10673,1148,5008,1367,0,81,18277
5/21/2015,22,10673,1144,4360,1483,0,77,17737
5/21/2015,23,10648,1112,3629,1227,0,34,16650
5/21/2015,24,10211,1102,3271,1074,0,16,15674
5/22/2015,1,9670,969,3261,1256,0,15,15171
5/22/2015,2,9514,905,3283,1102,0,6,14810
5/22/2015,3,9517,907,3417,783,0,2,14626
5/22/2015,4,9907,907,3344,591,0,1,14750
5/22/2015,5,10421,912,3260,593,0,1,15187
5/22/2015,6,10679,920,3782,464,2,20,15867
5/22/2015,7,10679,925,4303,457,14,19,16397
5/22/2015,8,10679,955,4225,470,42,50,16421
5/22/2015,9,10678,955,4350,506,71,66,16626
5/22/2015,10,10675,945,4036,787,92,61,16596
5/22/2015,11,10678,949,4089,1046,84,51,16897
5/22/2015,12,10678,946,4093,1408,62,51,17238
5/22/2015,13,10675,949,3978,1321,75,50,17048
5/22/2015,14,10673,949,4079,1229,73,51,17054
5/22/2015,15,10670,945,4095,1094,86,51,16941
5/22/2015,16,10671,946,4257,935,86,50,16945
5/22/2015,17,10669,914,4313,863,61,51,16871
5/22/2015,18,10666,908,4573,1041,30,51,17269
5/22/2015,19,10715,909,4739,845,6,51,17265
5/22/2015,20,10760,913,4677,472,1,51,16874
5/22/2015,21,10761,914,5095,391,0,51,17212
5/22/2015,22,10769,892,4593,430,0,55,16739
5/22/2015,23,10780,530,4486,304,0,53,16153
5/22/2015,24,10782,434,4228,204,0,2,15650
5/23/2015,1,10789,416,3830,244,0,0,15279
5/23/2015,2,10802,407,3439,287,0,0,14935
5/23/2015,3,10803,405,3279,367,0,0,14854
5/23/2015,4,10807,404,3220,344,0,0,14775
5/23/2015,5,10591,409,3251,418,0,0,14669
5/23/2015,6,10503,410,3347,532,3,0,14795
5/23/2015,7,10502,409,3641,647,15,6,15220
5/23/2015,8,10501,410,4079,503,44,11,15548
5/23/2015,9,10498,405,4275,642,73,23,15916
5/23/2015,10,10515,405,4314,796,94,21,16145
5/23/2015,11,10775,401,3968,890,98,22,16154
5/23/2015,12,10789,402,3649,1008,98,12,15958
5/23/2015,13,10763,399,3487,1040,98,0,15787
5/23/2015,14,10779,397,3378,893,97,0,15544
5/23/2015,15,10792,398,3415,709,97,1,15412
5/23/2015,16,10790,401,3550,969,86,1,15797
5/23/2015,17,10786,402,3948,892,59,0,16087
5/23/2015,18,10788,406,4329,961,29,0,16513
5/23/2015,19,10794,407,4267,923,9,0,16400
5/23/2015,20,10787,404,4238,1024,1,0,16454
5/23/2015,21,10774,404,4434,1281,0,0,16893
5/23/2015,22,10784,404,3918,1145,0,1,16252
5/23/2015,23,10772,405,3247,1271,0,2,15697
5/23/2015,24,10303,408,3147,893,0,2,14753
5/24/2015,1,9679,410,3271,804,0,2,14166
5/24/2015,2,9658,411,3292,670,0,2,14033
5/24/2015,3,9663,413,3169,865,0,3,14113
5/24/2015,4,9660,410,3152,452,0,3,13677
5/24/2015,5,9358,410,3162,592,0,3,13525
5/24/2015,6,9140,411,3266,366,1,2,13186
5/24/2015,7,9140,411,3499,495,13,2,13560
5/24/2015,8,9135,420,4476,555,40,2,14628
5/24/2015,9,9371,423,4860,357,67,3,15081
5/24/2015,10,9644,418,4570,529,85,4,15250
5/24/2015,11,9912,403,4044,855,97,4,15315
5/24/2015,12,9964,388,4214,956,98,5,15625
5/24/2015,13,9965,392,4272,923,97,4,15653
5/24/2015,14,9963,390,4240,954,94,11,15652
5/24/2015,15,9968,390,4409,931,74,33,15805
5/24/2015,16,9981,386,4915,853,56,68,16259
5/24/2015,17,9989,395,5232,797,32,69,16514
5/24/2015,18,9987,395,5384,785,19,68,16638
5/24/2015,19,9984,400,5263,822,6,68,16543
5/24/2015,20,9972,402,5476,776,0,66,16692
5/24/2015,21,9974,578,5454,931,0,68,17005
5/24/2015,22,9976,681,4705,1005,0,69,16436
5/24/2015,23,9976,548,4126,1053,0,65,15768
5/24/2015,24,9987,407,3318,1248,0,25,14985
5/25/2015,1,9977,406,3238,1234,0,16,14871
5/25/2015,2,9817,404,3169,1149,0,16,14555
5/25/2015,3,9704,414,3140,1152,0,17,14427
5/25/2015,4,9701,492,3127,1129,0,17,14466
5/25/2015,5,9696,525,3222,1220,0,23,14686
5/25/2015,6,9703,702,3232,1270,1,26,14934
5/25/2015,7,9705,868,3940,1247,12,52,15824
5/25/2015,8,9706,903,4833,1831,37,57,17367
5/25/2015,9,9960,930,4766,2020,57,61,17794
5/25/2015,10,10002,947,5167,2242,70,64,18492
5/25/2015,11,10002,1028,5299,2260,48,77,18714
5/25/2015,12,10001,1078,4647,2305,95,99,18225
5/25/2015,13,9996,1147,4101,2470,90,87,17891
5/25/2015,14,10001,1336,4392,2640,83,87,18539
5/25/2015,15,9999,1549,4978,2610,68,88,19292
5/25/2015,16,9995,1714,5156,2579,45,85,19574
5/25/2015,17,9993,2051,5312,2622,21,82,20081
5/25/2015,18,9990,2165,5068,2558,19,88,19888
5/25/2015,19,9995,2216,5098,2452,8,108,19877
5/25/2015,20,9995,2204,4940,2448,1,65,19653
5/25/2015,21,9985,2109,4652,2332,0,50,19128
5/25/2015,22,9988,1823,4422,2161,0,42,18436
5/25/2015,23,9979,1266,4029,2182,0,20,17476
5/25/2015,24,9974,1097,3921,1839,0,41,16872
5/26/2015,1,9979,930,3781,1720,0,71,16481
5/26/2015,2,9987,949,3415,1570,0,85,16006
5/26/2015,3,10022,1073,3367,1507,0,85,16054
5/26/2015,4,9939,1249,3366,1256,0,86,15896
5/26/2015,5,10120,1386,3539,1012,0,111,16168
5/26/2015,6,10105,1438,3983,1236,1,115,16878
5/26/2015,7,10262,1576,5066,1160,15,121,18200
5/26/2015,8,10446,1813,4956,953,35,123,18326
5/26/2015,9,10754,1928,4830,850,57,127,18546
5/26/2015,10,10766,2101,4648,793,73,128,18509
5/26/2015,11,10837,2314,4692,893,70,126,18932
5/26/2015,12,11094,2427,4499,990,89,127,19226
5/26/2015,13,11261,2364,4380,1198,77,126,19406
5/26/2015,14,11275,2435,4481,1104,89,121,19505
5/26/2015,15,11272,2479,4902,1088,87,123,19951
5/26/2015,16,11279,2612,4933,1164,69,129,20186
5/26/2015,17,11272,2572,5133,1380,43,127,20527
5/26/2015,18,11283,2568,5146,1577,22,96,20692
5/26/2015,19,11286,2371,5116,1893,7,72,20745
5/26/2015,20,11286,2378,4936,2021,1,74,20696
5/26/2015,21,11338,2076,4726,2239,0,74,20453
5/26/2015,22,11495,1690,4116,2056,0,70,19427
5/26/2015,23,11526,1478,3865,1329,0,30,18228
5/26/2015,24,11310,998,3551,1841,0,20,17720
5/27/2015,1,11244,871,3098,2253,0,27,17493
5/27/2015,2,11260,871,3071,1817,0,26,17045
5/27/2015,3,11096,873,3042,1784,0,20,16815
5/27/2015,4,10684,872,3101,1965,0,22,16644
5/27/2015,5,10415,868,3170,1454,0,40,15947
5/27/2015,6,10420,870,3653,2303,0,52,17298
5/27/2015,7,10540,886,4205,2199,7,54,17891
5/27/2015,8,10977,892,4549,2343,14,60,18835
5/27/2015,9,11475,888,4290,2356,29,67,19105
5/27/2015,10,11539,960,4277,1944,56,60,18836
5/27/2015,11,11504,962,4387,2033,85,50,19021
5/27/2015,12,11504,1105,4379,2070,96,51,19205
5/27/2015,13,11545,1274,4350,2199,96,51,19515
5/27/2015,14,11415,1436,4365,2055,95,50,19416
5/27/2015,15,11375,1679,4384,2065,93,52,19648
5/27/2015,16,11462,1953,4358,2177,78,52,20080
5/27/2015,17,11519,2097,4484,1924,26,56,20106
5/27/2015,18,11523,2114,4649,1507,6,53,19852
5/27/2015,19,11515,2114,4827,1568,2,12,20038
5/27/2015,20,11516,2121,5164,1267,0,0,20068
5/27/2015,21,11512,1931,4954,1171,0,0,19568
5/27/2015,22,11509,1235,4281,1286,0,0,18311
5/27/2015,23,11363,925,3714,1153,0,0,17155
5/27/2015,24,11220,831,3365,1078,0,0,16494
5/28/2015,1,11150,831,3199,970,0,0,16150
5/28/2015,2,10841,832,3301,742,0,0,15716
5/28/2015,3,10705,837,3259,658,0,0,15459
5/28/2015,4,10725,838,3287,523,0,0,15373
5/28/2015,5,10413,839,3520,534,0,1,15307
5/28/2015,6,10134,839,3581,408,1,4,14967
5/28/2015,7,10646,847,4290,285,14,4,16086
5/28/2015,8,11445,968,4420,233,39,15,17120
5/28/2015,9,11581,1127,4366,181,64,58,17377
5/28/2015,10,11583,1266,4562,130,84,60,17685
5/28/2015,11,11582,1352,4544,181,95,60,17814
5/28/2015,12,11591,1394,4518,214,96,53,17866
5/28/2015,13,11483,1429,4878,231,96,63,18180
5/28/2015,14,11478,1535,4764,238,96,74,18185
5/28/2015,15,11566,1551,4970,205,94,85,18471
5/28/2015,16,11594,1542,4879,297,79,85,18476
5/28/2015,17,11600,1541,4865,315,55,85,18461
5/28/2015,18,11598,1541,4956,277,28,84,18484
5/28/2015,19,11592,1556,4985,303,7,87,18530
5/28/2015,20,11589,1697,4792,314,1,88,18481
5/28/2015,21,11588,1618,5030,376,0,87,18699
5/28/2015,22,11601,995,4659,519,0,57,17831
5/28/2015,23,11456,745,3847,626,0,26,16700
5/28/2015,24,10982,737,3403,664,0,21,15807
5/29/2015,1,10752,736,3356,757,0,20,15621
5/29/2015,2,10488,737,3226,877,0,20,15348
5/29/2015,3,10312,752,3208,928,0,20,15220
5/29/2015,4,10171,774,3313,952,0,21,15231
5/29/2015,5,10166,832,3265,1337,0,26,15626
5/29/2015,6,10172,833,3663,1412,2,29,16111
5/29/2015,7,10582,834,4345,1206,14,47,17028
5/29/2015,8,11242,839,4318,988,38,74,17499
5/29/2015,9,11613,829,4069,805,58,80,17454
5/29/2015,10,11604,827,4280,809,81,83,17684
5/29/2015,11,11599,824,4858,723,84,84,18172
5/29/2015,12,11595,822,5037,667,94,84,18299
5/29/2015,13,11596,817,5232,682,84,83,18494
5/29/2015,14,11602,826,5361,736,68,87,18680
5/29/2015,15,11593,827,5448,688,63,89,18708
5/29/2015,16,11586,831,5513,620,43,90,18683
5/29/2015,17,11579,835,5581,610,24,88,18717
5/29/2015,18,11577,822,5315,770,24,87,18595
5/29/2015,19,11583,828,5115,837,10,87,18460
5/29/2015,20,11585,821,5257,893,2,86,18644
5/29/2015,21,11576,823,4902,1061,0,85,18447
5/29/2015,22,11574,803,4397,948,0,85,17807
5/29/2015,23,11514,497,3914,1295,0,43,17263
5/29/2015,24,11179,399,3574,1353,0,2,16507
5/30/2015,1,11027,399,3599,872,0,2,15899
5/30/2015,2,10615,399,3505,712,0,2,15233
5/30/2015,3,10207,401,3507,1024,0,2,15141
5/30/2015,4,10127,404,3463,1114,0,2,15110
5/30/2015,5,10122,403,3489,1215,0,3,15232
5/30/2015,6,10117,400,3561,1265,1,4,15348
5/30/2015,7,10188,400,3704,1924,14,4,16234
5/30/2015,8,10938,405,3915,2171,35,5,17469
5/30/2015,9,11394,404,4350,1976,64,5,18193
5/30/2015,10,11581,405,4982,1703,87,9,18767
5/30/2015,11,11574,425,5465,1486,91,21,19062
5/30/2015,12,11570,443,5297,1611,97,54,19072
5/30/2015,13,11571,408,5079,1866,97,60,19081
5/30/2015,14,11580,399,5228,1410,96,65,18778
5/30/2015,15,11575,401,5750,1035,94,64,18919
5/30/2015,16,11577,501,6142,771,62,73,19126
5/30/2015,17,11575,701,5575,730,55,59,18695
5/30/2015,18,11586,652,4642,1043,23,60,18006
5/30/2015,19,11597,397,4556,1161,4,57,17772
5/30/2015,20,11598,402,4652,1039,1,60,17752
5/30/2015,21,11591,403,4383,1280,0,58,17715
5/30/2015,22,11519,412,3837,758,0,58,16584
5/30/2015,23,11078,406,3516,1120,0,58,16178
5/30/2015,24,10607,404,3505,1036,0,24,15576
5/31/2015,1,10381,404,3433,850,0,5,15073
5/31/2015,2,10016,406,3384,972,0,7,14785
5/31/2015,3,9680,406,3440,1028,0,6,14560
5/31/2015,4,9675,405,3440,866,0,5,14391
5/31/2015,5,9680,402,3504,695,0,3,14284
5/31/2015,6,9677,400,3416,701,0,3,14197
5/31/2015,7,9679,403,3419,1069,3,3,14576
5/31/2015,8,9819,399,3558,1823,6,4,15609
5/31/2015,9,10114,396,3697,1787,10,4,16008
5/31/2015,10,10346,398,3738,1875,16,5,16378
5/31/2015,11,10571,394,4094,1637,10,4,16710
5/31/2015,12,10567,393,4113,1212,17,4,16306
5/31/2015,13,10555,390,4046,1516,19,4,16530
5/31/2015,14,10522,390,3811,377,12,4,15116
5/31/2015,15,10560,390,3822,1203,10,5,15990
5/31/2015,16,10561,389,3905,2135,6,7,17003
5/31/2015,17,10749,387,4238,2049,3,14,17440
5/31/2015,18,10803,387,4478,2142,1,44,17855
5/31/2015,19,10804,395,4602,2097,2,57,17957
5/31/2015,20,10794,405,4520,1852,0,71,17642
5/31/2015,21,10793,407,4586,1686,0,71,17543
5/31/2015,22,10794,407,4028,1533,0,72,16834
5/31/2015,23,10801,381,3463,1432,0,33,16110
5/31/2015,24,10732,379,3265,961,0,18,15355
6/1/2015,1,10477,404,3269,1013,0,18,15181
6/1/2015,2,10248,403,3294,1235,0,17,15197
6/1/2015,3,10247,412,3407,1268,0,17,15351
6/1/2015,4,10242,472,3459,1236,0,17,15426
6/1/2015,5,10397,531,3521,1253,0,27,15729
6/1/2015,6,10621,635,3572,1072,4,32,15936
6/1/2015,7,10801,720,4113,749,14,46,16443
6/1/2015,8,10795,727,4694,698,17,53,16984
6/1/2015,9,10802,771,4619,710,30,57,16989
6/1/2015,10,10796,819,4912,575,31,79,17212
6/1/2015,11,10798,872,5207,506,40,105,17528
6/1/2015,12,10794,917,5176,584,40,100,17611
6/1/2015,13,10799,933,5004,657,45,105,17543
6/1/2015,14,10803,958,4869,698,40,102,17470
6/1/2015,15,10803,978,4640,719,36,95,17271
6/1/2015,16,10803,1043,4727,685,29,94,17381
6/1/2015,17,10802,1099,4796,551,19,93,17360
6/1/2015,18,10802,1092,4986,542,8,92,17522
6/1/2015,19,10802,1095,4935,417,4,87,17340
6/1/2015,20,10798,1100,5402,290,1,83,17674
6/1/2015,21,10802,1104,5411,212,0,80,17609
6/1/2015,22,10801,1107,4705,256,0,80,16949
6/1/2015,23,10803,946,4064,282,0,30,16125
6/1/2015,24,10715,893,3705,215,0,17,15545
6/2/2015,1,10265,895,3742,217,0,16,15135
6/2/2015,2,9993,897,3542,191,0,16,14639
6/2/2015,3,9965,898,3577,136,0,18,14594
6/2/2015,4,9963,897,3829,136,1,20,14846
6/2/2015,5,10169,896,4117,166,1,19,15368
6/2/2015,6,10444,895,4150,199,6,37,15731
6/2/2015,7,10756,900,4359,172,17,70,16274
6/2/2015,8,10943,895,4472,136,37,89,16572
6/2/2015,9,11082,898,4388,129,69,88,16654
6/2/2015,10,11249,905,4445,143,93,90,16925
6/2/2015,11,11220,913,4586,180,96,89,17084
6/2/2015,12,11203,901,4500,180,96,89,16969
6/2/2015,13,11361,877,4022,224,91,87,16662
6/2/2015,14,11399,874,4089,241,95,83,16781
6/2/2015,15,11406,880,4080,228,96,84,16774
6/2/2015,16,11409,875,4386,335,85,84,17174
6/2/2015,17,11408,882,4281,373,59,85,17088
6/2/2015,18,11407,884,4743,352,31,83,17500
6/2/2015,19,11409,891,4955,405,7,84,17751
6/2/2015,20,11401,896,4825,408,1,88,17619
6/2/2015,21,11397,899,4835,501,0,86,17718
6/2/2015,22,11398,901,4358,602,0,59,17318
6/2/2015,23,11392,889,3603,647,0,16,16547
6/2/2015,24,10922,891,3504,680,0,15,16012
6/3/2015,1,10508,891,3506,711,0,13,15629
6/3/2015,2,10052,895,3430,543,0,15,14935
6/3/2015,3,9959,897,3414,582,0,18,14870
6/3/2015,4,9963,898,3375,637,0,19,14892
6/3/2015,5,9958,899,3456,968,0,22,15303
6/3/2015,6,9976,907,3716,1044,2,28,15673
6/3/2015,7,10323,901,4201,995,14,33,16467
6/3/2015,8,10754,881,4119,688,42,35,16519
6/3/2015,9,11008,895,3785,456,71,35,16250
6/3/2015,10,11007,896,3710,417,92,35,16157
6/3/2015,11,11008,892,3741,592,96,44,16373
6/3/2015,12,11008,889,3747,607,97,42,16390
6/3/2015,13,11009,885,3832,618,97,45,16486
6/3/2015,14,11005,884,4059,358,96,78,16480
6/3/2015,15,11024,884,4143,376,96,94,16617
6/3/2015,16,11342,884,4183,468,84,98,17059
6/3/2015,17,11573,893,4266,485,59,98,17374
6/3/2015,18,11613,893,4357,456,30,103,17452
6/3/2015,19,11612,894,4511,465,7,121,17610
6/3/2015,20,11608,898,4585,668,1,133,17893
6/3/2015,21,11600,900,4369,812,0,130,17811
6/3/2015,22,11602,899,3628,892,0,113,17134
6/3/2015,23,11538,895,3463,585,0,25,16506
6/3/2015,24,11164,897,3365,606,0,1,16033
6/4/2015,1,10487,897,3416,727,0,4,15531
6/4/2015,2,10255,896,3320,737,0,8,15216
6/4/2015,3,10184,944,3420,685,0,7,15240
6/4/2015,4,9967,946,3454,817,0,0,15184
6/4/2015,5,9961,966,4002,667,0,0,15596
6/4/2015,6,10346,981,4314,431,2,0,16074
6/4/2015,7,10722,1006,4455,303,13,1,16500
6/4/2015,8,10727,1046,4703,213,24,16,16729
6/4/2015,9,10732,1072,4844,188,32,56,16924
6/4/2015,10,10727,1096,4909,183,55,106,17076
6/4/2015,11,10726,1115,5014,179,95,105,17234
6/4/2015,12,10727,1166,4768,243,97,67,17068
6/4/2015,13,10728,1131,5156,286,97,91,17489
6/4/2015,14,10724,1288,5178,272,96,108,17666
6/4/2015,15,10728,1310,5319,318,94,102,17871
6/4/2015,16,10732,1291,5455,340,79,105,18002
6/4/2015,17,10731,1307,5497,423,55,104,18117
6/4/2015,18,10730,1298,5234,435,26,92,17815
6/4/2015,19,10730,1296,5150,467,5,71,17719
6/4/2015,20,10726,1296,5345,486,2,91,17946
6/4/2015,21,10730,1298,5401,736,0,119,18284
6/4/2015,22,10727,1295,4572,698,0,136,17428
6/4/2015,23,10732,963,4350,695,0,117,16857
6/4/2015,24,10664,840,3692,707,0,40,15943
6/5/2015,1,10439,838,3374,813,0,18,15482
6/5/2015,2,10433,876,3278,835,0,19,15441
6/5/2015,3,10440,896,3308,757,0,21,15422
6/5/2015,4,10442,935,3398,660,0,22,15457
6/5/2015,5,10520,997,3605,538,0,25,15685
6/5/2015,6,10730,1131,3930,375,2,51,16219
6/5/2015,7,10729,1261,4301,284,13,92,16680
6/5/2015,8,10723,1276,4723,250,37,129,17138
6/5/2015,9,10713,1278,5358,208,58,131,17746
6/5/2015,10,10710,1372,5810,180,79,136,18287
6/5/2015,11,10706,1426,5642,239,94,139,18246
6/5/2015,12,10708,1439,5492,243,91,138,18111
6/5/2015,13,10720,1575,5604,298,88,135,18420
6/5/2015,14,10724,1481,5433,437,88,134,18297
6/5/2015,15,10722,1371,5093,746,26,138,18096
6/5/2015,16,10720,1333,4847,869,24,137,17930
6/5/2015,17,10723,1337,4711,1186,12,134,18103
6/5/2015,18,10724,1005,4405,1475,12,133,17754
6/5/2015,19,10725,919,4298,1580,7,99,17628
6/5/2015,20,10723,924,4343,1601,1,96,17688
6/5/2015,21,10714,931,4325,1736,0,127,17833
6/5/2015,22,10725,860,4026,1706,0,118,17435
6/5/2015,23,10665,737,3508,1737,0,50,16697
6/5/2015,24,10486,720,3331,1656,0,2,16195
6/6/2015,1,10413,724,3174,1762,0,2,16075
6/6/2015,2,10154,724,3145,1601,0,3,15627
6/6/2015,3,10081,715,3108,1327,0,3,15234
6/6/2015,4,9853,715,3093,1406,0,2,15069
6/6/2015,5,9850,721,3047,1279,0,2,14899
6/6/2015,6,9850,715,3139,1207,2,2,14915
6/6/2015,7,9920,694,3395,1144,15,2,15170
6/6/2015,8,10139,692,3413,887,41,2,15174
6/6/2015,9,10139,688,3484,682,71,2,15066
6/6/2015,10,10369,677,3975,516,93,4,15634
6/6/2015,11,10640,685,3819,414,96,25,15679
6/6/2015,12,10687,689,3736,422,97,60,15691
6/6/2015,13,10678,696,3319,455,96,73,15317
6/6/2015,14,10677,699,3605,430,96,58,15565
6/6/2015,15,10679,699,3728,465,95,77,15743
6/6/2015,16,10673,697,3882,419,87,91,15849
6/6/2015,17,10664,699,4405,422,62,102,16354
6/6/2015,18,10669,701,4871,345,30,104,16720
6/6/2015,19,10663,699,5039,285,8,103,16797
6/6/2015,20,10671,704,4702,286,1,101,16465
6/6/2015,21,10667,708,4462,384,0,104,16325
6/6/2015,22,10666,710,4108,565,0,85,16134
6/6/2015,23,10685,709,3521,914,0,16,15845
6/6/2015,24,10472,720,3222,1152,0,2,15568
6/7/2015,1,10153,709,3074,1337,0,2,15275
6/7/2015,2,9975,708,3106,1237,0,2,15028
6/7/2015,3,9555,709,3174,1250,0,2,14690
6/7/2015,4,9322,709,3261,1421,0,2,14715
6/7/2015,5,9240,704,3155,1501,1,2,14603
6/7/2015,6,9242,703,3317,1399,2,2,14665
6/7/2015,7,9239,702,3654,1137,14,2,14748
6/7/2015,8,9485,697,4027,955,42,2,15208
6/7/2015,9,9974,698,4053,883,69,2,15679
6/7/2015,10,10075,691,3790,1035,89,2,15682
6/7/2015,11,10288,690,4032,1342,96,2,16450
6/7/2015,12,10572,689,3644,1628,95,2,16630
6/7/2015,13,10492,687,3479,1621,96,2,16377
6/7/2015,14,10358,686,3523,1305,83,2,15957
6/7/2015,15,10359,690,3511,1430,62,3,16055
6/7/2015,16,10363,687,3592,1752,51,2,16447
6/7/2015,17,10372,687,3612,2067,31,2,16771
6/7/2015,18,10399,690,3844,2216,10,2,17161
6/7/2015,19,10399,693,3985,2160,7,2,17246
6/7/2015,20,10394,690,4429,2002,2,2,17519
6/7/2015,21,10390,690,4307,2154,0,2,17543
6/7/2015,22,10389,699,3916,2276,0,2,17282
6/7/2015,23,10399,699,3597,2178,0,1,16874
6/7/2015,24,10400,702,3154,1763,0,5,16024
6/8/2015,1,10001,705,3131,1481,0,17,15335
6/8/2015,2,9859,735,3034,1626,0,18,15272
6/8/2015,3,9701,788,3110,1644,0,18,15261
6/8/2015,4,9556,818,3399,1728,0,20,15521
6/8/2015,5,9949,855,3714,1355,0,24,15897
6/8/2015,6,10474,1006,3765,1167,0,30,16442
6/8/2015,7,9894,1206,4795,1170,0,34,17099
6/8/2015,8,9886,1441,4898,1237,1,33,17496
6/8/2015,9,9882,1555,5041,1157,7,32,17674
6/8/2015,10,9888,1610,5339,886,32,33,17788
6/8/2015,11,9893,1731,5238,1003,22,33,17920
6/8/2015,12,9895,1870,5086,985,21,33,17890
6/8/2015,13,9894,2395,5147,751,17,34,18238
6/8/2015,14,9900,2620,4662,872,25,35,18114
6/8/2015,15,9902,2852,4473,838,37,34,18136
6/8/2015,16,9896,2834,4428,1025,41,34,18258
6/8/2015,17,9898,2598,4846,915,31,33,18321
6/8/2015,18,9904,2489,5118,695,21,34,18261
6/8/2015,19,9904,2491,5190,545,13,33,18176
6/8/2015,20,9900,2486,5006,716,1,33,18142
6/8/2015,21,9903,2320,4768,952,0,33,17976
6/8/2015,22,9901,2208,4158,1024,0,33,17324
6/8/2015,23,9910,1726,4060,951,0,26,16673
6/8/2015,24,9902,1086,4290,695,0,20,15993
6/9/2015,1,9904,819,4593,500,0,19,15835
6/9/2015,2,9910,823,4443,387,0,19,15582
6/9/2015,3,9902,889,4138,406,0,20,15355
6/9/2015,4,9899,1128,3891,410,0,20,15348
6/9/2015,5,9904,1522,3836,235,0,23,15520
6/9/2015,6,9909,1764,3940,236,0,27,15876
6/9/2015,7,9915,1888,4630,296,0,33,16762
6/9/2015,8,9908,1865,4754,339,1,31,16898
6/9/2015,9,9914,1868,4906,399,11,35,17133
6/9/2015,10,9909,1924,5029,354,20,34,17270
6/9/2015,11,9903,2054,4917,399,23,34,17330
6/9/2015,12,9897,2175,4802,435,63,34,17406
6/9/2015,13,9901,2286,4718,472,74,34,17485
6/9/2015,14,9904,2505,4354,520,51,34,17368
6/9/2015,15,9905,2538,4534,494,59,33,17563
6/9/2015,16,9900,2432,4981,552,71,34,17970
6/9/2015,17,9896,2516,5417,445,57,34,18365
6/9/2015,18,9894,2489,5470,347,30,33,18263
6/9/2015,19,9896,2483,5496,317,8,33,18233
6/9/2015,20,9889,2488,5513,306,1,33,18230
6/9/2015,21,9889,2591,5435,339,0,33,18287
6/9/2015,22,9892,1696,5005,417,0,33,17043
6/9/2015,23,9892,997,4751,513,0,25,16178
6/9/2015,24,9896,843,4112,623,0,20,15494
6/10/2015,1,9905,848,3519,796,0,18,15086
6/10/2015,2,9906,851,3474,1004,0,18,15253
6/10/2015,3,9886,852,3469,1188,0,19,15414
6/10/2015,4,9661,852,3107,426,0,19,14065
6/10/2015,5,9658,854,3413,1340,0,21,15286
6/10/2015,6,9664,848,3811,1877,3,28,16231
6/10/2015,7,9664,832,4161,1929,15,34,16635
6/10/2015,8,9855,864,4242,2224,36,34,17255
6/10/2015,9,9811,873,4344,2454,59,31,17572
6/10/2015,10,9802,965,4455,2746,85,30,18083
6/10/2015,11,10001,1082,4640,2803,81,33,18640
6/10/2015,12,10064,1466,4490,2519,49,34,18622
6/10/2015,13,10064,1788,4293,2651,86,34,18916
6/10/2015,14,10132,2037,4301,2534,80,33,19117
6/10/2015,15,10367,2064,4507,2228,79,34,19279
6/10/2015,16,10552,2145,4570,2628,79,34,20008
6/10/2015,17,10551,2154,4831,2614,55,34,20239
6/10/2015,18,10552,2156,4795,2319,17,32,19871
6/10/2015,19,10546,2149,5014,1971,8,32,19720
6/10/2015,20,10548,2161,5378,1351,3,33,19474
6/10/2015,21,10538,2143,5296,1196,0,34,19207
6/10/2015,22,10551,1328,4632,1052,0,34,17597
6/10/2015,23,10564,872,4398,859,0,24,16717
6/10/2015,24,10575,834,3882,715,0,20,16026
6/11/2015,1,10586,834,3769,595,0,20,15804
6/11/2015,2,10675,834,3682,572,0,20,15783
6/11/2015,3,10676,843,3674,577,0,20,15790
6/11/2015,4,10695,902,3736,543,0,21,15897
6/11/2015,5,10699,988,3786,482,0,23,15978
6/11/2015,6,10694,1051,3917,370,2,28,16062
6/11/2015,7,10689,1119,4471,264,14,34,16591
6/11/2015,8,10683,1345,4736,222,41,34,17061
6/11/2015,9,10581,1597,4568,216,65,34,17061
6/11/2015,10,10613,1703,4729,204,86,34,17369
6/11/2015,11,10615,1764,4732,240,95,33,17479
6/11/2015,12,10686,1675,4863,253,97,34,17608
6/11/2015,13,10721,1741,5126,224,93,34,17939
6/11/2015,14,10718,2233,4874,224,83,33,18165
6/11/2015,15,10719,2803,4601,218,46,34,18421
6/11/2015,16,10730,3215,4367,209,28,34,18583
6/11/2015,17,10722,3236,4484,211,13,35,18701
6/11/2015,18,10721,2944,4327,246,14,8,18260
6/11/2015,19,10723,2693,4617,333,8,0,18374
6/11/2015,20,10719,2247,4896,288,1,0,18151
6/11/2015,21,10705,1805,5401,310,0,5,18226
6/11/2015,22,10713,1193,5393,409,0,0,17708
6/11/2015,23,10715,895,4980,352,0,6,16948
6/11/2015,24,10727,835,3598,617,0,14,15791
6/12/2015,1,10732,838,3276,659,0,18,15523
6/12/2015,2,10726,842,3178,722,0,20,15488
6/12/2015,3,10729,842,3236,852,0,21,15680
6/12/2015,4,10730,845,3310,827,0,22,15734
6/12/2015,5,10728,846,3499,760,0,21,15854
6/12/2015,6,10730,846,3934,610,1,27,16148
6/12/2015,7,10729,848,4619,501,12,32,16741
6/12/2015,8,10725,1055,5304,497,21,35,17637
6/12/2015,9,10628,1126,5124,566,41,35,17520
6/12/2015,10,10622,1009,5328,617,72,35,17683
6/12/2015,11,10619,843,5205,930,85,37,17719
6/12/2015,12,10707,836,5503,893,85,35,18059
6/12/2015,13,10567,849,5620,1025,89,35,18185
6/12/2015,14,10580,832,4972,1458,28,34,17904
6/12/2015,15,10723,806,4914,1133,48,33,17657
6/12/2015,16,10726,809,4986,1065,28,33,17647
6/12/2015,17,10718,809,4943,1419,17,34,17940
6/12/2015,18,10724,804,4901,1379,13,34,17855
6/12/2015,19,10723,799,4851,1354,8,35,17770
6/12/2015,20,10722,803,4692,1152,2,35,17406
6/12/2015,21,10707,811,5542,735,0,35,17830
6/12/2015,22,10710,810,5075,470,0,36,17101
6/12/2015,23,10711,808,4384,391,0,28,16322
6/12/2015,24,10712,808,3774,194,0,22,15510
6/13/2015,1,10720,808,3451,128,0,22,15129
6/13/2015,2,10720,728,3309,130,0,23,14910
6/13/2015,3,10603,688,3257,116,0,22,14686
6/13/2015,4,10487,681,3444,120,0,22,14754
6/13/2015,5,10484,678,3332,138,0,23,14655
6/13/2015,6,10485,676,3512,171,0,22,14866
6/13/2015,7,10490,673,3585,233,3,22,15006
6/13/2015,8,10677,666,4043,237,9,22,15654
6/13/2015,9,10725,662,4476,243,11,22,16139
6/13/2015,10,10721,660,4639,271,17,22,16330
6/13/2015,11,10703,658,4756,306,34,21,16478
6/13/2015,12,10692,659,4635,386,54,22,16448
6/13/2015,13,10692,667,4731,419,73,22,16604
6/13/2015,14,10701,682,4590,453,79,22,16527
6/13/2015,15,10706,751,4570,353,84,22,16486
6/13/2015,16,10709,775,4901,337,76,23,16821
6/13/2015,17,10710,830,5452,323,55,21,17391
6/13/2015,18,10705,1103,5222,267,30,20,17347
6/13/2015,19,10705,1066,5292,284,7,22,17376
6/13/2015,20,10699,835,5139,293,1,21,16988
6/13/2015,21,10707,807,5167,304,0,22,17007
6/13/2015,22,10705,839,4984,283,0,20,16831
6/13/2015,23,10711,827,4780,237,0,20,16575
6/13/2015,24,10723,794,3853,289,0,19,15678
6/14/2015,1,10724,794,3611,392,0,19,15540
6/14/2015,2,10723,794,3546,324,0,19,15406
6/14/2015,3,10720,795,3131,366,0,19,15031
6/14/2015,4,10644,792,3133,430,0,21,15020
6/14/2015,5,10389,790,3125,486,0,23,14813
6/14/2015,6,10157,788,3129,497,1,21,14593
6/14/2015,7,10156,785,3358,513,5,21,14838
6/14/2015,8,10226,781,3945,619,20,21,15612
6/14/2015,9,10458,778,4046,610,22,21,15935
6/14/2015,10,10523,775,4386,686,38,22,16430
6/14/2015,11,10705,773,4745,664,15,22,16924
6/14/2015,12,10704,815,5174,580,11,22,17306
6/14/2015,13,10708,822,5076,587,6,23,17222
6/14/2015,14,10705,782,5065,452,18,24,17046
6/14/2015,15,10709,856,5463,345,34,27,17434
6/14/2015,16,10709,827,5501,335,56,26,17454
6/14/2015,17,10710,1076,5699,162,29,26,17702
6/14/2015,18,10698,1076,5029,128,3,23,16957
6/14/2015,19,10681,1089,5136,177,1,23,17107
6/14/2015,20,10671,842,5192,220,1,22,16948
6/14/2015,21,10668,1057,5328,177,0,21,17251
6/14/2015,22,10681,1073,5179,220,0,23,17176
6/14/2015,23,10684,888,4729,376,0,22,16699
6/14/2015,24,10689,788,3941,444,0,21,15883
6/15/2015,1,10698,795,3519,496,0,22,15530
6/15/2015,2,10695,798,3891,406,0,23,15813
6/15/2015,3,10699,799,3866,345,0,23,15732
6/15/2015,4,10700,863,3766,346,0,23,15698
6/15/2015,5,10700,908,3810,311,0,25,15754
6/15/2015,6,10710,1018,4085,243,1,29,16086
6/15/2015,7,10714,1205,4505,194,4,34,16656
6/15/2015,8,10711,1521,5067,150,14,36,17499
6/15/2015,9,10711,1756,5053,158,32,37,17747
6/15/2015,10,10709,1836,5129,154,59,37,17924
6/15/2015,11,10712,2206,5042,216,73,37,18286
6/15/2015,12,10714,2355,4944,274,86,37,18410
6/15/2015,13,10708,2668,5120,281,95,36,18908
6/15/2015,14,10703,2976,5308,276,94,42,19399
6/15/2015,15,10704,3122,5496,236,54,43,19655
6/15/2015,16,10702,3396,5533,253,63,48,19995
6/15/2015,17,10700,3666,5547,260,25,49,20247
6/15/2015,18,10703,3553,5503,180,19,49,20007
6/15/2015,19,10701,3193,5510,302,7,47,19760
6/15/2015,20,10699,2929,5560,335,1,40,19564
6/15/2015,21,10680,3013,5515,373,0,38,19619
6/15/2015,22,10681,2175,5019,433,0,35,18343
6/15/2015,23,10698,1662,4490,657,0,27,17534
6/15/2015,24,10693,1105,4220,718,0,25,16761
6/16/2015,1,10694,868,3759,810,0,22,16153
6/16/2015,2,10697,981,3496,721,0,20,15915
6/16/2015,3,10695,1146,3202,812,0,20,15875
6/16/2015,4,10697,1361,3149,826,0,23,16056
6/16/2015,5,10701,1458,3208,952,0,26,16345
6/16/2015,6,10688,1462,3628,918,0,39,16735
6/16/2015,7,10688,1561,4311,650,0,41,17251
6/16/2015,8,10690,1732,4768,624,5,35,17854
6/16/2015,9,10693,1902,4899,655,37,35,18221
6/16/2015,10,10698,1964,5021,863,66,35,18647
6/16/2015,11,10698,2134,5192,804,53,35,18916
6/16/2015,12,10692,2172,5026,844,79,35,18848
6/16/2015,13,10689,2313,5273,835,79,35,19224
6/16/2015,14,10683,2637,5008,945,80,33,19386
6/16/2015,15,10679,2973,4484,1110,97,29,19372
6/16/2015,16,10684,3140,4453,1044,85,33,19439
6/16/2015,17,10678,3154,4449,1105,61,48,19495
6/16/2015,18,10689,3135,4475,983,33,49,19364
6/16/2015,19,10698,2947,4561,752,9,46,19013
6/16/2015,20,10700,2608,4765,534,1,32,18640
6/16/2015,21,10703,2227,4489,398,0,30,17847
6/16/2015,22,10703,1501,4718,389,0,30,17341
6/16/2015,23,10712,958,4602,327,0,25,16624
6/16/2015,24,10719,862,3888,351,0,18,15838
6/17/2015,1,10726,864,3234,291,0,16,15131
6/17/2015,2,10495,875,2898,417,0,16,14701
6/17/2015,3,10415,878,2925,419,0,15,14652
6/17/2015,4,10463,879,2954,447,0,18,14761
6/17/2015,5,10708,881,3014,412,0,24,15039
6/17/2015,6,10709,890,3455,501,3,29,15587
6/17/2015,7,10704,1006,4178,575,17,31,16511
6/17/2015,8,10699,1188,4309,487,32,32,16747
6/17/2015,9,10695,1407,4468,289,72,31,16962
6/17/2015,10,10702,1416,4736,467,86,32,17439
6/17/2015,11,10711,1645,4696,316,80,30,17478
6/17/2015,12,10703,1926,4664,223,88,30,17634
6/17/2015,13,10549,2174,4449,171,87,31,17461
6/17/2015,14,10530,2242,4418,140,71,31,17432
6/17/2015,15,10555,2222,4615,98,71,29,17590
6/17/2015,16,10637,1904,5016,94,58,26,17735
6/17/2015,17,10619,1836,5433,104,39,24,18055
6/17/2015,18,10621,1968,5241,103,23,26,17982
6/17/2015,19,10623,1964,5127,166,10,33,17923
6/17/2015,20,10630,1965,4817,263,2,34,17711
6/17/2015,21,10618,1964,4840,230,0,34,17686
6/17/2015,22,10629,1792,4323,239,0,34,17017
6/17/2015,23,10623,1199,3856,343,0,25,16046
6/17/2015,24,10489,885,3135,525,0,22,15056
6/18/2015,1,10278,868,3044,611,0,20,14821
6/18/2015,2,10072,868,3106,575,0,20,14641
6/18/2015,3,10072,869,3562,447,0,20,14970
6/18/2015,4,10062,868,3678,435,0,20,15063
6/18/2015,5,10066,870,3561,408,1,24,14930
6/18/2015,6,10145,864,3845,444,3,27,15328
6/18/2015,7,10557,884,4816,324,14,30,16625
6/18/2015,8,10652,1015,4976,245,26,34,16948
6/18/2015,9,10648,1146,4981,194,40,35,17044
6/18/2015,10,10652,1523,4944,195,54,31,17399
6/18/2015,11,10645,1752,5105,238,50,0,17790
6/18/2015,12,10658,2123,5258,366,66,8,18479
6/18/2015,13,10649,2349,5199,484,89,0,18770
6/18/2015,14,10649,2477,5334,555,67,10,19092
6/18/2015,15,10650,2499,5421,618,85,18,19291
6/18/2015,16,10656,2613,5473,703,65,20,19530
6/18/2015,17,10654,2964,5538,701,48,24,19929
6/18/2015,18,10654,2730,5560,530,22,52,19548
6/18/2015,19,10659,2829,5560,389,6,76,19519
6/18/2015,20,10649,2811,5519,279,0,139,19397
6/18/2015,21,10655,2093,5135,519,0,186,18588
6/18/2015,22,10664,1292,4932,594,0,189,17671
6/18/2015,23,10668,945,4147,662,0,180,16602
6/18/2015,24,10663,860,3440,968,0,133,16064
6/19/2015,1,10667,861,3028,1092,0,82,15730
6/19/2015,2,10669,864,2961,883,0,27,15404
6/19/2015,3,10674,865,2972,1031,0,19,15561
6/19/2015,4,10664,873,2953,831,0,19,15340
6/19/2015,5,10666,886,3045,798,0,23,15418
6/19/2015,6,10675,957,3326,748,2,28,15736
6/19/2015,7,10676,1194,4014,629,14,32,16559
6/19/2015,8,10674,1428,4024,418,25,44,16613
6/19/2015,9,10665,1535,4380,531,49,41,17201
6/19/2015,10,10671,1545,4643,438,71,34,17402
6/19/2015,11,10669,1734,4631,375,68,34,17511
6/19/2015,12,10667,1940,4581,406,69,34,17697
6/19/2015,13,10662,2092,4423,373,69,34,17653
6/19/2015,14,10655,2373,4338,233,39,35,17673
6/19/2015,15,10652,2384,4726,377,40,34,18213
6/19/2015,16,10643,2382,4852,309,43,35,18264
6/19/2015,17,10647,2215,5397,296,52,34,18641
6/19/2015,18,10650,2019,5379,245,28,34,18355
6/19/2015,19,10653,1674,5545,185,12,55,18124
6/19/2015,20,10658,1595,5299,154,2,88,17796
6/19/2015,21,10655,1600,4712,161,0,129,17257
6/19/2015,22,10643,1099,4507,232,0,143,16624
6/19/2015,23,10647,760,4442,272,0,101,16222
6/19/2015,24,10665,734,3728,291,0,110,15528
6/20/2015,1,10674,740,3175,369,0,19,14977
6/20/2015,2,10676,741,3268,377,0,2,15064
6/20/2015,3,10667,738,3166,415,0,2,14988
6/20/2015,4,10435,742,3063,389,0,2,14631
6/20/2015,5,10080,741,3033,425,0,1,14280
6/20/2015,6,10080,738,3163,554,6,1,14542
6/20/2015,7,10076,719,3447,555,17,2,14816
6/20/2015,8,10291,709,3744,262,41,0,15047
6/20/2015,9,10492,719,4257,256,65,0,15789
6/20/2015,10,10671,790,4302,265,88,0,16116
6/20/2015,11,10664,810,4727,189,94,0,16484
6/20/2015,12,10663,1078,4672,187,76,0,16676
6/20/2015,13,10630,1414,4624,187,55,0,16910
6/20/2015,14,10657,1725,4503,222,26,0,17133
6/20/2015,15,10658,2015,4017,125,37,0,16852
6/20/2015,16,10652,1954,4281,192,62,0,17141
6/20/2015,17,10657,1920,4402,231,34,0,17244
6/20/2015,18,10651,1921,4852,182,23,0,17629
6/20/2015,19,10651,1921,4975,166,8,0,17721
6/20/2015,20,10650,1917,4570,151,1,0,17289
6/20/2015,21,10644,1602,4810,228,0,2,17286
6/20/2015,22,10647,979,5191,233,0,2,17052
6/20/2015,23,10656,821,4884,244,0,2,16607
6/20/2015,24,10661,727,3975,413,0,2,15778
6/21/2015,1,10659,727,3334,561,0,2,15283
6/21/2015,2,10668,724,3120,719,0,2,15233
6/21/2015,3,10667,725,2980,916,0,2,15290
6/21/2015,4,10539,727,2919,755,0,2,14942
6/21/2015,5,10371,727,2759,996,1,2,14856
6/21/2015,6,10372,728,2726,791,2,2,14621
6/21/2015,7,10363,728,2904,621,10,2,14628
6/21/2015,8,10429,806,3776,388,11,2,15412
6/21/2015,9,10659,839,4251,325,32,2,16108
6/21/2015,10,10655,1042,4791,319,60,2,16869
6/21/2015,11,10651,1453,4941,403,62,2,17512
6/21/2015,12,10658,1678,4745,453,75,3,17612
6/21/2015,13,10655,1715,4718,617,71,2,17778
6/21/2015,14,10650,1919,4554,720,83,2,17928
6/21/2015,15,10652,2382,4513,663,85,20,18315
6/21/2015,16,10649,2605,5000,641,81,50,19026
6/21/2015,17,10647,2681,4996,641,59,54,19078
6/21/2015,18,10651,2763,5060,602,31,61,19168
6/21/2015,19,10652,2850,4995,460,8,76,19041
6/21/2015,20,10652,2965,4941,352,1,90,19001
6/21/2015,21,10659,2841,4803,361,0,87,18751
6/21/2015,22,10662,2040,4417,355,0,85,17559
6/21/2015,23,10684,1394,4209,529,0,53,16869
6/21/2015,24,10695,790,4136,563,0,37,16221
6/22/2015,1,10695,731,3634,628,0,42,15730
6/22/2015,2,10683,743,3254,540,0,44,15264
6/22/2015,3,10680,934,3072,384,0,53,15123
6/22/2015,4,10676,1251,3136,268,0,55,15386
6/22/2015,5,10667,1580,3075,80,0,61,15463
6/22/2015,6,10665,1841,3593,40,0,65,16204
6/22/2015,7,10667,1933,4493,61,13,66,17233
6/22/2015,8,10659,2033,4584,79,38,61,17454
6/22/2015,9,10663,2350,4930,86,66,87,18182
6/22/2015,10,10667,2700,4979,203,87,116,18752
6/22/2015,11,10667,3029,5129,255,98,104,19282
6/22/2015,12,10669,3133,5069,405,98,102,19476
6/22/2015,13,10668,3339,4962,632,98,101,19800
6/22/2015,14,10663,3350,4934,1006,96,97,20146
6/22/2015,15,10668,3307,4972,1240,84,96,20367
6/22/2015,16,10663,3240,5162,1308,61,95,20529
6/22/2015,17,10659,3570,5065,1492,42,98,20926
6/22/2015,18,10662,3336,5021,1647,9,69,20744
6/22/2015,19,10654,3128,4572,1836,6,48,20244
6/22/2015,20,10640,3050,4446,2163,2,38,20339
6/22/2015,21,10660,2911,4081,2348,0,36,20036
6/22/2015,22,10650,1778,3770,2440,0,35,18673
6/22/2015,23,10646,1156,3490,2531,0,27,17850
6/22/2015,24,10636,874,3212,2645,0,20,17387
6/23/2015,1,10626,870,2889,2570,0,20,16975
6/23/2015,2,10623,876,2941,1899,0,20,16359
6/23/2015,3,10619,970,3173,1920,0,20,16702
6/23/2015,4,10618,1155,2793,1999,0,22,16587
6/23/2015,5,10619,1508,2690,2085,0,28,16930
6/23/2015,6,10621,1860,3128,1509,0,34,17152
6/23/2015,7,10625,1918,3627,1806,10,64,18050
6/23/2015,8,10629,1883,4012,2098,28,100,18750
6/23/2015,9,10632,1904,4558,2223,47,124,19488
6/23/2015,10,10623,2137,4657,2299,65,122,19903
6/23/2015,11,10614,2484,4378,2361,87,123,20047
6/23/2015,12,10617,2412,4142,2254,96,127,19648
6/23/2015,13,10626,2538,3937,2113,87,123,19424
6/23/2015,14,10635,2533,3934,1931,85,96,19214
6/23/2015,15,10642,2769,4104,1663,81,79,19338
6/23/2015,16,10672,2956,4329,1517,76,94,19644
6/23/2015,17,10696,3100,4609,1256,46,94,19801
6/23/2015,18,10711,3109,4792,867,33,88,19600
6/23/2015,19,10724,3102,4932,582,8,49,19397
6/23/2015,20,10719,3435,4922,347,1,36,19460
6/23/2015,21,10711,3064,4881,276,0,35,18967
6/23/2015,22,10718,1956,4595,279,0,35,17583
6/23/2015,23,10727,1117,4171,305,0,24,16344
6/23/2015,24,10731,1001,3730,386,0,20,15868
6/24/2015,1,10737,861,3225,424,0,20,15267
6/24/2015,2,10740,824,3126,374,0,20,15084
6/24/2015,3,10520,828,3211,366,0,20,14945
6/24/2015,4,10426,947,3410,251,0,22,15056
6/24/2015,5,10429,1134,3761,104,0,24,15452
6/24/2015,6,10504,1300,4142,105,0,27,16078
6/24/2015,7,10714,1465,4708,52,12,37,16988
6/24/2015,8,10700,1636,4524,40,40,62,17002
6/24/2015,9,10698,1825,4467,68,68,97,17223
6/24/2015,10,10694,1992,4592,85,90,92,17545
6/24/2015,11,10692,2055,4694,118,97,95,17751
6/24/2015,12,10695,2360,4887,129,96,92,18259
6/24/2015,13,10697,2441,4857,197,97,92,18381
6/24/2015,14,10716,2627,4842,315,96,94,18690
6/24/2015,15,10725,2680,4873,517,96,133,19024
6/24/2015,16,10757,2719,4960,651,84,135,19306
6/24/2015,17,10759,2930,5319,601,61,125,19795
6/24/2015,18,10751,3099,5392,456,32,101,19831
6/24/2015,19,10749,3210,5488,341,9,105,19902
6/24/2015,20,10735,3014,5421,266,1,93,19530
6/24/2015,21,10718,2885,5160,286,0,50,19099
6/24/2015,22,10721,1516,4928,363,0,33,17561
6/24/2015,23,10731,977,4475,424,0,21,16628
6/24/2015,24,10733,823,3850,515,0,17,15938
6/25/2015,1,10738,820,3825,480,0,18,15881
6/25/2015,2,10725,821,3435,460,0,16,15457
6/25/2015,3,10721,823,3374,312,0,15,15245
6/25/2015,4,10725,819,3264,187,0,15,15010
6/25/2015,5,10721,819,3541,89,0,22,15192
6/25/2015,6,10721,821,3933,21,4,26,15526
6/25/2015,7,10730,943,4584,29,16,35,16337
6/25/2015,8,10722,1189,5190,28,33,65,17227
6/25/2015,9,10732,1660,5144,36,52,89,17713
6/25/2015,10,10735,1956,5246,53,70,95,18155
6/25/2015,11,10733,2337,4900,31,61,99,18161
6/25/2015,12,10728,2468,4959,43,71,93,18362
6/25/2015,13,10698,2807,4797,83,78,100,18563
6/25/2015,14,10707,2780,4826,155,96,111,18675
6/25/2015,15,10709,2665,4803,242,67,107,18593
6/25/2015,16,10711,2564,4875,201,69,107,18527
6/25/2015,17,10712,2685,5074,118,55,104,18748
6/25/2015,18,10718,2629,5072,96,29,101,18645
6/25/2015,19,10720,2365,4899,126,11,56,18177
6/25/2015,20,10714,2334,4900,95,2,43,18088
6/25/2015,21,10713,2238,4816,159,0,33,17959
6/25/2015,22,10715,1336,4911,222,0,32,17216
6/25/2015,23,10725,958,4807,211,0,19,16720
6/25/2015,24,10726,867,3897,207,0,17,15714
6/26/2015,1,10728,814,3455,242,0,18,15257
6/26/2015,2,10729,815,3058,284,0,17,14903
6/26/2015,3,10730,816,3022,371,0,16,14955
6/26/2015,4,10731,834,3192,582,0,18,15357
6/26/2015,5,10733,822,3059,699,0,20,15333
6/26/2015,6,10730,817,3450,625,4,34,15660
6/26/2015,7,10725,824,4108,447,14,64,16182
6/26/2015,8,10721,857,4496,356,36,97,16563
6/26/2015,9,10727,868,4776,457,60,137,17025
6/26/2015,10,10727,1010,4914,624,78,182,17535
6/26/2015,11,10719,1173,4946,723,79,201,17841
6/26/2015,12,10720,1321,4786,697,47,181,17752
6/26/2015,13,10714,1558,4830,658,87,146,17993
6/26/2015,14,10712,1623,4870,694,95,142,18136
6/26/2015,15,10710,1607,5123,662,76,138,18316
6/26/2015,16,10712,1634,5292,600,71,135,18444
6/26/2015,17,10718,1696,5435,556,45,73,18523
6/26/2015,18,10719,1725,5512,570,26,31,18583
6/26/2015,19,10725,1587,5322,580,11,30,18255
6/26/2015,20,10720,1525,4995,674,2,31,17947
6/26/2015,21,10718,1219,4804,911,0,31,17683
6/26/2015,22,10720,931,4243,1145,0,31,17070
6/26/2015,23,10717,764,3684,1229,0,21,16415
6/26/2015,24,10721,740,3265,1421,0,2,16149
6/27/2015,1,10582,733,3142,1681,0,1,16139
6/27/2015,2,10423,736,2691,1966,0,1,15817
6/27/2015,3,10425,738,2543,2072,0,1,15779
6/27/2015,4,10273,740,2496,2028,0,1,15538
6/27/2015,5,10122,739,2562,2097,0,2,15522
6/27/2015,6,10119,737,2626,2097,0,2,15581
6/27/2015,7,10118,733,2922,2432,1,2,16208
6/27/2015,8,10320,730,3268,2486,5,2,16811
6/27/2015,9,10594,725,3667,2431,5,2,17424
6/27/2015,10,10723,721,3813,2392,6,3,17658
6/27/2015,11,10723,718,3879,2556,7,2,17885
6/27/2015,12,10714,715,3439,2729,8,3,17608
6/27/2015,13,10704,712,3157,2624,3,3,17203
6/27/2015,14,10702,711,3179,2559,12,3,17166
6/27/2015,15,10697,711,3315,2541,7,3,17274
6/27/2015,16,10691,713,3467,2734,5,3,17613
6/27/2015,17,10688,714,3457,2863,5,2,17729
6/27/2015,18,10670,716,3320,2564,6,2,17278
6/27/2015,19,10644,717,3541,2275,1,2,17180
6/27/2015,20,10627,706,3570,2350,0,2,17255
6/27/2015,21,10578,695,3297,2682,0,2,17254
6/27/2015,22,10582,694,3034,2641,0,2,16953
6/27/2015,23,10551,693,2779,2582,0,2,16607
6/27/2015,24,10456,695,2602,2275,0,2,16030
6/28/2015,1,10147,697,2524,1951,0,2,15321
6/28/2015,2,9597,699,2550,1890,0,2,14738
6/28/2015,3,9232,702,2741,2162,0,2,14839
6/28/2015,4,9174,702,2719,1982,0,2,14579
6/28/2015,5,9168,702,2789,1776,0,2,14437
6/28/2015,6,9174,701,2700,1835,0,2,14412
6/28/2015,7,9350,698,3075,1765,4,2,14894
6/28/2015,8,10044,697,3129,1630,8,3,15511
6/28/2015,9,10276,690,3426,1606,11,2,16011
6/28/2015,10,10237,689,3332,1619,16,3,15896
6/28/2015,11,10270,691,3302,1647,41,3,15954
6/28/2015,12,10298,689,3503,1623,28,3,16144
6/28/2015,13,10180,690,3488,1757,29,3,16147
6/28/2015,14,10114,686,3527,1610,32,2,15971
6/28/2015,15,10152,688,3598,1614,24,12,16088
6/28/2015,16,10152,727,3804,1401,17,25,16126
6/28/2015,17,10248,756,4110,1230,10,60,16414
6/28/2015,18,10332,817,4369,794,10,59,16381
6/28/2015,19,10326,906,4528,465,5,59,16289
6/28/2015,20,10312,911,4590,321,1,57,16192
6/28/2015,21,10320,926,4740,285,0,56,16327
6/28/2015,22,10353,965,4297,249,0,17,15881
6/28/2015,23,10383,950,3573,287,0,2,15195
6/28/2015,24,10396,961,3328,349,0,2,15036
6/29/2015,1,10415,811,2675,318,0,2,14221
6/29/2015,2,10286,767,2697,518,0,4,14272
6/29/2015,3,10127,767,2807,412,0,16,14129
6/29/2015,4,10129,767,2787,344,0,5,14032
6/29/2015,5,10141,768,3189,274,1,26,14399
6/29/2015,6,10247,766,3419,262,3,32,14729
6/29/2015,7,10457,780,3923,227,14,50,15451
6/29/2015,8,10454,809,4482,63,39,52,15899
6/29/2015,9,10456,935,4768,28,63,38,16288
6/29/2015,10,10458,1185,4938,48,86,25,16740
6/29/2015,11,10467,1419,4984,115,95,26,17106
6/29/2015,12,10468,1326,4950,163,87,38,17032
6/29/2015,13,10465,1395,4860,231,95,39,17085
6/29/2015,14,10455,1473,4820,344,95,34,17221
6/29/2015,15,10478,1610,4804,461,90,25,17468
6/29/2015,16,10478,1663,4763,462,73,25,17464
6/29/2015,17,10513,1688,4826,440,46,25,17538
6/29/2015,18,10550,1703,5006,409,36,25,17729
6/29/2015,19,10703,1736,5012,395,10,25,17881
6/29/2015,20,10664,1768,5167,340,2,25,17966
6/29/2015,21,10650,1907,5103,354,0,25,18039
6/29/2015,22,10652,1386,4883,307,0,25,17253
6/29/2015,23,10670,1149,4370,341,0,22,16552
6/29/2015,24,10658,877,3977,291,0,21,15824
6/30/2015,1,10739,911,3670,435,0,21,15776
6/30/2015,2,10792,814,2859,267,0,21,14753
6/30/2015,3,10422,819,3067,433,0,21,14762
6/30/2015,4,10362,820,2999,442,0,21,14644
6/30/2015,5,10544,851,3172,385,0,22,14974
6/30/2015,6,10628,876,3556,419,1,23,15503
6/30/2015,7,10851,911,4343,368,4,25,16502
6/30/2015,8,11226,934,4342,198,21,33,16754
6/30/2015,9,11221,977,4623,127,40,61,17049
6/30/2015,10,11232,1112,5021,84,30,82,17561
6/30/2015,11,11239,1393,5103,103,26,75,17939
6/30/2015,12,11237,1405,5002,171,29,73,17917
6/30/2015,13,11232,1692,4937,195,66,74,18196
6/30/2015,14,11370,1900,4513,208,43,73,18107
6/30/2015,15,11388,2099,4193,212,71,74,18037
6/30/2015,16,11388,2227,4016,193,64,74,17962
6/30/2015,17,11396,2083,4290,204,55,73,18101
6/30/2015,18,11403,2042,4332,184,30,73,18064
6/30/2015,19,11401,2022,4472,175,9,73,18152
6/30/2015,20,11399,1767,4366,189,1,73,17795
6/30/2015,21,11396,1400,4593,133,0,73,17595
6/30/2015,22,11400,829,4217,111,0,73,16630
6/30/2015,23,11404,669,4146,106,0,42,16367
6/30/2015,24,11397,653,3439,141,0,23,15653
7/1/2015,1,11402,617,2868,197,0,23,15107
7/1/2015,2,11395,613,2714,224,0,23,14969
7/1/2015,3,11418,611,2691,305,0,23,15048
7/1/2015,4,11151,615,2524,227,0,23,14540
7/1/2015,5,10838,613,2721,286,0,23,14481
7/1/2015,6,10848,616,2771,311,0,23,14569
7/1/2015,7,10845,619,3352,284,8,23,15131
7/1/2015,8,10919,713,4105,371,17,17,16142
7/1/2015,9,11283,650,4181,422,38,13,16587
7/1/2015,10,11442,611,3761,548,48,14,16424
7/1/2015,11,11440,607,3531,514,70,24,16186
7/1/2015,12,11430,604,3583,472,62,22,16173
7/1/2015,13,11424,614,3831,517,62,23,16471
7/1/2015,14,11415,620,3821,635,76,26,16593
7/1/2015,15,11417,745,3819,666,84,31,16762
7/1/2015,16,11413,749,4054,661,77,12,16966
7/1/2015,17,11419,751,4098,687,41,21,17017
7/1/2015,18,11436,748,4372,678,31,54,17319
7/1/2015,19,11437,751,4504,549,10,57,17308
7/1/2015,20,11448,751,4415,402,2,56,17074
7/1/2015,21,11481,757,4319,371,0,59,16987
7/1/2015,22,11651,760,3499,286,0,58,16254
7/1/2015,23,11642,760,3524,270,0,59,16255
7/1/2015,24,11679,761,3057,212,0,28,15737
7/2/2015,1,11280,767,2824,300,0,5,15176
7/2/2015,2,11102,769,2978,282,0,5,15136
7/2/2015,3,11107,769,2811,293,0,5,14985
7/2/2015,4,11130,768,2699,249,0,9,14855
7/2/2015,5,11148,762,2720,315,0,24,14969
7/2/2015,6,11224,759,2925,274,3,31,15216
7/2/2015,7,11660,793,3508,152,11,36,16160
7/2/2015,8,11801,816,3645,95,18,37,16412
7/2/2015,9,11796,813,4248,123,40,57,17077
7/2/2015,10,11773,810,4126,114,74,83,16980
7/2/2015,11,11778,808,4481,155,82,88,17392
7/2/2015,12,11936,805,4361,243,89,119,17553
7/2/2015,13,12033,803,4576,340,96,134,17982
7/2/2015,14,12033,801,4286,380,92,148,17740
7/2/2015,15,12024,798,4121,452,94,120,17609
7/2/2015,16,12036,799,4277,482,69,102,17765
7/2/2015,17,12026,800,4495,453,60,116,17950
7/2/2015,18,12023,803,4753,455,31,145,18210
7/2/2015,19,12028,802,4487,393,9,142,17861
7/2/2015,20,12026,809,4241,313,1,126,17516
7/2/2015,21,12028,815,4183,403,0,130,17559
7/2/2015,22,12046,812,3800,392,0,92,17142
7/2/2015,23,11887,719,3321,336,0,30,16293
7/2/2015,24,11252,718,2992,364,0,25,15351
7/3/2015,1,10847,714,2966,393,0,23,14943
7/3/2015,2,10619,591,3004,370,0,22,14606
7/3/2015,3,10624,593,3019,304,0,21,14561
7/3/2015,4,10614,590,3069,234,0,19,14526
7/3/2015,5,10619,592,3098,248,0,24,14581
7/3/2015,6,10658,713,3028,297,2,29,14727
7/3/2015,7,11077,743,3237,293,14,39,15403
7/3/2015,8,11233,788,3700,190,36,60,16007
7/3/2015,9,11229,812,3961,159,63,64,16288
7/3/2015,10,11437,809,4003,183,85,73,16590
7/3/2015,11,11966,806,3819,171,96,74,16932
7/3/2015,12,12053,805,3915,155,97,66,17091
7/3/2015,13,12051,797,3623,175,96,69,16811
7/3/2015,14,12049,796,3622,172,91,74,16804
7/3/2015,15,12063,799,3729,120,69,80,16860
7/3/2015,16,12051,797,3883,116,77,97,17021
7/3/2015,17,12051,802,4170,103,61,128,17315
7/3/2015,18,12064,802,4060,114,28,119,17187
7/3/2015,19,12075,804,4047,123,9,111,17169
7/3/2015,20,12072,807,4394,99,1,142,17515
7/3/2015,21,12064,804,4277,94,0,96,17335
7/3/2015,22,12058,783,3576,96,0,85,16598
7/3/2015,23,11805,485,3624,101,0,38,16053
7/3/2015,24,11790,392,3372,89,0,3,15646
7/4/2015,1,11804,392,2721,99,0,3,15019
7/4/2015,2,11701,392,2615,104,0,4,14816
7/4/2015,3,11335,394,2825,139,0,4,14697
7/4/2015,4,11196,395,2519,150,0,4,14264
7/4/2015,5,11000,396,2601,157,0,4,14158
7/4/2015,6,10927,392,2656,88,3,4,14070
7/4/2015,7,10697,388,3249,85,13,3,14435
7/4/2015,8,10765,386,3875,41,37,3,15107
7/4/2015,9,11209,385,4094,20,64,3,15775
7/4/2015,10,11493,382,3775,6,85,3,15744
7/4/2015,11,11799,382,3915,4,97,3,16200
7/4/2015,12,11962,381,3859,15,98,3,16318
7/4/2015,13,12119,382,3560,36,97,3,16197
7/4/2015,14,12120,379,3668,99,96,5,16367
7/4/2015,15,12126,378,3786,168,88,16,16562
7/4/2015,16,12131,378,4073,257,73,45,16957
7/4/2015,17,12137,377,4241,269,51,57,17132
7/4/2015,18,12140,401,4786,238,30,60,17655
7/4/2015,19,12141,437,4874,197,10,62,17721
7/4/2015,20,12131,429,4572,229,2,68,17431
7/4/2015,21,12133,444,4399,234,0,70,17280
7/4/2015,22,12128,388,3972,244,0,38,16770
7/4/2015,23,12136,388,3264,356,0,22,16166
7/4/2015,24,12144,390,2830,368,0,21,15753
7/5/2015,1,12020,392,2883,317,0,23,15635
7/5/2015,2,11871,391,2615,338,0,23,15238
7/5/2015,3,11670,392,2433,365,0,26,14886
7/5/2015,4,11133,394,2425,406,0,29,14387
7/5/2015,5,10583,396,2412,358,0,33,13782
7/5/2015,6,10413,395,2543,353,2,26,13732
7/5/2015,7,10415,393,2973,299,14,22,14116
7/5/2015,8,10712,429,3786,175,32,19,15153
7/5/2015,9,11037,455,3954,83,54,12,15595
7/5/2015,10,11408,483,4295,110,75,3,16374
7/5/2015,11,11957,569,4027,161,92,2,16808
7/5/2015,12,12106,572,4042,176,96,2,16994
7/5/2015,13,12108,644,4097,147,98,2,17096
7/5/2015,14,12271,786,4425,140,97,10,17729
7/5/2015,15,12268,936,4585,135,86,41,18051
7/5/2015,16,12258,1143,4768,142,72,58,18441
7/5/2015,17,12256,1233,5265,138,51,54,18997
7/5/2015,18,12277,1304,5622,136,24,52,19415
7/5/2015,19,12284,1240,5322,128,13,60,19047
7/5/2015,20,12320,1206,5173,218,3,60,18980
7/5/2015,21,12317,1302,5009,259,0,55,18942
7/5/2015,22,12309,892,4295,297,0,54,17847
7/5/2015,23,12294,796,3664,329,0,67,17150
7/5/2015,24,12298,790,3234,432,0,59,16813
7/6/2015,1,12291,487,2713,509,0,2,16002
7/6/2015,2,12296,391,2583,565,0,3,15838
7/6/2015,3,12301,404,2537,560,0,17,15819
7/6/2015,4,12290,439,2612,459,0,18,15818
7/6/2015,5,12264,540,2841,371,0,19,16035
7/6/2015,6,12007,883,3008,241,2,23,16164
7/6/2015,7,12028,1208,3099,232,10,46,16623
7/6/2015,8,12259,1395,3356,161,34,76,17281
7/6/2015,9,12252,1576,3783,86,57,85,17839
7/6/2015,10,12249,1868,4265,75,77,78,18612
7/6/2015,11,12226,2390,4372,62,92,80,19222
7/6/2015,12,12228,2550,4599,129,97,82,19685
7/6/2015,13,12229,3056,4647,187,97,81,20297
7/6/2015,14,12197,3135,4633,228,96,81,20370
7/6/2015,15,11467,3221,4773,254,94,87,19896
7/6/2015,16,11304,3098,4904,247,73,87,19713
7/6/2015,17,11302,3215,5322,215,58,92,20204
7/6/2015,18,11306,3237,5365,291,33,93,20325
7/6/2015,19,11305,3592,5382,379,10,68,20736
7/6/2015,20,11309,3460,5254,448,4,44,20519
7/6/2015,21,11312,3285,4713,667,0,35,20012
7/6/2015,22,11293,2138,3909,1074,0,33,18447
7/6/2015,23,11277,1058,4011,1383,0,18,17747
7/6/2015,24,11275,803,3723,1644,0,19,17464
7/7/2015,1,11261,793,3031,1473,0,18,16576
7/7/2015,2,11259,793,2810,1640,0,16,16518
7/7/2015,3,11257,794,2829,1727,0,19,16626
7/7/2015,4,11260,797,2871,1716,0,19,16663
7/7/2015,5,11260,799,3097,1657,0,20,16833
7/7/2015,6,11254,807,3342,1748,0,27,17178
7/7/2015,7,11263,917,3934,1704,11,53,17882
7/7/2015,8,11253,1110,4234,1673,28,72,18370
7/7/2015,9,11248,1437,4360,1717,55,85,18902
7/7/2015,10,11244,1978,4611,1759,75,82,19749
7/7/2015,11,11231,2625,4615,1716,83,83,20353
7/7/2015,12,11218,3027,4606,1839,64,87,20841
7/7/2015,13,11211,3135,4706,1797,73,91,21013
7/7/2015,14,11193,3039,4721,1516,41,90,20600
7/7/2015,15,11169,3045,5036,1305,32,82,20669
7/7/2015,16,11150,3709,4969,1315,16,82,21241
7/7/2015,17,11167,3085,5065,1616,12,82,21027
7/7/2015,18,11175,2880,4711,1627,6,83,20482
7/7/2015,19,11180,2722,4301,1632,5,83,19923
7/7/2015,20,11192,2545,4028,1462,1,83,19311
7/7/2015,21,11199,2337,4118,1396,0,82,19132
7/7/2015,22,11227,1151,4331,1138,0,83,17930
7/7/2015,23,11260,805,3957,1043,0,68,17133
7/7/2015,24,11277,804,3504,885,0,65,16535
7/8/2015,1,11291,807,3389,854,0,65,16406
7/8/2015,2,11247,808,3383,727,0,64,16229
7/8/2015,3,11245,823,2959,553,0,63,15643
7/8/2015,4,11187,925,2827,225,0,36,15200
7/8/2015,5,11015,1174,2910,410,0,20,15529
7/8/2015,6,11083,1523,3080,479,3,26,16194
7/8/2015,7,11309,1785,3306,262,14,33,16709
7/8/2015,8,11300,1873,3414,290,33,34,16944
7/8/2015,9,11283,1833,3496,278,64,52,17006
7/8/2015,10,11261,1881,3781,181,71,73,17248
7/8/2015,11,11257,2016,3858,138,79,83,17431
7/8/2015,12,11251,1762,4186,119,70,82,17470
7/8/2015,13,11239,1797,4597,103,50,84,17870
7/8/2015,14,11166,2061,4628,112,65,90,18122
7/8/2015,15,11166,2075,4619,95,46,99,18100
7/8/2015,16,11228,1879,4591,111,35,91,17935
7/8/2015,17,11244,1723,4856,100,25,92,18040
7/8/2015,18,11371,1759,4533,87,16,114,17880
7/8/2015,19,11418,1623,4611,74,8,160,17894
7/8/2015,20,11422,1633,4631,40,1,129,17856
7/8/2015,21,11418,1635,4802,62,0,105,18022
7/8/2015,22,11384,1014,4701,72,0,105,17276
7/8/2015,23,11397,852,4253,83,0,73,16658
7/8/2015,24,11416,854,3908,87,0,71,16336
7/9/2015,1,11343,852,3326,53,0,72,15646
7/9/2015,2,11129,854,3575,59,0,71,15688
7/9/2015,3,11151,852,3349,66,0,71,15489
7/9/2015,4,11154,852,3556,54,0,72,15688
7/9/2015,5,11217,850,3862,60,0,92,16081
7/9/2015,6,11257,847,3827,171,0,86,16188
7/9/2015,7,11507,848,3619,364,2,86,16426
7/9/2015,8,11508,862,4301,407,7,88,17173
7/9/2015,9,11457,876,4356,275,5,101,17070
7/9/2015,10,11438,924,4406,182,5,92,17047
7/9/2015,11,11446,1076,4413,228,13,103,17279
7/9/2015,12,11468,1250,4658,175,22,153,17726
7/9/2015,13,11475,1419,4471,245,19,204,17833
7/9/2015,14,11472,1388,4441,415,20,190,17926
7/9/2015,15,11486,1475,4358,481,20,151,17971
7/9/2015,16,11493,1607,4146,559,21,110,17936
7/9/2015,17,11448,1636,4586,481,20,127,18298
7/9/2015,18,11447,1642,4839,393,21,125,18467
7/9/2015,19,11440,1643,5187,295,9,186,18760
7/9/2015,20,11434,1650,5004,234,1,185,18508
7/9/2015,21,11404,1590,4993,214,0,154,18355
7/9/2015,22,11394,1452,4209,219,0,122,17396
7/9/2015,23,11405,946,3905,209,0,34,16499
7/9/2015,24,11411,865,3402,194,0,20,15892
7/10/2015,1,11419,868,3149,221,0,19,15676
7/10/2015,2,11369,867,3112,245,0,18,15611
7/10/2015,3,11066,867,2929,204,0,19,15085
7/10/2015,4,10794,867,3083,260,0,20,15024
7/10/2015,5,10642,866,3112,229,0,21,14870
7/10/2015,6,10637,860,3569,196,1,28,15291
7/10/2015,7,10887,890,4291,189,3,34,16294
7/10/2015,8,11399,870,3905,94,3,50,16321
7/10/2015,9,11475,872,4058,42,4,79,16530
7/10/2015,10,11453,1069,4645,31,61,96,17355
7/10/2015,11,11434,1366,4490,54,95,123,17562
7/10/2015,12,11414,1647,4627,61,96,116,17961
7/10/2015,13,11283,2010,4627,88,94,117,18219
7/10/2015,14,11272,2282,4738,121,94,97,18604
7/10/2015,15,11315,2441,4798,173,95,85,18907
7/10/2015,16,11410,2439,4779,183,81,117,19009
7/10/2015,17,11417,2420,5009,161,51,90,19148
7/10/2015,18,11428,2421,5034,156,23,84,19146
7/10/2015,19,11448,2267,5197,162,9,108,19191
7/10/2015,20,11454,2305,5075,172,3,159,19168
7/10/2015,21,11464,2089,4742,197,0,177,18669
7/10/2015,22,11475,1418,4219,199,0,181,17492
7/10/2015,23,11485,938,4137,226,0,91,16877
7/10/2015,24,11490,827,3696,277,0,17,16307
7/11/2015,1,11498,825,3245,279,0,17,15864
7/11/2015,2,11400,832,3015,284,0,17,15548
7/11/2015,3,11201,833,2933,303,0,16,15286
7/11/2015,4,10945,838,2816,465,0,16,15080
7/11/2015,5,10890,1020,2860,421,0,16,15207
7/11/2015,6,10878,1258,2949,314,0,16,15415
7/11/2015,7,10741,1574,2750,94,9,16,15184
7/11/2015,8,10609,1824,3112,84,31,16,15676
7/11/2015,9,10604,1963,3979,26,62,17,16651
7/11/2015,10,10864,2029,4326,17,83,23,17342
7/11/2015,11,11399,2016,4088,31,96,36,17666
7/11/2015,12,11447,2083,4480,75,97,40,18222
7/11/2015,13,11445,2009,4609,149,98,31,18341
7/11/2015,14,11442,1905,4918,204,97,37,18603
7/11/2015,15,11444,2010,4937,266,94,40,18791
7/11/2015,16,11448,2167,5065,277,78,31,19066
7/11/2015,17,11453,2317,5252,331,55,37,19445
7/11/2015,18,11443,2406,5365,317,30,34,19595
7/11/2015,19,11428,2438,5239,289,10,36,19440
7/11/2015,20,11413,2536,5084,294,1,40,19368
7/11/2015,21,11380,2701,5027,276,0,39,19423
7/11/2015,22,11392,2324,4580,254,0,38,18588
7/11/2015,23,11363,1756,4209,259,0,17,17604
7/11/2015,24,11396,946,3858,291,0,17,16508
7/12/2015,1,11404,819,3540,287,0,17,16067
7/12/2015,2,11333,821,3077,239,0,17,15487
7/12/2015,3,11104,823,3018,243,0,18,15206
7/12/2015,4,11113,835,2797,263,0,17,15025
7/12/2015,5,10960,916,2981,199,0,17,15073
7/12/2015,6,10785,1114,2957,138,0,16,15010
7/12/2015,7,10790,1429,3041,110,12,16,15398
7/12/2015,8,10786,1705,3426,56,28,19,16020
7/12/2015,9,10989,1892,3894,25,50,19,16869
7/12/2015,10,11378,1986,4165,17,73,19,17638
7/12/2015,11,11385,2216,4653,47,71,17,18389
7/12/2015,12,11384,2479,4648,75,91,17,18694
7/12/2015,13,11371,2605,4623,125,92,17,18833
7/12/2015,14,11379,2650,4639,137,79,29,18913
7/12/2015,15,11382,2633,4896,165,53,30,19159
7/12/2015,16,11395,3071,4845,177,37,18,19543
7/12/2015,17,11399,3250,5231,247,29,22,20178
7/12/2015,18,11393,3289,5422,276,36,20,20436
7/12/2015,19,11385,3218,5468,238,13,17,20339
7/12/2015,20,11375,3066,5278,125,2,17,19863
7/12/2015,21,11367,3462,5099,122,0,20,20070
7/12/2015,22,11359,3176,4599,127,0,20,19281
7/12/2015,23,11347,2258,4317,109,0,22,18053
7/12/2015,24,11354,1398,3780,140,0,17,16689
7/13/2015,1,11350,917,3704,191,0,17,16179
7/13/2015,2,11360,825,3555,212,0,31,15983
7/13/2015,3,11364,939,3031,180,0,33,15547
7/13/2015,4,11311,1196,2940,134,0,21,15602
7/13/2015,5,11087,1499,3205,140,0,28,15959
7/13/2015,6,11084,1649,3399,122,0,28,16282
7/13/2015,7,11219,1854,4067,146,12,33,17331
7/13/2015,8,11355,2260,4065,135,35,34,17884
7/13/2015,9,11339,3117,4169,149,59,33,18866
7/13/2015,10,11330,3287,4334,280,81,33,19345
7/13/2015,11,11321,3900,4395,506,96,33,20251
7/13/2015,12,11323,3967,4579,582,97,33,20581
7/13/2015,13,11323,4501,4735,498,96,47,21200
7/13/2015,14,11332,4234,4936,531,95,77,21205
7/13/2015,15,11338,4606,5059,517,84,98,21702
7/13/2015,16,11350,4665,5242,347,63,99,21766
7/13/2015,17,11355,4883,5256,248,52,97,21891
7/13/2015,18,11345,4912,5303,219,24,93,21896
7/13/2015,19,11338,4781,5076,219,11,95,21520
7/13/2015,20,11309,4489,4874,236,2,94,21004
7/13/2015,21,11322,4591,4837,407,0,87,21244
7/13/2015,22,11300,3592,4514,494,0,86,19986
7/13/2015,23,11268,2933,4089,621,0,76,18987
7/13/2015,24,11252,1833,3641,822,0,72,17620
7/14/2015,1,11271,980,3177,1219,0,70,16717
7/14/2015,2,11292,797,3473,1021,0,70,16653
7/14/2015,3,11329,806,3469,928,0,70,16602
7/14/2015,4,11328,964,3168,815,0,70,16345
7/14/2015,5,11325,1211,3610,673,0,73,16892
7/14/2015,6,11304,1652,3622,610,0,83,17271
7/14/2015,7,11309,1904,3789,775,2,85,17864
7/14/2015,8,11305,2227,4035,931,7,87,18592
7/14/2015,9,11314,2682,4161,957,27,87,19228
7/14/2015,10,11308,3082,4562,665,6,87,19710
7/14/2015,11,11303,3527,4641,572,6,87,20136
7/14/2015,12,11299,3687,4654,501,6,87,20234
7/14/2015,13,11279,3710,4692,368,43,88,20180
7/14/2015,14,11282,3752,4811,327,43,88,20303
7/14/2015,15,11280,3526,4988,337,51,86,20268
7/14/2015,16,11290,3368,5102,499,45,81,20385
7/14/2015,17,11286,3523,5235,633,36,88,20801
7/14/2015,18,11312,3362,4851,1078,8,87,20698
7/14/2015,19,11374,3024,4191,1680,7,87,20363
7/14/2015,20,11390,2719,4349,1714,2,87,20261
7/14/2015,21,11395,2236,4699,1630,0,87,20047
7/14/2015,22,11401,1122,4379,1815,0,86,18803
7/14/2015,23,11408,843,3417,2007,0,74,17749
7/14/2015,24,11418,802,2803,1929,0,70,17022
7/15/2015,1,11270,752,2683,1568,0,44,16317
7/15/2015,2,10801,773,2577,1835,0,20,16006
7/15/2015,3,10584,765,2526,1842,0,20,15737
7/15/2015,4,10586,794,2538,1611,0,21,15550
7/15/2015,5,10574,842,2633,1602,0,22,15673
7/15/2015,6,10778,805,2828,1536,0,28,15975
7/15/2015,7,11313,811,3071,1297,26,34,16552
7/15/2015,8,11394,940,3019,1320,28,33,16734
7/15/2015,9,11392,1040,3321,1015,33,34,16835
7/15/2015,10,11397,1280,3687,731,64,34,17193
7/15/2015,11,11399,1461,4260,482,97,39,17738
7/15/2015,12,11395,1654,4187,406,98,68,17808
7/15/2015,13,11241,1684,4399,418,97,85,17924
7/15/2015,14,11316,1658,4329,476,96,85,17960
7/15/2015,15,11382,1633,4330,478,89,85,17997
7/15/2015,16,11376,1631,4055,503,87,86,17738
7/15/2015,17,11363,1623,4518,490,57,85,18136
7/15/2015,18,11364,1625,5042,482,32,85,18630
7/15/2015,19,11369,1697,5151,383,7,86,18693
7/15/2015,20,11356,1414,5112,325,1,86,18294
7/15/2015,21,11357,1104,4871,435,0,85,17852
7/15/2015,22,11358,881,4550,431,0,86,17306
7/15/2015,23,11373,824,3911,368,0,76,16552
7/15/2015,24,11378,825,3459,367,0,70,16099
7/16/2015,1,11387,828,3326,349,0,70,15960
7/16/2015,2,11405,831,2806,359,0,44,15445
7/16/2015,3,11412,831,2684,327,0,19,15273
7/16/2015,4,11409,830,2604,277,0,19,15139
7/16/2015,5,11410,827,2763,307,0,23,15330
7/16/2015,6,11405,827,3030,348,1,30,15641
7/16/2015,7,11398,825,3398,347,11,35,16014
7/16/2015,8,11387,981,3638,248,37,35,16326
7/16/2015,9,11377,1065,4228,204,65,35,16974
7/16/2015,10,11293,1065,4549,207,85,35,17234
7/16/2015,11,11293,1167,4639,226,78,38,17441
7/16/2015,12,11372,1223,4503,251,88,44,17481
7/16/2015,13,11361,1318,4440,274,98,75,17566
7/16/2015,14,11355,1426,4094,316,99,81,17371
7/16/2015,15,11345,1087,4702,292,97,84,17607
7/16/2015,16,11342,812,4937,233,83,85,17492
7/16/2015,17,11352,843,5332,238,60,85,17910
7/16/2015,18,11359,895,5203,302,32,85,17876
7/16/2015,19,11357,1088,4765,443,10,84,17747
7/16/2015,20,11356,1377,4251,489,2,85,17560
7/16/2015,21,11357,1399,4527,525,0,85,17893
7/16/2015,22,11366,1353,4099,559,0,87,17464
7/16/2015,23,11373,1340,3285,683,0,34,16715
7/16/2015,24,11376,1201,2655,640,0,19,15891
7/17/2015,1,10920,837,2720,579,0,19,15075
7/17/2015,2,10598,822,2751,915,0,19,15105
7/17/2015,3,10585,820,2632,925,0,19,14981
7/17/2015,4,10589,820,2742,1078,0,19,15248
7/17/2015,5,10593,820,2995,1187,0,26,15621
7/17/2015,6,10729,822,3184,1369,0,34,16138
7/17/2015,7,10889,843,3103,1470,2,38,16345
7/17/2015,8,10868,988,3241,1493,16,37,16643
7/17/2015,9,10870,1087,3559,1714,20,47,17297
7/17/2015,10,10864,1079,3779,1782,17,41,17562
7/17/2015,11,10875,1222,3854,1982,21,53,18007
7/17/2015,12,10877,1288,3978,1777,18,64,18002
7/17/2015,13,10877,1496,4202,1527,17,75,18194
7/17/2015,14,10882,1695,4260,1403,25,91,18356
7/17/2015,15,10882,1742,4369,1225,48,89,18355
7/17/2015,16,10881,1890,4391,1210,55,94,18521
7/17/2015,17,10878,2020,4219,1311,31,91,18550
7/17/2015,18,10864,2109,4318,1066,9,91,18457
7/17/2015,19,10878,2106,4500,1111,5,74,18674
7/17/2015,20,10859,2113,4342,937,1,56,18308
7/17/2015,21,10346,2029,4752,908,0,55,18090
7/17/2015,22,10068,1738,4624,939,0,55,17424
7/17/2015,23,10078,1358,4083,1006,0,54,16579
7/17/2015,24,10086,953,3631,936,0,52,15658
7/18/2015,1,10084,902,3624,690,0,27,15327
7/18/2015,2,10087,801,3918,404,0,1,15211
7/18/2015,3,10095,797,3694,313,0,1,14900
7/18/2015,4,10097,808,3753,274,0,1,14933
7/18/2015,5,10102,929,3582,259,0,1,14873
7/18/2015,6,10106,1093,3336,280,0,1,14816
7/18/2015,7,10112,1362,3726,192,6,1,15399
7/18/2015,8,10108,1587,4096,94,22,15,15922
7/18/2015,9,10109,1992,4518,60,48,48,16775
7/18/2015,10,10111,2948,4677,84,70,54,17944
7/18/2015,11,10109,3412,4873,127,88,53,18662
7/18/2015,12,10107,3599,4881,211,97,53,18948
7/18/2015,13,10056,3820,4946,241,97,55,19215
7/18/2015,14,10085,4073,4826,417,96,38,19535
7/18/2015,15,10074,4051,4788,895,84,1,19893
7/18/2015,16,10055,3957,5050,869,65,1,19997
7/18/2015,17,10069,3799,5302,1093,55,3,20321
7/18/2015,18,10071,3635,4749,1359,25,2,19841
7/18/2015,19,10080,3958,5116,1118,5,3,20280
7/18/2015,20,10074,4023,5130,1108,1,2,20338
7/18/2015,21,10089,4187,4903,1193,0,2,20374
7/18/2015,22,10085,3190,4471,1273,0,2,19021
7/18/2015,23,10089,2041,3947,1407,0,1,17485
7/18/2015,24,10089,1199,3627,1272,0,1,16188
7/19/2015,1,10088,878,3803,1080,0,1,15850
7/19/2015,2,10084,998,3796,924,0,3,15805
7/19/2015,3,10081,1019,3533,906,0,5,15544
7/19/2015,4,10076,898,3020,1076,0,5,15075
7/19/2015,5,10108,859,2942,987,0,5,14901
7/19/2015,6,10150,892,2684,867,0,5,14598
7/19/2015,7,10244,1098,3260,733,6,6,15347
7/19/2015,8,10231,1527,3640,681,34,20,16133
7/19/2015,9,10233,2389,4161,694,61,50,17588
7/19/2015,10,10229,3493,4606,649,84,54,19115
7/19/2015,11,10226,4184,4619,716,95,54,19894
7/19/2015,12,10229,4386,4681,870,96,55,20317
7/19/2015,13,10230,4461,4724,1167,96,57,20735
7/19/2015,14,10228,4186,5044,1400,86,62,21006
7/19/2015,15,10224,4890,5031,1360,13,62,21580
7/19/2015,16,10221,4982,5164,1253,8,69,21697
7/19/2015,17,10210,5086,5527,1091,15,40,21969
7/19/2015,18,10303,4861,5462,900,6,15,21547
7/19/2015,19,10657,4540,5590,773,12,16,21588
7/19/2015,20,10688,4740,5090,781,1,13,21313
7/19/2015,21,10679,4602,4638,986,0,16,20921
7/19/2015,22,10689,4174,4045,889,0,5,19802
7/19/2015,23,10705,3147,3802,846,0,4,18504
7/19/2015,24,10724,2554,3507,823,0,19,17627
7/20/2015,1,10756,2068,2796,732,0,21,16373
7/20/2015,2,10779,1178,2865,616,0,23,15461
7/20/2015,3,10813,951,3175,549,0,20,15508
7/20/2015,4,10960,1089,2933,612,0,21,15615
7/20/2015,5,10964,1448,3165,590,0,26,16193
7/20/2015,6,10954,2147,2970,399,0,30,16500
7/20/2015,7,10939,2600,3556,532,8,44,17679
7/20/2015,8,10918,2997,4169,417,35,44,18580
7/20/2015,9,10907,3049,4900,325,63,52,19296
7/20/2015,10,10902,3662,4887,311,85,97,19944
7/20/2015,11,10896,3917,4981,504,96,106,20500
7/20/2015,12,10891,4159,4929,779,96,88,20942
7/20/2015,13,10887,4008,5168,1148,92,90,21393
7/20/2015,14,10871,3678,5296,1349,86,93,21373
7/20/2015,15,10882,3799,5297,1400,74,112,21564
7/20/2015,16,10904,3933,5325,1466,65,79,21772
7/20/2015,17,10945,4044,5380,1414,51,60,21894
7/20/2015,18,10964,4121,5407,1350,30,59,21931
7/20/2015,19,10960,4192,5392,1247,7,59,21857
7/20/2015,20,10946,4175,5300,1243,1,50,21715
7/20/2015,21,10946,4441,4708,1234,0,45,21374
7/20/2015,22,10941,3281,4363,1260,0,38,19883
7/20/2015,23,10933,2625,4110,1311,0,24,19003
7/20/2015,24,10929,1684,3850,1002,0,19,17484
7/21/2015,1,10929,1666,3405,863,0,19,16882
7/21/2015,2,10934,1059,3330,768,0,19,16110
7/21/2015,3,10943,896,3487,798,0,20,16144
7/21/2015,4,10964,926,3153,770,0,1,15814
7/21/2015,5,10979,1518,3206,709,0,23,16435
7/21/2015,6,10978,1986,2981,843,0,29,16817
7/21/2015,7,10997,2228,3273,493,1,37,17029
7/21/2015,8,11000,2583,3584,674,15,60,17916
7/21/2015,9,10991,2956,4085,660,56,84,18832
7/21/2015,10,10988,3118,4336,744,77,85,19348
7/21/2015,11,10971,3138,4475,863,95,85,19627
7/21/2015,12,10964,3254,4372,847,97,86,19620
7/21/2015,13,10838,3263,4457,814,88,87,19547
7/21/2015,14,10815,3263,4641,817,89,89,19714
7/21/2015,15,10950,3121,4778,780,85,89,19803
7/21/2015,16,10980,3062,5276,789,77,88,20272
7/21/2015,17,10994,2991,5441,777,60,86,20349
7/21/2015,18,11017,2798,5351,658,31,86,19941
7/21/2015,19,11042,2935,5364,494,8,85,19928
7/21/2015,20,11041,2935,5080,474,1,87,19618
7/21/2015,21,11040,2984,4767,527,0,88,19406
7/21/2015,22,11046,1894,4271,592,0,86,17889
7/21/2015,23,11040,1297,3572,787,0,71,16767
7/21/2015,24,11041,1019,3017,913,0,35,16025
7/22/2015,1,11044,935,2911,943,0,16,15849
7/22/2015,2,11032,890,2608,783,0,18,15331
7/22/2015,3,10886,887,2625,619,0,21,15038
7/22/2015,4,10734,883,2659,666,0,22,14964
7/22/2015,5,10715,868,2964,737,0,23,15307
7/22/2015,6,10894,985,3328,699,0,27,15933
7/22/2015,7,10983,1249,3695,609,9,36,16581
7/22/2015,8,10972,1653,3602,529,37,38,16831
7/22/2015,9,10982,1949,3734,706,65,35,17471
7/22/2015,10,11009,2013,3935,811,86,35,17889
7/22/2015,11,11025,2463,3561,806,89,35,17979
7/22/2015,12,11036,2721,3470,815,81,35,18158
7/22/2015,13,10958,2888,3870,715,79,36,18546
7/22/2015,14,11022,2966,3777,654,71,35,18525
7/22/2015,15,11110,2701,4517,520,64,36,18948
7/22/2015,16,11114,2574,5029,429,57,36,19239
7/22/2015,17,11120,2624,5317,409,54,36,19560
7/22/2015,18,11083,2775,5091,428,33,35,19445
7/22/2015,19,11054,2885,4958,302,8,35,19242
7/22/2015,20,11026,2893,4827,213,1,36,18996
7/22/2015,21,11012,2839,4698,231,0,35,18815
7/22/2015,22,11034,1916,4320,238,0,35,17543
7/22/2015,23,11024,1631,3346,257,0,23,16281
7/22/2015,24,10948,1500,2818,297,0,19,15582
7/23/2015,1,10714,998,2940,391,0,17,15060
7/23/2015,2,10701,863,2717,510,0,17,14808
7/23/2015,3,10638,861,2687,415,0,19,14620
7/23/2015,4,10179,861,3233,546,0,19,14838
7/23/2015,5,10190,914,3700,431,0,21,15256
7/23/2015,6,10543,1035,3382,400,0,29,15389
7/23/2015,7,11006,1194,3384,309,11,41,15945
7/23/2015,8,11044,1409,4010,156,24,40,16683
7/23/2015,9,11056,1773,3900,138,37,31,16935
7/23/2015,10,11075,2460,3628,184,67,34,17448
7/23/2015,11,11074,2851,3509,181,87,35,17737
7/23/2015,12,11070,2843,3748,141,95,35,17932
7/23/2015,13,11062,2848,4050,207,98,35,18300
7/23/2015,14,11056,2869,4266,234,97,35,18557
7/23/2015,15,11054,2979,4517,285,96,35,18966
7/23/2015,16,11060,2800,4804,330,83,44,19121
7/23/2015,17,11059,2705,5057,380,60,39,19300
7/23/2015,18,11055,2893,5077,394,30,32,19481
7/23/2015,19,11050,3286,5022,313,7,33,19711
7/23/2015,20,11041,2858,4770,295,1,31,18996
7/23/2015,21,11044,2865,4629,356,0,35,18929
7/23/2015,22,11058,2155,3999,387,0,32,17631
7/23/2015,23,11065,1053,3458,425,0,19,16020
7/23/2015,24,11076,886,2932,481,0,20,15395
7/24/2015,1,11071,882,2721,497,0,20,15191
7/24/2015,2,11080,860,2992,417,0,12,15361
7/24/2015,3,11090,979,3015,303,0,7,15394
7/24/2015,4,11096,1155,2751,250,0,6,15258
7/24/2015,5,11100,1285,2800,199,0,6,15390
7/24/2015,6,11090,1315,2952,119,0,13,15489
7/24/2015,7,11078,1451,3522,62,10,40,16163
7/24/2015,8,11077,1700,3728,28,35,65,16633
7/24/2015,9,11065,2031,4048,16,63,81,17304
7/24/2015,10,11060,2473,4038,28,85,94,17778
7/24/2015,11,11050,2866,4092,113,97,111,18329
7/24/2015,12,11045,2970,4212,153,98,112,18590
7/24/2015,13,11026,3346,4482,196,98,108,19256
7/24/2015,14,11023,3418,4710,336,97,107,19691
7/24/2015,15,11029,3459,4797,392,95,108,19880
7/24/2015,16,11043,3602,5003,438,77,108,20271
7/24/2015,17,11050,3584,5128,383,58,90,20293
7/24/2015,18,11056,3639,5297,296,28,80,20396
7/24/2015,19,11066,3770,5158,265,7,33,20299
7/24/2015,20,11055,3442,5142,264,1,5,19909
7/24/2015,21,11038,3436,4758,393,0,6,19631
7/24/2015,22,11035,1964,4326,518,0,6,17849
7/24/2015,23,11036,1471,3991,644,0,6,17148
7/24/2015,24,11032,992,3635,788,0,5,16452
7/25/2015,1,11043,845,3294,879,0,5,16066
7/25/2015,2,11045,847,3102,876,0,5,15875
7/25/2015,3,11048,817,2684,848,0,5,15402
7/25/2015,4,11048,816,2752,692,0,2,15310
7/25/2015,5,11050,817,3049,667,0,1,15584
7/25/2015,6,11043,796,3146,798,1,1,15785
7/25/2015,7,11039,752,3208,768,7,1,15775
7/25/2015,8,11027,791,3824,611,32,1,16286
7/25/2015,9,11040,1068,4192,600,59,1,16960
7/25/2015,10,11048,1321,4726,850,80,1,18026
7/25/2015,11,11054,1909,4099,1297,95,1,18455
7/25/2015,12,11053,2117,4257,1686,97,1,19211
7/25/2015,13,11056,2201,4065,1718,97,1,19138
7/25/2015,14,11048,2438,4322,1719,83,1,19611
7/25/2015,15,11052,2624,4352,1702,88,1,19819
7/25/2015,16,11048,3032,4541,1516,71,1,20209
7/25/2015,17,11046,3443,4746,1314,46,1,20596
7/25/2015,18,11037,3380,4728,1166,28,1,20340
7/25/2015,19,11022,3390,4673,916,10,9,20020
7/25/2015,20,11008,3586,4645,574,2,4,19819
7/25/2015,21,11002,3613,4340,362,0,3,19320
7/25/2015,22,11005,3295,3778,301,0,3,18382
7/25/2015,23,11015,1961,3961,277,0,1,17215
7/25/2015,24,11023,1317,3777,278,0,1,16396
7/26/2015,1,11035,1159,3330,326,0,1,15851
7/26/2015,2,11040,958,3038,263,0,1,15300
7/26/2015,3,11037,810,3208,257,0,1,15313
7/26/2015,4,11014,932,2866,280,0,1,15093
7/26/2015,5,11032,1183,2705,226,0,1,15147
7/26/2015,6,10910,1567,2700,114,0,1,15292
7/26/2015,7,10587,1798,2872,125,10,1,15393
7/26/2015,8,10423,2032,3271,62,34,1,15823
7/26/2015,9,10492,2397,3930,20,61,1,16901
7/26/2015,10,10868,2917,4198,38,82,1,18104
7/26/2015,11,11000,3564,4105,40,95,1,18805
7/26/2015,12,10991,3724,4319,69,97,1,19201
7/26/2015,13,10977,3702,4661,78,97,1,19516
7/26/2015,14,10951,3961,4944,108,93,1,20058
7/26/2015,15,10992,4513,5006,141,91,1,20744
7/26/2015,16,11029,4922,4963,136,65,1,21116
7/26/2015,17,11038,4785,5168,175,50,1,21217
7/26/2015,18,11041,4880,5164,127,28,1,21241
7/26/2015,19,11044,4776,4948,90,7,4,20869
7/26/2015,20,11038,4581,4824,92,0,4,20539
7/26/2015,21,11025,4620,4575,131,0,1,20352
7/26/2015,22,11026,3940,3985,125,0,1,19077
7/26/2015,23,11029,2766,3758,103,0,1,17657
7/26/2015,24,11035,1773,3634,94,0,1,16537
7/27/2015,1,11027,1312,3482,99,0,1,15921
7/27/2015,2,11003,1276,3228,90,0,11,15608
7/27/2015,3,10997,1251,3228,88,0,18,15582
7/27/2015,4,10986,1265,3214,92,0,19,15576
7/27/2015,5,10980,1379,3403,93,0,21,15876
7/27/2015,6,10973,1848,3371,113,0,29,16334
7/27/2015,7,10984,2702,3612,168,8,32,17506
7/27/2015,8,10993,3565,3813,135,32,30,18568
7/27/2015,9,11012,4407,4082,24,58,29,19612
7/27/2015,10,11025,4854,4302,13,79,30,20303
7/27/2015,11,11019,5086,4626,23,93,29,20876
7/27/2015,12,11019,5194,4792,40,96,30,21171
7/27/2015,13,11018,5182,5116,61,97,34,21508
7/27/2015,14,11001,5236,4986,97,96,46,21462
7/27/2015,15,10996,5193,4856,131,92,45,21313
7/27/2015,16,10987,4686,5323,166,76,45,21283
7/27/2015,17,10985,4837,5552,173,54,47,21648
7/27/2015,18,10981,5407,5468,146,29,48,22079
7/27/2015,19,10978,5488,5240,102,8,49,21865
7/27/2015,20,10968,5145,5052,96,1,47,21309
7/27/2015,21,10934,5204,4950,85,0,44,21217
7/27/2015,22,10932,4498,4648,96,0,35,20209
7/27/2015,23,10942,4039,4066,98,0,19,19164
7/27/2015,24,10936,3137,3733,76,0,15,17897
7/28/2015,1,10953,2315,3621,84,0,15,16988
7/28/2015,2,10962,1814,3307,76,0,14,16173
7/28/2015,3,10976,1689,3287,80,0,13,16045
7/28/2015,4,10988,1700,3486,90,0,13,16277
7/28/2015,5,10990,2034,3614,71,0,15,16724
7/28/2015,6,10990,2710,2922,49,6,20,16697
7/28/2015,7,10994,3331,2955,38,10,26,17354
7/28/2015,8,10993,4003,3240,32,32,27,18327
7/28/2015,9,10981,4139,3680,8,58,40,18906
7/28/2015,10,10977,4569,4395,9,79,81,20110
7/28/2015,11,10969,4910,4673,24,93,145,20814
7/28/2015,12,10932,5320,4885,31,97,91,21356
7/28/2015,13,10917,5314,5102,64,97,84,21578
7/28/2015,14,10901,5332,5093,79,96,99,21600
7/28/2015,15,10882,5102,4970,86,91,101,21232
7/28/2015,16,10884,5004,5285,87,74,77,21411
7/28/2015,17,10881,5261,5276,109,54,39,21620
7/28/2015,18,10881,5479,4787,92,28,38,21305
7/28/2015,19,10881,5275,4732,86,7,41,21022
7/28/2015,20,10883,5447,4414,134,0,36,20914
7/28/2015,21,10885,5417,4389,198,0,26,20915
7/28/2015,22,10889,4734,4016,225,0,26,19890
7/28/2015,23,10884,4259,3740,209,0,18,19110
7/28/2015,24,10899,3732,3441,219,0,15,18306
7/29/2015,1,10910,3053,3642,219,0,12,17836
7/29/2015,2,10915,2608,3499,230,0,11,17263
7/29/2015,3,10886,2323,3498,222,0,12,16941
7/29/2015,4,10871,2247,3466,155,0,11,16750
7/29/2015,5,10851,2556,3640,179,0,13,17239
7/29/2015,6,10839,2643,3474,268,0,20,17244
7/29/2015,7,10835,3129,3185,297,11,26,17483
7/29/2015,8,10804,3637,3979,288,32,27,18767
7/29/2015,9,10803,4715,4204,226,49,42,20039
7/29/2015,10,10798,5100,4548,236,76,87,20845
7/29/2015,11,10801,5449,4762,325,91,108,21536
7/29/2015,12,10802,5634,4932,481,97,95,22041
7/29/2015,13,10763,5640,4925,603,96,88,22115
7/29/2015,14,10764,5433,4999,736,95,93,22120
7/29/2015,15,10766,4933,5103,976,90,96,21964
7/29/2015,16,10761,4715,5297,925,72,94,21864
7/29/2015,17,10906,4795,5223,800,47,94,21865
7/29/2015,18,10973,5072,5320,718,16,99,22198
7/29/2015,19,10964,5245,5112,678,7,99,22105
7/29/2015,20,10952,5106,4886,861,0,96,21901
7/29/2015,21,10929,5080,4428,871,0,95,21403
7/29/2015,22,10917,4792,4135,935,0,88,20867
7/29/2015,23,10898,3729,3848,1581,0,94,20150
7/29/2015,24,10885,2610,3771,1577,0,129,18972
7/30/2015,1,10897,1917,3736,1306,0,85,17941
7/30/2015,2,10889,1441,3637,1288,0,71,17326
7/30/2015,3,10890,1360,3555,1383,0,72,17260
7/30/2015,4,10930,1179,3082,1309,0,72,16572
7/30/2015,5,10951,1243,3366,1144,0,73,16777
7/30/2015,6,10948,1585,3214,1159,1,81,16988
7/30/2015,7,10962,2326,3480,1012,7,85,17872
7/30/2015,8,10956,3229,3960,791,33,123,19092
7/30/2015,9,10958,3683,4552,868,60,156,20277
7/30/2015,10,10966,3994,4702,1012,83,155,20912
7/30/2015,11,10986,3959,4759,1295,93,145,21237
7/30/2015,12,11024,3848,4616,1655,77,126,21346
7/30/2015,13,11042,3552,4473,1824,80,102,21073
7/30/2015,14,11039,3550,4625,1776,70,138,21198
7/30/2015,15,11054,3671,4459,1934,74,103,21295
7/30/2015,16,11102,3578,4315,1910,73,99,21077
7/30/2015,17,11187,3287,4421,2132,55,107,21189
7/30/2015,18,11220,3156,4592,1859,30,105,20962
7/30/2015,19,11233,3540,4944,1312,7,106,21142
7/30/2015,20,11237,3637,4855,1003,1,115,20848
7/30/2015,21,11232,3739,4609,945,0,95,20620
7/30/2015,22,11247,2949,3866,1047,0,127,19236
7/30/2015,23,11255,1970,3785,979,0,78,18067
7/30/2015,24,11260,1171,3587,970,0,75,17063
7/31/2015,1,11258,1020,3353,969,0,73,16673
7/31/2015,2,11259,991,3067,897,0,70,16284
7/31/2015,3,11318,857,2840,830,0,70,15915
7/31/2015,4,11433,846,2727,762,0,72,15840
7/31/2015,5,11480,854,2777,830,0,74,16015
7/31/2015,6,11474,1028,3153,962,0,81,16698
7/31/2015,7,11469,1369,3718,751,8,85,17400
7/31/2015,8,11459,1970,4167,440,32,85,18153
7/31/2015,9,11451,2198,4400,390,59,87,18585
7/31/2015,10,11447,2430,4672,584,82,87,19302
7/31/2015,11,11441,2477,4520,887,96,87,19508
7/31/2015,12,11428,2423,4648,1339,81,90,20009
7/31/2015,13,11418,2687,4561,1726,79,119,20590
7/31/2015,14,11422,2647,4522,1807,81,121,20600
7/31/2015,15,11426,2793,4600,1699,63,118,20699
7/31/2015,16,11431,2775,4760,1668,41,84,20759
7/31/2015,17,11430,3291,4940,1169,18,105,20953
7/31/2015,18,11428,3277,4816,1056,22,105,20704
7/31/2015,19,11418,2815,4642,1305,7,83,20270
7/31/2015,20,11385,2710,4403,1262,1,55,19816
7/31/2015,21,11368,2600,4367,1160,0,65,19560
7/31/2015,22,11343,1996,3985,927,0,66,18317
7/31/2015,23,11400,1534,3411,910,0,71,17326
7/31/2015,24,11407,813,3407,901,0,53,16581
8/1/2015,1,11410,686,3487,718,0,17,16318
8/1/2015,2,11410,672,3452,643,0,1,16178
8/1/2015,3,11423,605,2925,676,0,1,15630
8/1/2015,4,11445,598,2727,604,0,1,15375
8/1/2015,5,11465,601,2758,597,0,1,15422
8/1/2015,6,11470,628,2694,339,0,1,15132
8/1/2015,7,11476,631,3113,428,8,1,15657
8/1/2015,8,11470,662,3687,238,33,1,16091
8/1/2015,9,11472,705,3946,241,62,1,16427
8/1/2015,10,11473,750,4544,269,85,1,17122
8/1/2015,11,11482,943,4730,395,95,1,17646
8/1/2015,12,11482,1079,4604,616,84,1,17866
8/1/2015,13,11465,1351,4407,879,46,1,18149
8/1/2015,14,11450,1466,4230,1001,40,1,18188
8/1/2015,15,11434,1638,4067,1212,94,1,18446
8/1/2015,16,11432,1627,4477,1162,72,1,18771
8/1/2015,17,11431,1695,4838,1022,40,1,19027
8/1/2015,18,11442,1996,4791,877,4,1,19111
8/1/2015,19,11442,1935,4674,572,7,1,18631
8/1/2015,20,11441,1816,4341,499,1,1,18099
8/1/2015,21,11437,1654,3924,610,0,6,17631
8/1/2015,22,11446,1181,3198,736,0,19,16580
8/1/2015,23,11447,733,3061,804,0,7,16052
8/1/2015,24,11440,649,2901,797,0,5,15792
8/2/2015,1,11332,603,2731,682,0,2,15350
8/2/2015,2,11157,597,3001,753,0,2,15510
8/2/2015,3,11153,600,2912,646,0,3,15314
8/2/2015,4,11145,635,2761,585,0,2,15128
8/2/2015,5,11145,639,2643,450,0,2,14879
8/2/2015,6,11149,635,2724,565,0,2,15075
8/2/2015,7,11147,661,2719,459,7,3,14996
8/2/2015,8,11146,661,3240,409,35,1,15492
8/2/2015,9,11372,659,3567,454,60,1,16113
8/2/2015,10,11451,660,3549,855,86,1,16602
8/2/2015,11,11450,664,3533,1441,96,1,17185
8/2/2015,12,11444,663,3656,1908,98,1,17770
8/2/2015,13,11404,654,3832,2253,97,1,18241
8/2/2015,14,11445,660,3973,2462,97,5,18642
8/2/2015,15,11450,668,4373,2398,93,11,18993
8/2/2015,16,11453,871,5007,1855,56,18,19260
8/2/2015,17,11457,800,4701,1828,37,21,18844
8/2/2015,18,11458,759,3744,1787,23,20,17791
8/2/2015,19,11456,762,3688,1953,8,5,17872
8/2/2015,20,11463,767,3797,2094,0,1,18122
8/2/2015,21,11465,781,3930,1984,0,1,18161
8/2/2015,22,11487,826,4018,1308,0,1,17640
8/2/2015,23,11495,834,3155,1331,0,1,16816
8/2/2015,24,11495,782,3234,976,0,1,16488
8/3/2015,1,11487,779,2786,1076,0,3,16131
8/3/2015,2,11481,777,2580,1091,0,3,15932
8/3/2015,3,11271,750,2521,1122,0,3,15667
8/3/2015,4,10969,749,2623,1216,0,4,15561
8/3/2015,5,10888,750,2637,1430,0,4,15709
8/3/2015,6,10765,755,2761,1406,0,4,15691
8/3/2015,7,10653,788,2858,1411,3,4,15717
8/3/2015,8,10794,900,3160,1360,15,3,16232
8/3/2015,9,11200,981,3456,1302,34,3,16976
8/3/2015,10,11497,1207,3361,790,65,3,16923
8/3/2015,11,11514,1542,3819,677,72,3,17627
8/3/2015,12,11509,1640,4360,509,88,3,18109
8/3/2015,13,11497,1804,4300,463,91,3,18158
8/3/2015,14,11489,1860,4142,496,75,3,18065
8/3/2015,15,11487,1885,3925,711,76,3,18087
8/3/2015,16,11482,1911,4258,1016,74,3,18744
8/3/2015,17,11485,2177,4706,626,52,3,19049
8/3/2015,18,11504,2227,4871,464,12,17,19095
8/3/2015,19,11514,2219,4724,360,7,49,18873
8/3/2015,20,11525,1986,4500,247,1,54,18313
8/3/2015,21,11515,1876,4376,229,0,57,18053
8/3/2015,22,11518,1017,3988,245,0,55,16823
8/3/2015,23,11519,860,3596,309,0,40,16324
8/3/2015,24,11526,858,3048,383,0,18,15833
8/4/2015,1,11542,861,2815,389,0,21,15628
8/4/2015,2,11543,817,2862,385,0,23,15630
8/4/2015,3,11557,789,2624,430,0,21,15421
8/4/2015,4,11562,785,2605,414,0,25,15391
8/4/2015,5,11565,843,2997,384,0,28,15817
8/4/2015,6,11567,1118,3062,309,1,52,16109
8/4/2015,7,11566,1380,3181,234,8,60,16429
8/4/2015,8,11562,1592,3592,121,29,60,16956
8/4/2015,9,11444,1784,3918,128,61,62,17397
8/4/2015,10,11428,2233,3964,218,84,57,17984
8/4/2015,11,11417,2305,4108,388,82,61,18361
8/4/2015,12,11409,2260,3956,663,76,53,18417
8/4/2015,13,11515,2286,3567,1027,63,53,18511
8/4/2015,14,11524,2463,3771,1117,81,58,19014
8/4/2015,15,11521,2576,3673,1213,97,56,19136
8/4/2015,16,11519,2442,4048,1077,30,61,19177
8/4/2015,17,11521,2579,4517,797,17,61,19492
8/4/2015,18,11521,2621,4373,601,25,45,19186
8/4/2015,19,11521,2466,4600,458,3,35,19083
8/4/2015,20,11521,2364,4483,382,0,35,18785
8/4/2015,21,11515,2591,4162,302,0,35,18605
8/4/2015,22,11522,1345,4145,314,0,35,17361
8/4/2015,23,11529,1126,3770,288,0,26,16739
8/4/2015,24,11502,1052,3286,255,0,24,16119
8/5/2015,1,11500,806,2924,340,0,21,15591
8/5/2015,2,11288,789,2730,195,0,21,15023
8/5/2015,3,11193,730,2650,382,0,21,14976
8/5/2015,4,10988,732,2696,422,0,22,14860
8/5/2015,5,10946,753,3331,491,0,29,15550
8/5/2015,6,11232,759,3091,483,0,32,15597
8/5/2015,7,11005,859,3467,357,7,36,15731
8/5/2015,8,10973,1072,3450,285,32,45,15857
8/5/2015,9,10974,1078,3471,323,64,38,15948
8/5/2015,10,10976,1173,3952,376,75,34,16586
8/5/2015,11,10986,1463,4018,447,62,38,17014
8/5/2015,12,10997,1695,3680,617,66,48,17103
8/5/2015,13,10928,2062,3346,689,72,48,17145
8/5/2015,14,10996,2421,3246,663,65,63,17454
8/5/2015,15,10994,2607,3363,741,69,60,17834
8/5/2015,16,10990,2757,3599,719,64,61,18190
8/5/2015,17,11039,2874,3917,612,45,58,18545
8/5/2015,18,11052,2886,3830,516,25,50,18359
8/5/2015,19,11051,2840,4169,459,6,44,18569
8/5/2015,20,11047,2839,3645,422,0,43,17996
8/5/2015,21,11044,2761,3870,309,0,41,18025
8/5/2015,22,11055,1652,3594,228,0,40,16569
8/5/2015,23,11065,916,3786,180,0,34,15981
8/5/2015,24,11073,783,3245,218,0,36,15355
8/6/2015,1,11079,760,2879,239,0,32,14989
8/6/2015,2,11078,761,2958,265,0,34,15096
8/6/2015,3,11077,729,2997,254,0,25,15082
8/6/2015,4,11079,729,3004,225,0,23,15060
8/6/2015,5,11075,736,3180,146,0,27,15164
8/6/2015,6,11069,882,3270,125,1,32,15379
8/6/2015,7,11069,1133,3205,132,12,35,15586
8/6/2015,8,11060,1502,3000,58,25,36,15681
8/6/2015,9,11055,1768,3453,29,59,34,16398
8/6/2015,10,11054,2029,3435,58,73,34,16683
8/6/2015,11,11053,2272,3318,90,91,34,16858
8/6/2015,12,10549,2452,3932,130,90,39,17192
8/6/2015,13,10301,2576,4123,197,89,39,17325
8/6/2015,14,10307,2623,4176,235,83,36,17460
8/6/2015,15,10308,2641,4325,295,78,35,17682
8/6/2015,16,10311,2567,4519,283,83,35,17798
8/6/2015,17,10315,2915,4559,228,57,35,18109
8/6/2015,18,10319,2961,4466,183,29,36,17994
8/6/2015,19,10318,2694,4579,130,6,36,17763
8/6/2015,20,10318,2513,4469,129,0,36,17465
8/6/2015,21,10314,2435,4330,279,0,35,17393
8/6/2015,22,10323,1656,3741,442,0,36,16198
8/6/2015,23,10324,1182,3587,494,0,29,15616
8/6/2015,24,10329,854,3130,556,0,24,14893
8/7/2015,1,10325,830,2904,468,0,21,14548
8/7/2015,2,10312,830,3080,433,0,20,14675
8/7/2015,3,10316,787,3457,426,0,21,15007
8/7/2015,4,10323,796,3441,436,0,23,15019
8/7/2015,5,10329,823,3538,469,1,30,15190
8/7/2015,6,10332,904,3439,607,1,34,15317
8/7/2015,7,10340,1204,3255,639,12,35,15485
8/7/2015,8,10340,1923,3037,384,34,35,15753
8/7/2015,9,10335,2688,3270,271,63,35,16662
8/7/2015,10,10334,2900,3132,344,86,42,16838
8/7/2015,11,10339,2956,3502,337,86,40,17260
8/7/2015,12,10329,3042,3860,279,67,33,17610
8/7/2015,13,10325,3177,3973,312,87,40,17914
8/7/2015,14,10316,3277,4014,304,95,42,18048
8/7/2015,15,10308,3466,4122,306,72,41,18315
8/7/2015,16,10294,3353,4417,332,59,35,18490
8/7/2015,17,10288,3206,4618,368,50,36,18566
8/7/2015,18,10289,3207,4460,347,26,35,18364
8/7/2015,19,10294,3137,4623,282,7,36,18379
8/7/2015,20,10301,2739,4561,320,0,36,17957
8/7/2015,21,10305,2431,4319,360,0,42,17457
8/7/2015,22,10316,1734,3825,379,0,42,16296
8/7/2015,23,10331,1180,3713,366,0,27,15617
8/7/2015,24,10338,833,3392,551,0,5,15119
8/8/2015,1,10358,836,3106,609,0,3,14912
8/8/2015,2,10365,860,2900,676,0,3,14804
8/8/2015,3,10356,829,2577,788,0,4,14554
8/8/2015,4,10340,815,2519,786,0,4,14464
8/8/2015,5,10349,818,2524,780,0,4,14475
8/8/2015,6,10341,849,2817,746,0,3,14756
8/8/2015,7,10329,937,3074,665,1,3,15009
8/8/2015,8,10317,1173,3022,551,5,3,15071
8/8/2015,9,10289,1426,3087,455,21,4,15282
8/8/2015,10,10277,1619,3709,375,28,4,16012
8/8/2015,11,10269,1754,3670,404,41,4,16142
8/8/2015,12,10272,1889,3869,557,53,4,16644
8/8/2015,13,10279,1885,3574,630,68,4,16440
8/8/2015,14,10235,1882,3582,641,70,4,16414
8/8/2015,15,10274,1881,3486,656,72,4,16373
8/8/2015,16,10286,1903,3815,591,43,4,16642
8/8/2015,17,10287,2047,3902,610,27,4,16877
8/8/2015,18,10298,1910,4050,596,8,4,16866
8/8/2015,19,10295,1548,4117,524,3,4,16491
8/8/2015,20,10300,1474,4188,496,0,4,16462
8/8/2015,21,10294,1390,4322,548,0,4,16558
8/8/2015,22,10281,1029,4106,596,0,4,16016
8/8/2015,23,10265,929,3716,657,0,4,15571
8/8/2015,24,10266,918,3194,768,0,4,15150
8/9/2015,1,10256,917,2782,795,0,4,14754
8/9/2015,2,10087,873,2717,651,0,2,14330
8/9/2015,3,9861,867,2691,720,0,1,14140
8/9/2015,4,9508,870,2621,743,0,16,13758
8/9/2015,5,9409,875,2814,860,0,7,13965
8/9/2015,6,9480,900,2933,850,0,11,14174
8/9/2015,7,9837,992,2917,685,7,17,14455
8/9/2015,8,10157,1011,3097,562,34,15,14876
8/9/2015,9,10227,1226,3001,469,61,12,14996
8/9/2015,10,10210,1581,3030,501,85,12,15419
8/9/2015,11,10197,1880,3134,465,97,9,15782
8/9/2015,12,10190,2145,3733,391,97,6,16562
8/9/2015,13,10194,2271,4122,328,95,1,17011
8/9/2015,14,10185,2335,4006,253,92,1,16872
8/9/2015,15,10173,2333,4079,255,83,1,16924
8/9/2015,16,10174,2392,4686,234,73,1,17560
8/9/2015,17,10226,2447,5110,217,57,1,18058
8/9/2015,18,10235,2780,4948,220,29,1,18213
8/9/2015,19,10231,2079,4791,221,6,1,17329
8/9/2015,20,10225,1852,4660,234,0,8,16979
8/9/2015,21,10260,2038,4711,303,0,5,17317
8/9/2015,22,10457,1315,3896,378,0,5,16051
8/9/2015,23,10515,931,3660,513,0,2,15621
8/9/2015,24,10550,905,3281,659,0,1,15396
8/10/2015,1,10680,908,2908,621,0,3,15120
8/10/2015,2,10718,1009,2877,527,0,4,15135
8/10/2015,3,10609,1135,2827,448,0,1,15020
8/10/2015,4,10759,1276,2694,382,0,4,15115
8/10/2015,5,10784,1292,2970,369,0,16,15431
8/10/2015,6,10988,1332,3056,409,0,22,15807
8/10/2015,7,11089,1357,3367,396,6,27,16242
8/10/2015,8,11089,1512,3454,250,16,27,16348
8/10/2015,9,11084,1830,3640,121,30,26,16731
8/10/2015,10,11117,2352,3857,87,34,27,17474
8/10/2015,11,11147,2480,4160,124,48,27,17986
8/10/2015,12,11137,2623,4194,140,59,27,18180
8/10/2015,13,11136,2818,4569,126,66,27,18742
8/10/2015,14,11132,3077,4665,102,62,27,19065
8/10/2015,15,11127,3107,4574,114,32,26,18980
8/10/2015,16,11176,2910,4684,168,11,26,18975
8/10/2015,17,11216,2805,4591,231,1,26,18870
8/10/2015,18,11216,2770,4124,312,1,29,18452
8/10/2015,19,11218,2774,4055,312,2,35,18396
8/10/2015,20,11210,2781,3977,335,0,34,18337
8/10/2015,21,11205,2621,3869,211,0,34,17940
8/10/2015,22,11186,1907,3389,256,0,34,16772
8/10/2015,23,11193,1079,3552,285,0,15,16124
8/10/2015,24,11186,905,3276,309,0,16,15692
8/11/2015,1,11185,902,3207,378,0,16,15688
8/11/2015,2,11231,850,2788,450,0,17,15336
8/11/2015,3,11306,844,2646,493,0,19,15308
8/11/2015,4,11308,849,2582,531,0,20,15290
8/11/2015,5,11319,854,2730,422,0,21,15346
8/11/2015,6,11317,881,3102,576,0,25,15901
8/11/2015,7,11318,923,3616,455,6,34,16352
8/11/2015,8,11319,967,4005,322,30,35,16678
8/11/2015,9,11313,1054,4246,386,53,35,17087
8/11/2015,10,11311,1385,4245,494,84,35,17554
8/11/2015,11,11321,1619,4256,527,87,36,17846
8/11/2015,12,11320,1887,3995,620,81,36,17939
8/11/2015,13,11321,2124,4374,743,80,35,18677
8/11/2015,14,11317,2084,4181,929,63,35,18609
8/11/2015,15,11315,2052,4374,1009,65,35,18850
8/11/2015,16,11310,2101,4626,1100,75,37,19249
8/11/2015,17,11321,2367,4714,1101,51,37,19591
8/11/2015,18,11321,2171,4539,1023,26,35,19115
8/11/2015,19,11321,2248,4483,703,6,35,18796
8/11/2015,20,11319,2079,4288,700,0,35,18421
8/11/2015,21,11319,2078,3967,763,0,35,18162
8/11/2015,22,11327,1115,3694,748,0,35,16919
8/11/2015,23,11347,912,3169,764,0,22,16214
8/11/2015,24,11223,866,3016,740,0,20,15865
8/12/2015,1,11085,866,2913,683,0,20,15567
8/12/2015,2,11103,867,2860,648,0,20,15498
8/12/2015,3,11103,868,2639,598,0,20,15228
8/12/2015,4,11111,868,2645,637,0,19,15280
8/12/2015,5,11114,874,2678,627,0,29,15322
8/12/2015,6,11193,901,2838,780,0,40,15752
8/12/2015,7,11417,933,3171,682,8,42,16253
8/12/2015,8,11412,1034,3564,640,25,49,16724
8/12/2015,9,11409,1142,3518,788,56,50,16963
8/12/2015,10,11409,1196,3558,1000,66,46,17275
8/12/2015,11,11420,1411,3519,1090,77,49,17566
8/12/2015,12,11416,1632,3583,967,52,47,17697
8/12/2015,13,11263,1821,3715,853,37,61,17750
8/12/2015,14,11245,1848,3640,872,71,85,17761
8/12/2015,15,11338,1964,3646,755,70,86,17859
8/12/2015,16,11415,2011,3944,647,67,86,18170
8/12/2015,17,11425,2171,4007,589,66,86,18344
8/12/2015,18,11433,2194,4093,344,11,81,18156
8/12/2015,19,11432,2033,4453,182,4,105,18209
8/12/2015,20,11428,1915,4467,209,0,94,18113
8/12/2015,21,11434,1757,4159,247,0,100,17697
8/12/2015,22,11434,1227,3736,238,0,97,16732
8/12/2015,23,11434,953,3483,269,0,31,16170
8/12/2015,24,11440,922,2999,324,0,20,15705
8/13/2015,1,11216,923,2676,393,0,19,15227
8/13/2015,2,10948,881,2669,540,0,19,15057
8/13/2015,3,10844,891,2742,717,0,18,15212
8/13/2015,4,10780,884,3042,726,0,19,15451
8/13/2015,5,10382,884,2787,582,0,24,14659
8/13/2015,6,10607,918,3354,676,0,31,15586
8/13/2015,7,11207,917,3058,556,8,35,15781
8/13/2015,8,11442,952,3444,428,34,36,16336
8/13/2015,9,11452,959,3854,402,62,48,16777
8/13/2015,10,11460,975,3971,716,73,81,17276
8/13/2015,11,11462,1108,3801,974,63,114,17522
8/13/2015,12,11457,1213,4053,1063,82,113,17981
8/13/2015,13,11443,1436,4178,1144,78,111,18390
8/13/2015,14,11437,1659,3854,1201,92,113,18356
8/13/2015,15,11430,1964,3591,1429,75,105,18594
8/13/2015,16,11436,2237,3843,1334,73,87,19010
8/13/2015,17,11439,2307,4013,1468,47,96,19370
8/13/2015,18,11434,2292,4359,1454,28,102,19669
8/13/2015,19,11435,2281,4602,1340,8,86,19752
8/13/2015,20,11414,2291,4644,1461,0,110,19920
8/13/2015,21,11399,2341,4264,1578,0,112,19694
8/13/2015,22,11380,1527,3896,1506,0,110,18419
8/13/2015,23,11388,1321,3503,1460,0,64,17736
8/13/2015,24,11417,1311,2905,1424,0,23,17080
8/14/2015,1,11439,985,2568,1380,0,20,16392
8/14/2015,2,11440,861,2652,1370,0,22,16345
8/14/2015,3,11438,860,2628,1398,0,22,16346
8/14/2015,4,11425,862,2627,1443,0,22,16379
8/14/2015,5,11375,867,2788,1378,0,24,16432
8/14/2015,6,11323,923,2960,1561,1,31,16799
8/14/2015,7,11324,988,3061,1415,1,37,16826
8/14/2015,8,11312,1126,3476,1386,18,37,17355
8/14/2015,9,11326,1532,3530,1276,26,36,17726
8/14/2015,10,11329,1987,3326,1103,63,37,17845
8/14/2015,11,11334,2554,3406,1161,87,37,18579
8/14/2015,12,11350,2767,3289,1326,41,37,18810
8/14/2015,13,11357,2864,3376,1342,48,36,19023
8/14/2015,14,11365,2876,3623,1130,9,36,19039
8/14/2015,15,11365,2888,3748,1127,23,37,19188
8/14/2015,16,11372,2912,4180,1104,65,36,19669
8/14/2015,17,11408,2915,4285,1034,50,36,19728
8/14/2015,18,11456,2877,4578,819,19,37,19786
8/14/2015,19,11448,2896,4691,555,2,37,19629
8/14/2015,20,11441,3206,4823,747,0,37,20254
8/14/2015,21,11476,3005,4674,883,0,37,20075
8/14/2015,22,11491,2639,4332,396,0,37,18895
8/14/2015,23,11487,2275,4177,272,0,29,18240
8/14/2015,24,11485,1569,4145,207,0,24,17430
8/15/2015,1,11479,1021,3546,127,0,23,16196
8/15/2015,2,11506,924,3323,119,0,23,15895
8/15/2015,3,11526,892,3293,109,0,22,15842
8/15/2015,4,11536,1002,3290,118,0,21,15967
8/15/2015,5,11556,1175,2842,150,0,21,15744
8/15/2015,6,11415,1411,2834,138,0,22,15820
8/15/2015,7,11268,1836,2940,133,9,21,16207
8/15/2015,8,11262,2379,3153,74,14,20,16902
8/15/2015,9,11315,2564,3826,85,27,21,17838
8/15/2015,10,11509,3478,4131,76,27,21,19242
8/15/2015,11,11493,4007,4156,57,44,21,19778
8/15/2015,12,11484,4408,4292,50,78,23,20335
8/15/2015,13,11433,4301,4696,65,83,24,20602
8/15/2015,14,11467,4647,4641,74,96,23,20948
8/15/2015,15,11465,4698,4560,84,92,22,20921
8/15/2015,16,11451,4764,4758,91,75,22,21161
8/15/2015,17,11447,4785,4946,114,53,22,21367
8/15/2015,18,11472,4900,4906,106,26,22,21432
8/15/2015,19,11497,4995,4540,108,5,22,21167
8/15/2015,20,11517,4668,4365,109,0,20,20679
8/15/2015,21,11531,4831,3966,128,0,20,20476
8/15/2015,22,11521,3920,3603,149,0,21,19214
8/15/2015,23,11505,2800,3584,226,0,20,18135
8/15/2015,24,11501,1569,3322,310,0,20,16722
8/16/2015,1,11492,996,3429,277,0,21,16215
8/16/2015,2,11493,915,3428,291,0,20,16147
8/16/2015,3,11481,873,3043,325,0,20,15742
8/16/2015,4,11470,853,2772,399,0,21,15515
8/16/2015,5,11436,860,2753,456,0,23,15528
8/16/2015,6,11163,957,2665,524,0,22,15331
8/16/2015,7,11158,1143,2704,485,8,22,15520
8/16/2015,8,11255,1400,3310,399,32,24,16420
8/16/2015,9,11492,1790,3730,322,57,24,17415
8/16/2015,10,11501,2549,3995,299,80,20,18444
8/16/2015,11,11504,3525,4273,331,95,19,19747
8/16/2015,12,11502,4124,4435,400,97,21,20579
8/16/2015,13,11513,4141,4326,652,98,21,20751
8/16/2015,14,11506,4268,4473,847,97,21,21212
8/16/2015,15,11499,3803,4538,998,95,21,20954
8/16/2015,16,11503,4383,4816,982,78,22,21784
8/16/2015,17,11492,4549,5005,881,53,21,22001
8/16/2015,18,11482,4522,4966,751,25,21,21767
8/16/2015,19,11479,4807,4801,652,5,20,21764
8/16/2015,20,11459,4547,4581,800,0,20,21407
8/16/2015,21,11446,4685,4030,994,0,21,21176
8/16/2015,22,11427,4057,3664,1112,0,30,20290
8/16/2015,23,11438,2498,3710,1162,0,39,18847
8/16/2015,24,11441,1847,3393,1081,0,67,17829
8/17/2015,1,11457,1255,3188,1086,0,70,17056
8/17/2015,2,11460,1110,2888,1066,0,69,16593
8/17/2015,3,11482,1061,2895,925,0,69,16432
8/17/2015,4,11499,1221,3099,725,0,72,16616
8/17/2015,5,11504,1520,3257,727,0,82,17090
8/17/2015,6,11513,1923,3280,791,0,89,17596
8/17/2015,7,11523,2728,3175,631,6,102,18165
8/17/2015,8,11525,3457,3195,372,28,104,18681
8/17/2015,9,11506,4156,3861,331,55,99,20008
8/17/2015,10,11510,4985,4020,306,78,95,20994
8/17/2015,11,11500,5205,4181,439,92,89,21506
8/17/2015,12,11488,4926,4502,538,96,101,21651
8/17/2015,13,11481,4634,4452,700,98,101,21466
8/17/2015,14,11472,4316,4467,720,97,102,21174
8/17/2015,15,11462,4429,4892,738,92,101,21714
8/17/2015,16,11453,4539,5094,645,74,103,21908
8/17/2015,17,11447,4659,5155,475,51,98,21885
8/17/2015,18,11462,4682,4901,452,21,100,21618
8/17/2015,19,11458,4604,4612,362,3,99,21138
8/17/2015,20,11451,4802,4449,334,0,103,21139
8/17/2015,21,11454,5006,4245,405,0,104,21214
8/17/2015,22,11472,3941,3704,426,0,98,19641
8/17/2015,23,11499,3342,3398,437,0,70,18746
8/17/2015,24,11509,2777,3279,393,0,69,18027
8/18/2015,1,11502,2678,3138,373,0,68,17759
8/18/2015,2,11488,2188,3227,286,0,68,17257
8/18/2015,3,11479,2054,3280,299,0,70,17182
8/18/2015,4,11459,2048,3081,219,0,70,16877
8/18/2015,5,11454,2277,3168,261,0,72,17232
8/18/2015,6,11465,3036,3309,216,0,76,18102
8/18/2015,7,11473,3350,3632,164,4,82,18705
8/18/2015,8,11465,3722,3779,249,13,80,19308
8/18/2015,9,11457,4060,3851,216,13,80,19677
8/18/2015,10,11449,4297,4021,204,9,85,20065
8/18/2015,11,11433,4541,4357,312,3,86,20732
8/18/2015,12,11433,5004,4299,177,14,98,21025
8/18/2015,13,11430,4906,4262,153,36,102,20889
8/18/2015,14,11418,4440,4442,144,36,103,20583
8/18/2015,15,11401,4612,4575,219,40,101,20948
8/18/2015,16,11411,4492,4775,208,43,102,21031
8/18/2015,17,11420,4698,4780,191,43,104,21236
8/18/2015,18,11419,4150,4699,175,26,102,20571
8/18/2015,19,11422,4096,4857,237,5,105,20722
8/18/2015,20,11422,4208,4632,302,0,102,20666
8/18/2015,21,11407,4165,4178,487,0,92,20329
8/18/2015,22,11401,3411,3688,526,0,82,19108
8/18/2015,23,11405,2861,3678,672,0,75,18691
8/18/2015,24,11403,1920,3572,808,0,69,17772
8/19/2015,1,11409,1606,3146,869,0,69,17099
8/19/2015,2,11411,1526,2929,904,0,69,16839
8/19/2015,3,11415,1527,2572,672,0,69,16255
8/19/2015,4,11419,1556,2626,734,0,69,16404
8/19/2015,5,11414,1642,2741,946,0,72,16815
8/19/2015,6,11413,2008,3334,993,0,77,17825
8/19/2015,7,11410,2394,3204,818,13,82,17921
8/19/2015,8,11400,2744,3764,819,17,82,18826
8/19/2015,9,11373,3163,4071,853,51,83,19594
8/19/2015,10,11360,3742,4048,999,75,83,20307
8/19/2015,11,11361,4401,3960,1111,92,89,21014
8/19/2015,12,11365,4628,4145,1292,95,98,21623
8/19/2015,13,11358,4509,4162,1449,95,115,21688
8/19/2015,14,11340,4729,4176,1419,97,109,21870
8/19/2015,15,11345,4329,4516,1448,92,102,21832
8/19/2015,16,11347,4327,4712,1549,75,104,22114
8/19/2015,17,11346,4371,4789,1455,51,105,22117
8/19/2015,18,11362,4806,4609,1204,18,102,22101
8/19/2015,19,11362,4761,4550,1210,3,101,21987
8/19/2015,20,11354,4711,4685,1276,0,102,22128
8/19/2015,21,11352,4706,4391,1292,0,69,21810
8/19/2015,22,11337,3529,3822,1484,0,75,20247
8/19/2015,23,11332,2562,3606,1546,0,73,19119
8/19/2015,24,11330,2182,3217,1562,0,51,18342
8/20/2015,1,11318,1183,2995,1617,0,65,17178
8/20/2015,2,11318,958,2932,1703,0,67,16978
8/20/2015,3,11329,920,2701,1956,0,71,16977
8/20/2015,4,11366,942,2713,2144,0,70,17235
8/20/2015,5,11361,1142,3222,2056,0,72,17853
8/20/2015,6,11366,1511,3431,1810,0,77,18195
8/20/2015,7,11364,2017,3680,1504,1,84,18650
8/20/2015,8,11357,2465,3759,1424,19,85,19109
8/20/2015,9,11342,3047,3926,1337,27,85,19764
8/20/2015,10,11342,3124,3819,1601,9,85,19980
8/20/2015,11,11336,2979,3883,1864,12,84,20158
8/20/2015,12,11336,3016,3843,2046,26,81,20348
8/20/2015,13,11331,3077,3789,2302,68,70,20637
8/20/2015,14,11335,3072,3660,2541,88,70,20766
8/20/2015,15,11341,3062,3864,2618,94,70,21049
8/20/2015,16,11330,2902,4147,2598,78,70,21125
8/20/2015,17,11334,2841,3971,2482,43,70,20741
8/20/2015,18,11331,2834,3760,2204,23,70,20222
8/20/2015,19,11315,2825,3711,2125,4,72,20052
8/20/2015,20,11262,2818,3799,1735,0,73,19687
8/20/2015,21,11254,2485,3772,1659,0,73,19243
8/20/2015,22,11269,1551,3448,1709,0,73,18050
8/20/2015,23,11271,1080,3105,1612,0,66,17134
8/20/2015,24,11278,1009,2878,1393,0,60,16618
8/21/2015,1,11302,965,2672,1089,0,59,16087
8/21/2015,2,11319,963,2653,1026,0,58,16019
8/21/2015,3,11188,965,2624,1161,0,58,15996
8/21/2015,4,11051,966,2621,1116,0,56,15810
8/21/2015,5,10855,975,2684,952,0,59,15525
8/21/2015,6,10856,976,3092,1162,0,64,16150
8/21/2015,7,11009,1014,3033,983,5,65,16109
8/21/2015,8,11324,1192,3475,734,17,60,16802
8/21/2015,9,11439,1353,3532,649,39,53,17065
8/21/2015,10,11446,1483,3763,694,83,71,17540
8/21/2015,11,11455,1929,3647,641,73,72,17817
8/21/2015,12,11470,2019,3905,575,88,72,18129
8/21/2015,13,11472,2126,4135,504,89,67,18393
8/21/2015,14,11466,2316,4002,413,67,54,18318
8/21/2015,15,11454,2360,4017,354,63,54,18302
8/21/2015,16,11444,2554,4089,366,39,55,18547
8/21/2015,17,11450,2541,4333,345,34,54,18757
8/21/2015,18,11461,2541,4511,267,15,55,18850
8/21/2015,19,11465,2223,4862,168,3,54,18775
8/21/2015,20,11475,2266,4907,129,0,55,18832
8/21/2015,21,11482,1893,4635,154,0,56,18220
8/21/2015,22,11491,1592,3666,178,0,59,16986
8/21/2015,23,11492,1157,3577,241,0,55,16522
8/21/2015,24,11505,876,3301,350,0,54,16086
8/22/2015,1,11502,834,2867,341,0,56,15600
8/22/2015,2,11379,835,2749,359,0,56,15378
8/22/2015,3,11205,837,2742,386,0,56,15226
8/22/2015,4,11193,838,2714,304,0,56,15105
8/22/2015,5,10973,839,2898,365,0,54,15129
8/22/2015,6,10945,837,2949,405,0,55,15191
8/22/2015,7,10936,833,3154,364,7,55,15349
8/22/2015,8,11002,826,3685,292,33,55,15893
8/22/2015,9,11314,833,3770,176,63,54,16210
8/22/2015,10,11455,878,3853,161,82,54,16483
8/22/2015,11,11438,898,4093,188,77,55,16749
8/22/2015,12,11407,954,4276,210,87,56,16990
8/22/2015,13,11403,1121,4460,216,98,56,17354
8/22/2015,14,11423,1197,4311,218,97,56,17302
8/22/2015,15,11439,1220,4518,213,95,56,17541
8/22/2015,16,11453,1291,4982,200,79,53,18058
8/22/2015,17,11468,1252,5141,134,53,55,18103
8/22/2015,18,11472,1245,5079,119,24,55,17994
8/22/2015,19,11473,1308,4687,139,4,56,17667
8/22/2015,20,11464,1107,4684,256,0,56,17567
8/22/2015,21,11448,1127,4490,391,0,59,17515
8/22/2015,22,11430,835,3656,515,0,56,16492
8/22/2015,23,11427,790,3316,579,0,56,16168
8/22/2015,24,11451,788,2993,587,0,56,15875
8/23/2015,1,11466,786,2761,564,0,56,15633
8/23/2015,2,11471,788,2693,684,0,56,15692
8/23/2015,3,11477,789,2674,634,0,57,15631
8/23/2015,4,11477,789,2606,482,0,57,15411
8/23/2015,5,11259,790,2544,398,0,56,15047
8/23/2015,6,11169,791,2525,551,0,55,15091
8/23/2015,7,11161,786,2664,375,12,56,15054
8/23/2015,8,11146,750,3076,789,22,55,15838
8/23/2015,9,11351,752,3213,570,59,55,16000
8/23/2015,10,11404,921,3330,632,78,57,16422
8/23/2015,11,11395,1110,3709,628,97,57,16996
8/23/2015,12,11411,1356,4209,607,97,57,17737
8/23/2015,13,11408,1551,4283,611,98,55,18006
8/23/2015,14,11345,1758,4505,551,97,55,18311
8/23/2015,15,11363,1795,4697,663,94,56,18668
8/23/2015,16,11360,1868,4917,744,77,56,19022
8/23/2015,17,11359,2272,4961,679,52,56,19379
8/23/2015,18,11359,2383,4847,659,22,56,19326
8/23/2015,19,11360,2397,4710,744,3,55,19269
8/23/2015,20,11352,1827,4729,1158,0,56,19122
8/23/2015,21,11348,1508,4365,1279,0,55,18555
8/23/2015,22,11340,1107,4242,965,0,54,17708
8/23/2015,23,11337,894,3531,1255,0,55,17072
8/23/2015,24,11342,812,2762,1449,0,55,16420
8/24/2015,1,11338,812,2617,1422,0,55,16244
8/24/2015,2,11327,810,2716,1350,0,55,16258
8/24/2015,3,11324,812,2869,1181,0,55,16241
8/24/2015,4,11331,810,2742,1223,0,57,16163
8/24/2015,5,11322,811,2964,1115,0,66,16278
8/24/2015,6,11325,812,3210,1344,0,69,16760
8/24/2015,7,11338,854,3432,1033,6,78,16741
8/24/2015,8,11334,996,4090,896,32,86,17434
8/24/2015,9,11325,982,3977,1041,63,91,17479
8/24/2015,10,11327,882,3940,1282,86,86,17603
8/24/2015,11,11326,864,4218,1616,77,85,18186
8/24/2015,12,11321,860,3674,1836,48,85,17824
8/24/2015,13,11315,862,4120,1944,84,73,18398
8/24/2015,14,11315,862,4392,1899,15,71,18554
8/24/2015,15,11314,1015,4676,1803,0,70,18878
8/24/2015,16,11308,1149,4785,1867,0,69,19178
8/24/2015,17,11304,1291,4967,1828,0,70,19460
8/24/2015,18,11304,1315,4647,1733,0,70,19069
8/24/2015,19,11304,1281,4800,1605,0,70,19060
8/24/2015,20,11302,1485,4716,1569,0,69,19141
8/24/2015,21,11306,1472,4381,1385,0,68,18612
8/24/2015,22,11320,1304,3507,1359,0,66,17556
8/24/2015,23,11334,966,3162,1208,0,61,16731
8/24/2015,24,11346,869,2981,1069,0,56,16321
8/25/2015,1,11363,870,2756,983,0,57,16029
8/25/2015,2,11387,873,2769,865,0,54,15948
8/25/2015,3,11394,871,2674,816,0,53,15808
8/25/2015,4,11405,873,2915,784,0,56,16033
8/25/2015,5,11418,869,2797,757,0,60,15901
8/25/2015,6,11448,871,3359,850,0,64,16592
8/25/2015,7,11458,879,3390,879,1,68,16675
8/25/2015,8,11473,866,3437,713,11,71,16571
8/25/2015,9,11479,879,4235,827,50,72,17542
8/25/2015,10,11479,916,4402,846,69,74,17786
8/25/2015,11,11476,951,4554,834,84,70,17969
8/25/2015,12,11470,981,4532,883,54,70,17990
8/25/2015,13,11452,1100,4342,890,65,70,17919
8/25/2015,14,11438,1384,4266,839,61,70,18058
8/25/2015,15,11426,1761,4094,826,70,70,18247
8/25/2015,16,11397,1947,3905,811,40,71,18171
8/25/2015,17,11408,2030,3865,704,11,70,18088
8/25/2015,18,11414,2019,3858,560,2,70,17923
8/25/2015,19,11410,2125,3948,559,0,70,18112
8/25/2015,20,11407,1962,4351,603,0,71,18394
8/25/2015,21,11416,1793,4318,634,0,70,18231
8/25/2015,22,11431,1591,3822,598,0,70,17512
8/25/2015,23,11448,1367,3251,691,0,65,16822
8/25/2015,24,11198,1286,2839,541,0,58,15922
8/26/2015,1,10992,972,3066,563,0,55,15648
8/26/2015,2,10992,885,3299,546,0,56,15778
8/26/2015,3,10998,887,3213,531,0,56,15685
8/26/2015,4,10998,887,2918,545,0,55,15403
8/26/2015,5,10994,887,3305,563,0,61,15810
8/26/2015,6,11270,887,3550,579,0,67,16353
8/26/2015,7,11561,893,3508,488,5,70,16525
8/26/2015,8,11550,923,3592,491,21,71,16648
8/26/2015,9,11552,924,3769,596,33,71,16945
8/26/2015,10,11548,909,3945,613,54,67,17136
8/26/2015,11,11553,875,3932,637,58,65,17120
8/26/2015,12,11563,873,3854,643,38,69,17040
8/26/2015,13,11556,900,3850,620,40,69,17035
8/26/2015,14,11526,891,3950,675,28,70,17140
8/26/2015,15,11498,885,3928,682,22,69,17084
8/26/2015,16,11504,920,4162,626,39,70,17321
8/26/2015,17,11513,920,4324,513,14,70,17354
8/26/2015,18,11512,907,4619,423,12,71,17544
8/26/2015,19,11534,884,4992,392,2,68,17872
8/26/2015,20,11523,896,4816,376,0,68,17679
8/26/2015,21,11529,919,4406,315,0,68,17237
8/26/2015,22,11539,896,3644,311,0,66,16456
8/26/2015,23,11551,869,3299,269,0,51,16039
8/26/2015,24,11550,848,3063,238,0,50,15749
8/27/2015,1,11514,858,3100,251,0,52,15775
8/27/2015,2,11535,860,2994,240,0,58,15687
8/27/2015,3,11539,858,3010,221,0,69,15697
8/27/2015,4,11541,862,3164,231,0,69,15867
8/27/2015,5,11542,867,3320,267,0,73,16069
8/27/2015,6,11591,872,3694,225,0,78,16460
8/27/2015,7,11836,877,3469,187,2,76,16447
8/27/2015,8,11840,853,3591,121,17,80,16502
8/27/2015,9,11845,910,3580,169,56,84,16644
8/27/2015,10,11835,919,3871,264,69,67,17025
8/27/2015,11,11840,902,4006,293,63,66,17170
8/27/2015,12,11833,955,3924,284,35,66,17097
8/27/2015,13,11813,905,3921,229,43,66,16977
8/27/2015,14,11804,866,4051,160,36,66,16983
8/27/2015,15,11814,862,4409,93,28,67,17273
8/27/2015,16,11827,863,4613,91,30,68,17492
8/27/2015,17,11825,879,4776,109,20,67,17676
8/27/2015,18,11818,876,4765,132,12,68,17671
8/27/2015,19,11820,883,4846,121,1,67,17738
8/27/2015,20,11811,927,4909,124,0,67,17838
8/27/2015,21,11806,983,4545,141,0,67,17542
8/27/2015,22,11810,925,3795,131,0,67,16728
8/27/2015,23,11797,886,3393,126,0,61,16263
8/27/2015,24,11797,887,3037,112,0,60,15893
8/28/2015,1,11680,889,2667,57,0,59,15352
8/28/2015,2,11491,884,2881,96,0,59,15411
8/28/2015,3,11484,889,2686,86,0,59,15204
8/28/2015,4,11466,890,2984,141,0,61,15542
8/28/2015,5,11464,892,3251,164,0,61,15832
8/28/2015,6,11550,891,3452,162,0,65,16120
8/28/2015,7,11766,965,3979,153,6,63,16932
8/28/2015,8,11850,969,3895,105,28,62,16909
8/28/2015,9,11860,1090,3482,59,56,63,16610
8/28/2015,10,11797,1260,3690,62,79,64,16952
8/28/2015,11,11814,1446,3758,101,76,64,17259
8/28/2015,12,11895,1512,3620,140,65,64,17296
8/28/2015,13,11960,1629,3854,204,97,64,17808
8/28/2015,14,11952,1706,3858,231,97,63,17907
8/28/2015,15,11948,1694,3991,296,93,61,18083
8/28/2015,16,11944,1693,4324,323,72,48,18404
8/28/2015,17,11935,1355,4579,260,47,14,18190
8/28/2015,18,11923,1257,4809,116,16,4,18125
8/28/2015,19,11920,1240,4382,110,2,4,17658
8/28/2015,20,11924,1238,4272,212,0,4,17650
8/28/2015,21,11946,1242,3752,355,0,9,17304
8/28/2015,22,11967,910,3480,450,0,5,16812
8/28/2015,23,12042,784,3013,469,0,4,16312
8/28/2015,24,11978,783,2819,467,0,4,16051
8/29/2015,1,11572,783,2959,613,0,3,15930
8/29/2015,2,11312,782,2723,506,0,3,15326
8/29/2015,3,11091,783,2678,468,0,3,15023
8/29/2015,4,10709,783,2695,469,0,3,14659
8/29/2015,5,10626,783,2827,488,0,3,14727
8/29/2015,6,10704,782,2986,488,0,3,14963
8/29/2015,7,11233,779,3019,379,1,3,15414
8/29/2015,8,11789,775,3141,245,13,2,15965
8/29/2015,9,12050,772,3673,170,20,3,16688
8/29/2015,10,12039,771,3865,94,22,3,16794
8/29/2015,11,12031,763,3935,91,56,3,16879
8/29/2015,12,12027,763,3924,89,87,3,16893
8/29/2015,13,12029,761,4130,88,91,3,17102
8/29/2015,14,12033,723,4205,96,92,3,17152
8/29/2015,15,12038,721,4428,81,64,3,17335
8/29/2015,16,12045,722,4436,69,52,3,17327
8/29/2015,17,12039,726,4528,55,32,3,17383
8/29/2015,18,12041,766,4458,54,7,3,17329
8/29/2015,19,12047,759,4293,92,0,3,17194
8/29/2015,20,12049,787,4706,122,0,6,17670
8/29/2015,21,12059,789,4282,142,0,6,17278
8/29/2015,22,12063,803,3633,174,0,6,16679
8/29/2015,23,12047,775,3416,99,0,8,16345
8/29/2015,24,11970,774,3328,59,0,3,16134
8/30/2015,1,11720,775,3271,42,0,1,15809
8/30/2015,2,11457,776,2927,56,0,1,15217
8/30/2015,3,11234,778,2838,78,0,1,14929
8/30/2015,4,10934,777,2847,105,0,1,14664
8/30/2015,5,10863,776,3102,108,0,1,14850
8/30/2015,6,10879,777,3055,129,0,1,14841
8/30/2015,7,11261,771,3249,178,0,1,15460
8/30/2015,8,11594,769,2902,159,14,1,15439
8/30/2015,9,11780,775,3052,131,38,1,15777
8/30/2015,10,11930,852,3388,110,40,1,16321
8/30/2015,11,12036,991,3694,118,64,1,16904
8/30/2015,12,12034,1116,4040,170,75,1,17436
8/30/2015,13,11976,1412,4522,187,82,1,18180
8/30/2015,14,11993,1607,4765,231,84,1,18681
8/30/2015,15,11988,1655,4633,277,90,1,18644
8/30/2015,16,11966,1763,4786,243,71,1,18830
8/30/2015,17,11941,1842,4997,191,45,1,19017
8/30/2015,18,11924,1859,4922,139,18,1,18863
8/30/2015,19,11928,1827,4932,132,3,1,18823
8/30/2015,20,11920,2056,4913,184,0,1,19074
8/30/2015,21,11926,2247,4674,182,0,2,19031
8/30/2015,22,11951,1431,4516,224,0,8,18130
8/30/2015,23,11974,890,3827,298,0,20,17009
8/30/2015,24,11982,770,3482,357,0,19,16610
8/31/2015,1,11997,767,3183,386,0,20,16353
8/31/2015,2,12003,786,3182,354,0,18,16343
8/31/2015,3,12009,789,2944,307,0,21,16070
8/31/2015,4,12011,795,2838,245,0,16,15905
8/31/2015,5,11998,911,2967,208,0,14,16098
8/31/2015,6,11995,1190,3242,229,0,16,16672
8/31/2015,7,11984,1567,3263,181,4,17,17016
8/31/2015,8,11971,1930,3412,135,24,18,17490
8/31/2015,9,11973,2346,3705,107,48,12,18191
8/31/2015,10,11971,3023,4216,157,72,8,19447
8/31/2015,11,11959,3377,4566,278,50,10,20240
8/31/2015,12,11939,3706,4685,403,51,7,20791
8/31/2015,13,11943,3788,4736,402,91,6,20966
8/31/2015,14,11956,4055,5170,418,94,1,21694
8/31/2015,15,11961,4067,5253,482,84,2,21849
8/31/2015,16,11962,3976,5465,430,65,3,21901
8/31/2015,17,11990,4172,5476,322,40,8,22008
8/31/2015,18,11993,4122,5450,247,16,8,21836
8/31/2015,19,12000,4281,5346,226,2,10,21865
8/31/2015,20,11997,4143,5154,250,0,14,21558
8/31/2015,21,11998,3713,4632,254,0,5,20602
8/31/2015,22,11999,2687,4147,220,0,4,19057
8/31/2015,23,11989,1928,3869,200,0,7,17993
8/31/2015,24,11992,1508,3543,212,0,1,17256
9/1/2015,1,11987,1141,3164,209,0,1,16502
9/1/2015,2,11975,1037,2929,203,0,1,16145
9/1/2015,3,11981,1023,3069,196,0,1,16270
9/1/2015,4,11972,1243,2781,158,0,9,16163
9/1/2015,5,11976,1568,2810,139,0,20,16513
9/1/2015,6,11984,1973,3131,139,0,28,17255
9/1/2015,7,11992,2582,2831,113,5,32,17555
9/1/2015,8,11990,2983,2950,103,23,33,18082
9/1/2015,9,11977,3200,3769,56,45,33,19080
9/1/2015,10,11964,4112,3927,40,66,34,20143
9/1/2015,11,11951,4547,3856,72,81,34,20541
9/1/2015,12,11941,4230,4220,148,91,34,20664
9/1/2015,13,11893,4213,4501,188,94,30,20919
9/1/2015,14,11823,4586,4798,256,90,29,21582
9/1/2015,15,11468,5066,5019,278,79,31,21941
9/1/2015,16,11467,5113,4959,284,60,41,21924
9/1/2015,17,11461,4633,5199,235,37,36,21601
9/1/2015,18,11458,4112,5334,172,15,40,21131
9/1/2015,19,11445,3953,5319,214,2,40,20973
9/1/2015,20,11438,4131,5167,285,0,36,21057
9/1/2015,21,11438,3939,4554,457,0,31,20419
9/1/2015,22,11466,3571,4162,539,0,29,19767
9/1/2015,23,11461,2870,3098,632,0,19,18080
9/1/2015,24,11470,1747,2913,723,0,16,16869
9/2/2015,1,11465,1099,3221,694,0,16,16495
9/2/2015,2,11467,1002,3102,611,0,15,16197
9/2/2015,3,11466,1011,3209,495,0,15,16196
9/2/2015,4,11467,1206,3072,441,0,15,16201
9/2/2015,5,11468,1634,3338,345,0,17,16802
9/2/2015,6,11462,2344,3532,265,0,23,17626
9/2/2015,7,11448,3279,3493,235,2,29,18486
9/2/2015,8,11437,3499,3792,127,24,29,18908
9/2/2015,9,11430,4017,4042,38,48,30,19605
9/2/2015,10,11416,4951,4345,32,74,29,20847
9/2/2015,11,11413,4993,4207,107,90,28,20838
9/2/2015,12,11414,5209,4206,267,97,29,21222
9/2/2015,13,11406,4686,4707,457,97,33,21386
9/2/2015,14,11398,4565,4777,562,68,32,21402
9/2/2015,15,11399,4630,5178,589,83,36,21915
9/2/2015,16,11368,4724,5154,478,46,39,21809
9/2/2015,17,11359,4858,5161,276,14,40,21708
9/2/2015,18,11347,4654,5062,250,21,39,21373
9/2/2015,19,11338,4578,5098,369,1,39,21423
9/2/2015,20,11333,4754,4832,361,0,40,21320
9/2/2015,21,11321,4661,4297,289,0,38,20606
9/2/2015,22,11316,4500,3805,276,0,43,19940
9/2/2015,23,11305,2985,3610,318,0,64,18282
9/2/2015,24,11304,2352,3448,85,0,83,17272
9/3/2015,1,11306,1686,3482,64,0,85,16623
9/3/2015,2,11450,1294,3089,114,0,88,16035
9/3/2015,3,11558,1259,3218,137,0,86,16258
9/3/2015,4,11661,1501,2940,128,0,88,16318
9/3/2015,5,11687,1896,3332,94,0,88,17097
9/3/2015,6,11694,2338,3382,69,1,88,17572
9/3/2015,7,11685,2779,3385,53,6,95,18003
9/3/2015,8,11687,3278,3692,60,18,99,18834
9/3/2015,9,11686,3525,3875,47,36,99,19268
9/3/2015,10,11688,3735,4367,42,62,100,19994
9/3/2015,11,11691,4151,4459,55,89,129,20574
9/3/2015,12,11681,4290,4440,56,96,162,20725
9/3/2015,13,11683,4450,4280,99,96,176,20784
9/3/2015,14,11679,4110,4373,376,95,165,20798
9/3/2015,15,11675,3136,4388,1064,85,125,20473
9/3/2015,16,11670,3373,5083,532,54,114,20826
9/3/2015,17,11666,3955,5073,264,11,180,21149
9/3/2015,18,11672,3620,4981,218,6,195,20692
9/3/2015,19,11672,3620,4945,275,1,195,20708
9/3/2015,20,11657,3330,4944,338,0,190,20459
9/3/2015,21,11677,3146,4161,311,0,188,19483
9/3/2015,22,11686,2466,4047,321,0,189,18709
9/3/2015,23,11681,2031,3601,319,0,177,17809
9/3/2015,24,11691,1177,3483,363,0,174,16888
9/4/2015,1,11686,1067,3131,526,0,172,16582
9/4/2015,2,11695,1039,2853,609,0,173,16369
9/4/2015,3,11691,1262,3003,560,0,173,16689
9/4/2015,4,11698,1615,2813,504,0,176,16806
9/4/2015,5,11707,1855,2653,474,0,163,16852
9/4/2015,6,11703,1999,2712,468,0,173,17055
9/4/2015,7,11688,2019,2716,540,6,165,17134
9/4/2015,8,11673,2107,3096,574,10,125,17585
9/4/2015,9,11655,2417,3607,570,13,122,18384
9/4/2015,10,11656,2707,4159,552,39,91,19204
9/4/2015,11,11656,3115,4367,550,77,57,19822
9/4/2015,12,11660,3346,4367,640,74,33,20120
9/4/2015,13,11655,3538,4524,553,50,34,20354
9/4/2015,14,11650,3490,4490,551,45,34,20260
9/4/2015,15,11641,3194,4788,595,48,34,20300
9/4/2015,16,11643,3378,4943,574,63,34,20635
9/4/2015,17,11636,3956,5126,531,31,33,21313
9/4/2015,18,11625,4028,4873,551,16,33,21126
9/4/2015,19,11623,3089,4327,632,2,29,19702
9/4/2015,20,11613,3135,4226,831,0,23,19828
9/4/2015,21,11613,2096,3833,1165,0,22,18729
9/4/2015,22,11618,1400,3594,1283,0,23,17918
9/4/2015,23,11622,984,3178,1260,0,21,17065
9/4/2015,24,11639,875,3030,1086,0,4,16634
9/5/2015,1,11648,865,3088,927,0,4,16532
9/5/2015,2,11649,862,3068,974,0,4,16557
9/5/2015,3,11651,861,3054,863,0,4,16433
9/5/2015,4,11660,868,3050,756,0,4,16338
9/5/2015,5,11653,869,3109,661,0,4,16296
9/5/2015,6,11643,871,3260,624,0,5,16403
9/5/2015,7,11642,903,2974,523,4,5,16051
9/5/2015,8,11640,1112,3033,562,19,4,16370
9/5/2015,9,11636,1527,3285,353,51,4,16856
9/5/2015,10,11633,2077,3658,344,74,4,17790
9/5/2015,11,11631,2401,3595,355,90,4,18076
9/5/2015,12,11624,2498,3983,397,97,4,18603
9/5/2015,13,11618,3252,4039,379,97,4,19389
9/5/2015,14,11592,3749,4039,433,96,4,19913
9/5/2015,15,11607,3908,4201,402,87,4,20209
9/5/2015,16,11609,3756,4500,293,68,4,20230
9/5/2015,17,11601,3888,4685,197,43,4,20418
9/5/2015,18,11603,3703,4593,151,16,3,20069
9/5/2015,19,11598,3900,4220,84,1,3,19806
9/5/2015,20,11582,3978,3997,121,0,3,19681
9/5/2015,21,11598,3433,3974,149,0,3,19157
9/5/2015,22,11595,2895,3718,203,0,3,18414
9/5/2015,23,11602,1772,3720,232,0,3,17329
9/5/2015,24,11617,1132,3737,308,0,4,16798
9/6/2015,1,11622,877,3827,344,0,4,16674
9/6/2015,2,11624,840,3353,491,0,4,16312
9/6/2015,3,11628,752,3171,409,0,4,15964
9/6/2015,4,11629,739,3230,379,0,3,15980
9/6/2015,5,11626,743,3014,411,0,3,15797
9/6/2015,6,11631,764,2986,344,0,4,15729
9/6/2015,7,11344,951,3103,273,2,4,15677
9/6/2015,8,11094,1302,3764,294,23,4,16481
9/6/2015,9,11455,1828,3647,212,49,3,17194
9/6/2015,10,11640,2316,3546,271,75,3,17851
9/6/2015,11,11646,2911,3823,301,91,3,18775
9/6/2015,12,11651,3316,3682,300,97,3,19049
9/6/2015,13,11643,3477,3726,258,96,3,19203
9/6/2015,14,11647,3975,4155,295,95,3,20170
9/6/2015,15,11646,3813,4114,350,86,3,20012
9/6/2015,16,11648,3738,4595,341,68,3,20393
9/6/2015,17,11657,3653,4768,313,43,3,20437
9/6/2015,18,11647,3606,4804,329,16,3,20405
9/6/2015,19,11647,3470,4721,397,0,3,20238
9/6/2015,20,11638,3982,4334,468,0,3,20425
9/6/2015,21,11633,3677,3838,677,0,4,19829
9/6/2015,22,11641,2665,3435,842,0,4,18587
9/6/2015,23,11646,1213,3714,1013,0,4,17590
9/6/2015,24,11644,992,3229,1126,0,3,16994
9/7/2015,1,11654,873,2966,941,0,3,16437
9/7/2015,2,11654,863,2983,987,0,3,16490
9/7/2015,3,11652,867,3086,1129,0,3,16737
9/7/2015,4,11641,899,3035,1178,0,3,16756
9/7/2015,5,11636,902,3090,1239,0,3,16870
9/7/2015,6,11645,907,3131,1104,0,3,16790
9/7/2015,7,11636,977,3202,1067,2,3,16887
9/7/2015,8,11640,1236,3629,986,26,3,17520
9/7/2015,9,11639,1796,3769,973,53,3,18233
9/7/2015,10,11642,2874,3818,1055,77,3,19469
9/7/2015,11,11632,3327,3863,1041,93,4,19960
9/7/2015,12,11623,3747,3998,1046,97,5,20516
9/7/2015,13,11611,4289,4069,1069,97,3,21138
9/7/2015,14,11596,4667,3968,1193,96,3,21523
9/7/2015,15,11596,4620,4246,1257,87,3,21809
9/7/2015,16,11598,4621,4367,1157,68,8,21819
9/7/2015,17,11594,4933,4565,1001,42,8,22143
9/7/2015,18,11595,4754,4457,989,12,7,21814
9/7/2015,19,11591,4947,4793,938,1,10,22280
9/7/2015,20,11599,5030,4925,824,0,8,22386
9/7/2015,21,11592,4820,4332,522,0,4,21270
9/7/2015,22,11569,4208,3709,379,0,2,19867
9/7/2015,23,11598,3319,3675,189,0,2,18783
9/7/2015,24,11620,2195,3793,99,0,2,17709
9/8/2015,1,11639,1179,3826,74,0,2,16720
9/8/2015,2,11651,1115,3745,77,0,4,16592
9/8/2015,3,11655,1272,3231,114,0,8,16280
9/8/2015,4,11659,1674,3019,198,0,20,16570
9/8/2015,5,11659,2108,2992,320,0,19,17098
9/8/2015,6,11653,2736,3190,349,0,26,17954
9/8/2015,7,11651,3215,3446,330,2,33,18677
9/8/2015,8,11650,3339,3349,307,25,33,18703
9/8/2015,9,11639,3596,3500,243,43,34,19055
9/8/2015,10,11628,3936,3756,268,76,33,19697
9/8/2015,11,11614,4581,3921,339,90,33,20578
9/8/2015,12,11608,4596,4030,464,92,34,20824
9/8/2015,13,11609,5051,4534,488,88,40,21810
9/8/2015,14,11602,5093,4575,696,69,44,22079
9/8/2015,15,11605,4872,4455,1138,56,50,22176
9/8/2015,16,11600,3882,4618,1405,45,51,21601
9/8/2015,17,11592,4295,4784,1276,45,50,22042
9/8/2015,18,11586,4813,4693,1232,12,52,22388
9/8/2015,19,11581,4520,4623,1173,1,49,21947
9/8/2015,20,11563,4969,4211,1119,0,44,21906
9/8/2015,21,11554,4751,3663,1282,0,37,21287
9/8/2015,22,11554,3548,3400,1754,0,33,20289
9/8/2015,23,11570,2452,2927,1950,0,23,18922
9/8/2015,24,11560,1211,3153,1697,0,20,17641
9/9/2015,1,11549,1010,3589,1257,0,20,17425
9/9/2015,2,11528,1115,3485,1024,0,20,17172
9/9/2015,3,11548,1132,3176,1079,0,20,16955
9/9/2015,4,11558,1390,2953,995,0,20,16916
9/9/2015,5,11570,1827,2926,824,0,21,17168
9/9/2015,6,11574,2216,3270,761,0,30,17851
9/9/2015,7,11580,2908,3576,665,0,34,18763
9/9/2015,8,11582,3074,3651,684,4,34,19029
9/9/2015,9,11599,3122,3617,753,11,33,19135
9/9/2015,10,11610,3499,3685,582,19,33,19428
9/9/2015,11,11619,3814,3930,607,51,33,20054
9/9/2015,12,11623,3962,3982,681,60,33,20341
9/9/2015,13,11627,3937,4162,741,70,33,20570
9/9/2015,14,11628,3943,3918,745,57,32,20323
9/9/2015,15,11615,3815,3565,832,61,33,19921
9/9/2015,16,11614,3762,4352,791,42,33,20594
9/9/2015,17,11632,3776,4516,692,17,33,20666
9/9/2015,18,11643,3685,4416,551,8,34,20337
9/9/2015,19,11660,3652,3819,458,1,36,19626
9/9/2015,20,11666,3369,4002,482,0,35,19554
9/9/2015,21,11662,3164,3396,439,0,35,18696
9/9/2015,22,11654,2523,2901,391,0,37,17506
9/9/2015,23,11668,1165,3167,522,0,29,16551
9/9/2015,24,11656,938,3035,432,0,23,16084
9/10/2015,1,11376,959,3031,434,0,22,15822
9/10/2015,2,11145,961,2900,519,0,22,15547
9/10/2015,3,11170,963,2816,400,0,21,15370
9/10/2015,4,11182,967,2904,425,0,24,15502
9/10/2015,5,11180,1003,3080,467,0,29,15759
9/10/2015,6,11183,1144,3388,422,1,35,16173
9/10/2015,7,11248,1202,3859,393,2,36,16740
9/10/2015,8,11630,1169,3357,374,11,35,16576
9/10/2015,9,11685,1166,3682,180,55,36,16804
9/10/2015,10,11673,1372,4006,222,86,36,17395
9/10/2015,11,11671,1493,4014,389,94,37,17698
9/10/2015,12,11697,1673,3972,355,88,36,17821
9/10/2015,13,11164,2251,4245,216,76,36,17988
9/10/2015,14,10895,2391,3869,193,74,36,17458
9/10/2015,15,10884,2561,3879,129,42,34,17529
9/10/2015,16,10873,2927,3977,128,52,34,17991
9/10/2015,17,10865,2776,4275,154,32,34,18136
9/10/2015,18,10872,2641,4069,164,23,37,17806
9/10/2015,19,10878,2349,4257,194,2,38,17718
9/10/2015,20,10880,2678,4261,182,0,38,18039
9/10/2015,21,10318,2729,4075,188,0,40,17350
9/10/2015,22,10226,2345,3369,222,0,43,16205
9/10/2015,23,10091,1664,3483,259,0,37,15534
9/10/2015,24,10099,1195,3290,249,0,27,14860
9/11/2015,1,10112,968,3576,246,0,22,14924
9/11/2015,2,10111,969,3357,205,0,19,14661
9/11/2015,3,10114,1038,3106,238,0,18,14514
9/11/2015,4,9924,1144,3049,283,0,18,14418
9/11/2015,5,9868,1160,3287,307,0,22,14644
9/11/2015,6,9951,1383,3481,349,0,27,15191
9/11/2015,7,10135,1959,3458,368,5,32,15957
9/11/2015,8,10133,1828,3417,384,31,33,15826
9/11/2015,9,10139,1797,3535,386,61,33,15951
9/11/2015,10,10145,1803,3574,520,81,34,16157
9/11/2015,11,10146,1739,3796,445,94,33,16253
9/11/2015,12,10165,1890,3930,496,97,131,16709
9/11/2015,13,10172,1956,3613,769,89,133,16732
9/11/2015,14,10171,1978,3492,877,55,133,16706
9/11/2015,15,10183,1934,3561,1159,24,133,16994
9/11/2015,16,10210,1741,4018,1021,5,134,17129
9/11/2015,17,10226,1901,4164,978,4,134,17407
9/11/2015,18,10234,1812,3975,934,4,134,17093
9/11/2015,19,10239,1817,4307,870,0,134,17367
9/11/2015,20,10221,1892,4222,906,0,133,17374
9/11/2015,21,10209,1649,3661,863,0,133,16515
9/11/2015,22,9646,1210,3470,873,0,133,15332
9/11/2015,23,9604,911,3308,884,0,124,14831
9/11/2015,24,9597,692,3159,869,0,120,14437
9/12/2015,1,9609,650,3015,857,0,120,14251
9/12/2015,2,9551,642,3052,753,0,121,14119
9/12/2015,3,9418,690,3303,708,0,119,14238
9/12/2015,4,9415,777,3207,691,0,119,14209
9/12/2015,5,9415,670,2845,869,0,118,13917
9/12/2015,6,9415,639,2779,720,0,116,13669
9/12/2015,7,9409,620,2932,1020,0,114,14095
9/12/2015,8,9405,619,3101,1008,5,119,14257
9/12/2015,9,9401,678,3698,903,10,119,14809
9/12/2015,10,9396,794,3945,924,6,120,15185
9/12/2015,11,9392,811,3797,1073,7,119,15199
9/12/2015,12,9387,814,3635,1053,10,118,15017
9/12/2015,13,9387,780,3424,1310,7,119,15027
9/12/2015,14,9388,642,3069,1535,12,119,14765
9/12/2015,15,9386,624,3286,1633,8,119,15056
9/12/2015,16,9382,622,3307,1994,5,120,15430
9/12/2015,17,9376,622,3456,2304,1,120,15879
9/12/2015,18,9378,611,3629,2236,0,122,15976
9/12/2015,19,9382,578,3815,2080,0,116,15971
9/12/2015,20,9378,577,4131,1751,0,103,15940
9/12/2015,21,9373,576,3902,1383,0,103,15337
9/12/2015,22,8747,636,4070,1102,0,103,14658
9/12/2015,23,8541,774,3704,937,0,102,14058
9/12/2015,24,8550,704,3121,925,0,103,13403
9/13/2015,1,8547,586,2632,900,0,102,12767
9/13/2015,2,8552,582,2536,824,0,102,12596
9/13/2015,3,8553,582,2561,833,0,102,12631
9/13/2015,4,8554,581,2476,806,0,102,12519
9/13/2015,5,8559,581,2564,746,0,103,12553
9/13/2015,6,8562,581,2622,851,0,103,12719
9/13/2015,7,8564,594,3312,848,0,103,13421
9/13/2015,8,8559,603,3355,934,5,103,13559
9/13/2015,9,8564,601,3474,1301,22,103,14065
9/13/2015,10,8558,609,3471,1548,38,103,14327
9/13/2015,11,8559,610,3358,1672,26,103,14328
9/13/2015,12,8570,664,3780,1533,29,103,14679
9/13/2015,13,8572,881,4034,1386,20,104,14997
9/13/2015,14,8577,1147,4228,1432,15,103,15502
9/13/2015,15,8581,1150,3879,1544,12,102,15268
9/13/2015,16,8530,1309,3546,1487,9,103,14984
9/13/2015,17,8582,1440,3985,1262,4,104,15377
9/13/2015,18,8587,1488,4651,937,2,120,15785
9/13/2015,19,8594,1654,4844,622,1,119,15834
9/13/2015,20,8599,1501,4654,679,0,119,15552
9/13/2015,21,8598,1412,4096,679,0,121,14906
9/13/2015,22,8073,1095,3984,655,0,128,13935
9/13/2015,23,7949,1118,3835,574,0,130,13606
9/13/2015,24,7950,683,3123,622,0,121,12499
9/14/2015,1,7952,607,3260,828,0,120,12767
9/14/2015,2,7861,670,3000,1036,0,120,12687
9/14/2015,3,7713,782,2719,1078,0,121,12413
9/14/2015,4,7715,991,2531,962,0,122,12321
9/14/2015,5,7716,1355,2677,956,0,122,12826
9/14/2015,6,7713,1897,3109,970,0,128,13817
9/14/2015,7,7723,2475,3376,896,5,136,14611
9/14/2015,8,7724,2745,3358,730,31,139,14727
9/14/2015,9,7719,2988,3445,471,63,137,14823
9/14/2015,10,7740,3096,3443,546,87,138,15050
9/14/2015,11,7739,3075,3612,670,97,136,15329
9/14/2015,12,7731,3103,3662,859,96,133,15584
9/14/2015,13,7728,3109,3381,1101,97,35,15451
9/14/2015,14,7601,3173,3296,1254,97,34,15455
9/14/2015,15,7657,3108,3280,1138,93,34,15310
9/14/2015,16,7721,2923,3760,1480,75,34,15993
9/14/2015,17,7721,2827,4381,1511,46,34,16520
9/14/2015,18,7716,2832,4433,1164,16,36,16197
9/14/2015,19,7712,2842,4660,986,1,31,16232
9/14/2015,20,7712,2949,4643,1094,0,24,16422
9/14/2015,21,7702,2965,3662,1322,0,26,15677
9/14/2015,22,7711,2666,3307,1361,0,26,15071
9/14/2015,23,7726,1853,3026,1331,0,18,13954
9/14/2015,24,7745,1403,2698,1212,0,20,13078
9/15/2015,1,7746,1218,2612,1110,0,19,12705
9/15/2015,2,7746,1148,2595,1075,0,20,12584
9/15/2015,3,7743,1156,2549,1043,0,21,12512
9/15/2015,4,7739,1440,2585,954,0,24,12742
9/15/2015,5,7718,2041,2613,774,0,26,13172
9/15/2015,6,7699,2819,2657,891,0,29,14095
9/15/2015,7,7694,3283,2801,966,3,35,14782
9/15/2015,8,7690,3336,2960,855,28,40,14909
9/15/2015,9,7705,3449,3126,596,58,37,14971
9/15/2015,10,7698,3445,3176,522,82,37,14960
9/15/2015,11,7666,3467,3250,526,97,36,15042
9/15/2015,12,7643,3509,3274,631,98,36,15191
9/15/2015,13,7634,3497,3258,792,98,36,15315
9/15/2015,14,7628,3428,3486,923,98,35,15598
9/15/2015,15,7641,3446,3598,1005,91,35,15816
9/15/2015,16,7665,3428,4076,1053,70,36,16328
9/15/2015,17,7668,3447,4484,952,41,36,16628
9/15/2015,18,7676,3615,4700,833,13,31,16868
9/15/2015,19,7687,3844,4684,756,1,30,17002
9/15/2015,20,7694,3687,4581,857,0,30,16849
9/15/2015,21,7711,3288,4055,891,0,30,15975
9/15/2015,22,7717,3207,3285,927,0,31,15167
9/15/2015,23,7728,2873,2990,844,0,24,14459
9/15/2015,24,7733,2758,2678,767,0,19,13955
9/16/2015,1,7715,2279,2640,877,0,18,13529
9/16/2015,2,7680,2196,2650,820,0,20,13366
9/16/2015,3,7331,2220,2829,795,0,23,13198
9/16/2015,4,7175,2200,2742,841,0,24,12982
9/16/2015,5,7178,2317,2703,628,0,23,12849
9/16/2015,6,7184,2649,3139,671,0,28,13671
9/16/2015,7,7192,2998,3167,629,4,35,14025
9/16/2015,8,7201,3061,3331,515,23,36,14167
9/16/2015,9,7204,3602,3447,308,56,36,14653
9/16/2015,10,7218,3757,3710,277,81,36,15079
9/16/2015,11,7230,3843,3864,321,95,36,15389
9/16/2015,12,7231,4224,3824,353,98,136,15866
9/16/2015,13,7235,4706,3942,447,97,60,16487
9/16/2015,14,7226,4404,3977,509,97,35,16248
9/16/2015,15,7212,4817,4301,529,90,35,16984
9/16/2015,16,7194,5017,4639,485,70,35,17440
9/16/2015,17,7183,5182,5080,385,43,35,17908
9/16/2015,18,7189,5015,5132,338,14,35,17723
9/16/2015,19,7198,4757,5269,365,0,35,17624
9/16/2015,20,7198,4705,5213,534,0,35,17685
9/16/2015,21,7195,4307,4501,741,0,36,16780
9/16/2015,22,7210,3973,3674,1021,0,36,15914
9/16/2015,23,7225,3395,3128,981,0,27,14756
9/16/2015,24,7231,3069,2925,1004,0,24,14253
9/17/2015,1,7248,2492,2953,901,0,21,13615
9/17/2015,2,7248,2451,3079,803,0,21,13602
9/17/2015,3,7253,2430,3038,800,0,21,13542
9/17/2015,4,7257,2539,2976,793,0,23,13588
9/17/2015,5,7255,2898,2813,753,0,25,13744
9/17/2015,6,7257,3393,2955,658,0,33,14296
9/17/2015,7,7260,3706,3016,681,2,47,14712
9/17/2015,8,7250,3655,3141,335,25,53,14459
9/17/2015,9,7223,3747,3770,236,58,47,15081
9/17/2015,10,7214,4203,3981,211,81,50,15740
9/17/2015,11,7206,4381,3860,247,96,40,15830
9/17/2015,12,7213,4416,4015,449,98,36,16227
9/17/2015,13,7210,4489,4124,674,97,36,16630
9/17/2015,14,7218,4665,4290,864,97,35,17169
9/17/2015,15,7221,4585,4611,900,91,36,17444
9/17/2015,16,7220,4805,4822,792,71,36,17746
9/17/2015,17,7227,5022,4922,697,43,37,17948
9/17/2015,18,7241,5269,4981,454,14,35,17994
9/17/2015,19,7248,5138,4959,459,0,34,17838
9/17/2015,20,7240,4986,4683,685,0,35,17629
9/17/2015,21,7235,4241,4544,925,0,34,16979
9/17/2015,22,7220,3731,4130,1118,0,34,16233
9/17/2015,23,7221,3320,3123,1307,0,28,14999
9/17/2015,24,7222,2233,3353,1455,0,22,14285
9/18/2015,1,7216,2062,2763,1476,0,20,13537
9/18/2015,2,7208,2064,2697,1530,0,19,13518
9/18/2015,3,7214,2078,2806,1476,0,20,13594
9/18/2015,4,7218,2203,2851,1351,0,20,13643
9/18/2015,5,7196,2497,3209,1199,0,23,14124
9/18/2015,6,7191,3176,3050,1103,0,31,14551
9/18/2015,7,7227,3662,3283,1115,4,36,15327
9/18/2015,8,7281,3587,3655,1015,28,37,15603
9/18/2015,9,7299,3688,3898,1096,54,37,16072
9/18/2015,10,7295,3765,4020,1281,82,36,16479
9/18/2015,11,7296,3966,4303,1193,96,37,16891
9/18/2015,12,7291,4591,4483,1058,93,37,17553
9/18/2015,13,7279,4544,4622,798,75,36,17354
9/18/2015,14,7372,4496,4707,679,66,36,17356
9/18/2015,15,7538,3934,4731,651,28,36,16918
9/18/2015,16,7541,3983,4767,501,7,36,16835
9/18/2015,17,7549,4071,4807,380,3,36,16846
9/18/2015,18,7561,4069,4867,337,2,36,16872
9/18/2015,19,7556,4100,4842,227,0,36,16761
9/18/2015,20,7554,4610,4495,216,0,36,16911
9/18/2015,21,7550,4167,3849,251,0,36,15853
9/18/2015,22,7564,3619,3694,281,0,36,15194
9/18/2015,23,7569,3143,3562,359,0,30,14663
9/18/2015,24,7577,2835,3468,372,0,26,14278
9/19/2015,1,7583,2199,3485,469,0,23,13759
9/19/2015,2,7653,1606,3151,708,0,22,13140
9/19/2015,3,7657,1025,2951,1064,0,21,12718
9/19/2015,4,7653,912,3099,1125,0,21,12810
9/19/2015,5,7650,883,3099,1655,0,22,13309
9/19/2015,6,7642,886,2775,2211,0,23,13537
9/19/2015,7,7639,1008,2637,2329,0,23,13636
9/19/2015,8,7633,1351,3430,2391,5,23,14833
9/19/2015,9,7628,1882,3975,2432,15,22,15954
9/19/2015,10,7618,2601,3999,2550,37,22,16827
9/19/2015,11,7599,2495,4136,2648,37,22,16937
9/19/2015,12,7609,2983,4406,2324,24,21,17367
9/19/2015,13,7598,3300,4239,2637,20,21,17815
9/19/2015,14,7600,2395,3766,2985,21,21,16788
9/19/2015,15,7596,2517,4031,2882,13,21,17060
9/19/2015,16,7584,2601,4065,2772,15,20,17057
9/19/2015,17,7597,2762,3822,2655,16,21,16873
9/19/2015,18,7602,2786,3861,2348,7,22,16626
9/19/2015,19,7610,2892,4499,1742,0,23,16766
9/19/2015,20,7620,3180,4326,1342,0,22,16490
9/19/2015,21,7622,2816,3802,1177,0,22,15439
9/19/2015,22,7637,2660,3541,997,0,21,14856
9/19/2015,23,7648,2107,3430,744,0,20,13949
9/19/2015,24,7655,1208,3452,552,0,20,12887
9/20/2015,1,7653,1033,2998,654,0,21,12359
9/20/2015,2,7635,1024,2870,681,0,22,12232
9/20/2015,3,7551,1026,3096,681,0,22,12376
9/20/2015,4,7513,1089,3236,675,0,21,12534
9/20/2015,5,7524,1216,3150,627,0,21,12538
9/20/2015,6,7527,1590,3162,523,0,21,12823
9/20/2015,7,7525,1880,2650,380,5,30,12470
9/20/2015,8,7530,2037,2956,244,32,9,12808
9/20/2015,9,7535,2104,3191,146,60,11,13047
9/20/2015,10,7531,2235,3191,94,80,25,13156
9/20/2015,11,7522,2315,3533,98,82,28,13578
9/20/2015,12,7515,2668,3648,92,88,33,14044
9/20/2015,13,7317,2901,3663,106,94,58,14139
9/20/2015,14,7137,2779,3814,120,97,64,14011
9/20/2015,15,7149,2818,3834,116,87,60,14064
9/20/2015,16,7169,3066,4252,132,57,63,14739
9/20/2015,17,7209,3519,4654,132,34,60,15608
9/20/2015,18,7220,3727,4704,122,11,60,15844
9/20/2015,19,7217,3761,4717,183,0,57,15935
9/20/2015,20,7210,3589,4439,233,0,62,15533
9/20/2015,21,7209,3163,4033,276,0,55,14736
9/20/2015,22,7210,2673,3966,263,0,57,14169
9/20/2015,23,7223,2240,3848,276,0,56,13643
9/20/2015,24,7236,1870,3084,327,0,59,12576
9/21/2015,1,7239,1431,2995,362,0,59,12086
9/21/2015,2,7248,1319,3025,493,0,55,12140
9/21/2015,3,7251,1440,3022,539,0,60,12312
9/21/2015,4,7247,1747,2980,616,0,62,12652
9/21/2015,5,7255,2348,2811,781,0,65,13260
9/21/2015,6,7272,2977,2795,993,0,72,14109
9/21/2015,7,7271,3214,2858,1004,2,77,14426
9/21/2015,8,7270,3448,3294,884,20,75,14991
9/21/2015,9,7261,3633,3668,708,47,70,15387
9/21/2015,10,7254,3551,3577,1067,56,64,15569
9/21/2015,11,7249,3548,3316,1203,79,71,15466
9/21/2015,12,7246,3580,3934,1092,75,70,15997
9/21/2015,13,7271,3847,3975,847,87,66,16093
9/21/2015,14,7292,3743,4231,720,75,66,16127
9/21/2015,15,7297,3912,4277,636,92,69,16283
9/21/2015,16,7301,4022,4399,592,73,70,16457
9/21/2015,17,7303,4067,4567,510,35,68,16550
9/21/2015,18,7300,3949,4663,456,13,69,16450
9/21/2015,19,7301,4001,4769,448,0,70,16589
9/21/2015,20,7298,3809,4569,563,0,72,16311
9/21/2015,21,7288,3037,4173,709,0,70,15277
9/21/2015,22,7277,2809,3410,856,0,68,14420
9/21/2015,23,7284,2688,2979,896,0,60,13907
9/21/2015,24,7284,2106,2501,978,0,53,12922
9/22/2015,1,7285,1636,2966,1009,0,48,12944
9/22/2015,2,7283,1708,3031,839,0,52,12913
9/22/2015,3,7284,1901,2763,683,0,54,12685
9/22/2015,4,7294,2037,2641,506,0,53,12531
9/22/2015,5,7297,2281,2825,383,0,52,12838
9/22/2015,6,7297,3373,3291,321,0,60,14342
9/22/2015,7,7294,3697,3458,243,1,66,14759
9/22/2015,8,7280,3736,3596,195,12,93,14912
9/22/2015,9,7262,3541,3540,239,25,106,14713
9/22/2015,10,7256,3489,3743,207,67,112,14874
9/22/2015,11,7249,3549,3811,170,69,90,14938
9/22/2015,12,7244,3879,3938,158,51,114,15384
9/22/2015,13,7212,3919,4098,152,82,139,15602
9/22/2015,14,7200,4024,4217,179,97,163,15880
9/22/2015,15,7198,4270,4230,182,91,152,16123
9/22/2015,16,7204,4396,4295,162,70,119,16246
9/22/2015,17,7203,4550,4550,111,42,129,16585
9/22/2015,18,7227,4225,4568,51,12,89,16172
9/22/2015,19,7399,4162,4544,33,0,61,16199
9/22/2015,20,7399,4213,4512,49,0,56,16229
9/22/2015,21,7244,3956,4100,55,0,33,15388
9/22/2015,22,7196,3610,3419,70,0,34,14329
9/22/2015,23,7199,2981,3215,95,0,24,13514
9/22/2015,24,7202,2727,2942,81,0,22,12974
9/23/2015,1,7203,2573,2967,67,0,29,12839
9/23/2015,2,7204,2512,2820,66,0,31,12633
9/23/2015,3,7201,2486,3051,67,0,42,12847
9/23/2015,4,7202,2646,3055,91,0,48,13042
9/23/2015,5,7202,2908,3016,70,0,51,13247
9/23/2015,6,7200,3427,3285,74,0,55,14041
9/23/2015,7,7192,4042,3459,74,3,60,14830
9/23/2015,8,7188,3724,3651,60,27,86,14736
9/23/2015,9,7188,3568,3700,34,60,92,14642
9/23/2015,10,7176,3566,4159,16,83,90,15090
9/23/2015,11,7179,3630,4157,32,97,100,15195
9/23/2015,12,7175,3957,3903,86,98,125,15344
9/23/2015,13,7175,4226,3983,90,97,121,15692
9/23/2015,14,7162,4250,4283,134,96,119,16044
9/23/2015,15,7159,4253,4477,157,89,138,16273
9/23/2015,16,7165,4373,4724,192,68,176,16698
9/23/2015,17,7161,4620,4892,163,40,200,17076
9/23/2015,18,7165,4555,4933,124,11,201,16989
9/23/2015,19,7159,4631,4852,120,0,147,16909
9/23/2015,20,7134,4758,4682,166,0,45,16785
9/23/2015,21,7112,4564,4218,214,0,36,16144
9/23/2015,22,7128,4036,3656,273,0,36,15129
9/23/2015,23,7122,3072,3412,347,0,31,13984
9/23/2015,24,7135,2596,3165,391,0,24,13311
9/24/2015,1,7141,1915,3092,347,0,24,12519
9/24/2015,2,7130,1979,3112,352,0,22,12595
9/24/2015,3,7128,2019,3060,362,0,23,12592
9/24/2015,4,7125,1883,3080,432,0,23,12543
9/24/2015,5,7113,2004,3050,548,0,26,12741
9/24/2015,6,7115,2494,3103,696,0,31,13439
9/24/2015,7,7116,3327,3504,773,3,36,14759
9/24/2015,8,7113,3588,3599,740,26,36,15102
9/24/2015,9,7107,3596,4013,473,57,36,15282
9/24/2015,10,7111,3565,4143,467,81,36,15403
9/24/2015,11,7100,3476,4124,540,95,36,15371
9/24/2015,12,7094,3536,3935,553,97,36,15251
9/24/2015,13,7092,3531,4461,478,97,36,15695
9/24/2015,14,7093,3618,4323,472,88,37,15631
9/24/2015,15,7094,3855,4466,467,51,37,15970
9/24/2015,16,7089,4080,4533,548,59,37,16346
9/24/2015,17,7091,4141,4703,703,26,37,16701
9/24/2015,18,7097,3547,4679,769,8,37,16137
9/24/2015,19,7092,3733,4737,880,0,36,16478
9/24/2015,20,7088,3732,4320,1130,0,36,16306
9/24/2015,21,7087,3303,4043,1249,0,36,15718
9/24/2015,22,7092,2842,3459,1275,0,36,14704
9/24/2015,23,7103,2481,3186,1214,0,28,14012
9/24/2015,24,7099,1695,2997,1236,0,24,13051
9/25/2015,1,7093,1412,3122,1383,0,25,13035
9/25/2015,2,7072,1478,3051,1408,0,24,13033
9/25/2015,3,7068,1681,2971,1228,0,25,12973
9/25/2015,4,7073,1878,2830,1119,0,24,12924
9/25/2015,5,7056,2155,3069,1076,0,26,13382
9/25/2015,6,7039,2662,3048,1062,0,30,13841
9/25/2015,7,7032,2805,3261,1138,1,35,14272
9/25/2015,8,6982,2801,3552,873,27,36,14271
9/25/2015,9,6962,2833,3756,692,59,36,14338
9/25/2015,10,6962,2769,3824,670,83,35,14343
9/25/2015,11,6965,3223,3862,539,76,35,14700
9/25/2015,12,6963,3176,3971,553,96,35,14794
9/25/2015,13,6980,3257,4066,528,90,35,14956
9/25/2015,14,7011,3162,4214,460,93,34,14974
9/25/2015,15,7043,3230,4324,487,73,34,15191
9/25/2015,16,7061,3442,4546,560,54,34,15697
9/25/2015,17,7075,3449,4566,613,31,35,15769
9/25/2015,18,7080,3202,4637,681,9,35,15644
9/25/2015,19,7079,2913,4622,843,0,35,15492
9/25/2015,20,7076,2800,4265,1089,0,34,15264
9/25/2015,21,7107,2463,3934,1270,0,34,14808
9/25/2015,22,7216,2366,3416,1384,0,34,14416
9/25/2015,23,7221,2042,3030,1618,0,15,13926
9/25/2015,24,7225,1330,2519,1593,0,10,12677
9/26/2015,1,7227,692,2803,1684,0,3,12409
9/26/2015,2,7228,551,3030,1611,0,3,12423
9/26/2015,3,7225,554,3157,1480,0,3,12419
9/26/2015,4,7230,609,3043,1512,0,3,12397
9/26/2015,5,7230,694,2811,1537,0,3,12275
9/26/2015,6,7227,883,2894,1549,0,3,12556
9/26/2015,7,7225,1025,3093,1617,2,2,12964
9/26/2015,8,7200,1392,3329,1381,15,3,13320
9/26/2015,9,7215,1709,3522,1143,33,3,13625
9/26/2015,10,7217,1714,3373,1068,51,3,13426
9/26/2015,11,7216,1684,3392,994,69,3,13358
9/26/2015,12,7218,1671,3800,938,90,3,13720
9/26/2015,13,7226,1671,3603,988,89,3,13580
9/26/2015,14,7228,1670,3547,1029,85,4,13563
9/26/2015,15,7234,1609,3851,954,74,4,13726
9/26/2015,16,7238,1681,4116,1026,55,4,14120
9/26/2015,17,7245,1916,4321,1100,29,4,14615
9/26/2015,18,7259,1964,4467,1050,5,4,14749
9/26/2015,19,7265,1848,4665,1120,0,4,14902
9/26/2015,20,7260,1770,4401,1410,0,4,14845
9/26/2015,21,7249,1850,4207,1351,0,4,14661
9/26/2015,22,7258,1656,3699,1287,0,4,13904
9/26/2015,23,7259,964,3551,1432,0,4,13210
9/26/2015,24,7270,820,2903,1580,0,4,12577
9/27/2015,1,7274,657,2655,1634,0,4,12224
9/27/2015,2,7276,620,2642,1648,0,4,12190
9/27/2015,3,7463,619,2601,1650,0,4,12337
9/27/2015,4,7425,620,2512,1678,0,4,12239
9/27/2015,5,7349,620,2613,1535,0,4,12121
9/27/2015,6,7458,618,2643,1634,0,5,12358
9/27/2015,7,7458,618,2743,1585,3,7,12414
9/27/2015,8,7439,627,3201,1330,29,16,12642
9/27/2015,9,7514,669,3821,1096,61,13,13174
9/27/2015,10,7600,837,3941,928,86,18,13410
9/27/2015,11,7599,1040,3945,733,91,18,13426
9/27/2015,12,7596,1258,4318,618,46,15,13851
9/27/2015,13,7570,1319,4107,724,67,5,13792
9/27/2015,14,7541,1623,3631,728,76,5,13604
9/27/2015,15,7693,1619,3931,705,38,5,13991
9/27/2015,16,7763,1873,4243,766,29,5,14679
9/27/2015,17,7767,2083,4344,825,31,5,15055
9/27/2015,18,7764,2049,4478,935,7,5,15238
9/27/2015,19,7763,2025,4573,1044,0,4,15409
9/27/2015,20,7760,1920,4397,1156,0,3,15236
9/27/2015,21,7753,1715,3935,1305,0,3,14711
9/27/2015,22,7694,1343,3576,1449,0,3,14065
9/27/2015,23,7746,805,3309,1550,0,16,13426
9/27/2015,24,7772,613,3119,1596,0,19,13119
9/28/2015,1,7769,615,2961,1542,0,18,12905
9/28/2015,2,7777,711,3031,1472,0,25,13016
9/28/2015,3,7769,784,2830,1437,0,26,12846
9/28/2015,4,7775,1020,2636,1363,0,35,12829
9/28/2015,5,7778,1292,2710,1160,0,33,12973
9/28/2015,6,7775,1808,2966,1291,0,41,13881
9/28/2015,7,7770,2879,3539,1146,0,53,15387
9/28/2015,8,7767,3574,3862,922,2,55,16182
9/28/2015,9,7760,4146,3961,851,7,58,16783
9/28/2015,10,7750,4286,3989,829,12,57,16923
9/28/2015,11,7751,4356,4094,785,13,48,17047
9/28/2015,12,7749,4404,3899,644,15,41,16752
9/28/2015,13,7751,4502,3906,565,22,34,16780
9/28/2015,14,7748,4420,3768,575,15,34,16560
9/28/2015,15,7754,4275,3956,612,16,35,16648
9/28/2015,16,7756,4206,4369,615,19,33,16998
9/28/2015,17,7776,4512,4403,617,6,33,17347
9/28/2015,18,7780,4526,4450,589,4,32,17381
9/28/2015,19,7779,4653,4441,524,0,33,17430
9/28/2015,20,7776,4692,3907,597,0,34,17006
9/28/2015,21,7769,4015,3540,726,0,33,16083
9/28/2015,22,7765,3347,3396,849,0,36,15393
9/28/2015,23,7774,2635,3031,859,0,14,14313
9/28/2015,24,7781,1915,2920,920,0,13,13549
9/29/2015,1,7788,1719,2873,1066,0,9,13455
9/29/2015,2,7789,1716,2796,1026,0,10,13337
9/29/2015,3,7790,1722,2876,810,0,3,13201
9/29/2015,4,7792,1952,3006,620,0,3,13373
9/29/2015,5,7791,2439,3100,491,0,7,13828
9/29/2015,6,7794,3181,3333,412,0,2,14722
9/29/2015,7,7799,4492,4017,370,0,7,16685
9/29/2015,8,7797,4830,4184,350,0,3,17164
9/29/2015,9,7680,4910,3820,392,0,0,16802
9/29/2015,10,7664,4580,3747,453,1,0,16445
9/29/2015,11,7640,4594,3760,643,1,0,16638
9/29/2015,12,7697,4369,3750,847,7,0,16670
9/29/2015,13,7788,4415,3686,876,9,0,16774
9/29/2015,14,7788,4145,3778,1344,17,0,17072
9/29/2015,15,7800,4041,3842,1339,14,0,17036
9/29/2015,16,7801,4437,4160,1245,4,0,17647
9/29/2015,17,7782,4040,4103,1622,1,0,17548
9/29/2015,18,7778,3540,4352,1840,0,0,17510
9/29/2015,19,7784,3820,4306,1805,0,0,17715
9/29/2015,20,7785,3737,4133,1866,0,0,17521
9/29/2015,21,7764,3396,3714,1913,0,0,16787
9/29/2015,22,7784,2569,3159,1894,0,0,15406
9/29/2015,23,7796,1692,3316,1863,0,0,14667
9/29/2015,24,7803,1071,2698,1859,0,0,13431
9/30/2015,1,7805,950,2726,1852,0,0,13333
9/30/2015,2,7810,959,2561,1807,0,0,13137
9/30/2015,3,7821,1024,2542,1830,0,0,13217
9/30/2015,4,7831,1262,2435,1821,0,0,13349
9/30/2015,5,7831,1512,2493,1819,0,0,13655
9/30/2015,6,7829,1684,2931,1946,0,0,14390
9/30/2015,7,7832,1985,3443,2027,0,5,15292
9/30/2015,8,7828,2412,3714,1913,0,5,15872
9/30/2015,9,7824,2464,3834,1963,6,0,16091
9/30/2015,10,7791,2544,3781,1917,9,0,16042
9/30/2015,11,7806,2533,4013,1713,14,0,16079
9/30/2015,12,7832,2538,3814,1631,30,0,15845
9/30/2015,13,7701,2628,3717,1580,46,7,15679
9/30/2015,14,7811,2547,3564,1637,78,11,15648
9/30/2015,15,7830,2520,3629,1708,79,7,15773
9/30/2015,16,7831,2568,3918,1854,60,0,16231
9/30/2015,17,7829,2415,4229,1907,35,0,16415
9/30/2015,18,7803,2355,4363,1704,1,0,16226
9/30/2015,19,7794,2769,4557,1550,0,1,16671
9/30/2015,20,7792,2574,4400,1767,0,12,16545
9/30/2015,21,7781,2368,3617,1999,0,10,15775
9/30/2015,22,7776,1999,3048,1887,0,10,14720
9/30/2015,23,7782,1616,2761,1854,0,9,14022
9/30/2015,24,7784,1069,2573,1859,0,8,13293
10/1/2015,1,7786,940,2637,1672,0,9,13044
10/1/2015,2,7789,934,2552,1627,0,8,12910
10/1/2015,3,7787,1001,2457,1655,0,11,12911
10/1/2015,4,7784,1153,2429,1500,0,14,12880
10/1/2015,5,7788,1309,2457,1573,0,14,13141
10/1/2015,6,7790,1449,3011,1584,0,25,13859
10/1/2015,7,7786,1773,3022,1604,0,34,14219
10/1/2015,8,7783,1813,3235,1451,3,33,14318
10/1/2015,9,7786,1796,3201,1245,17,33,14078
10/1/2015,10,7782,1776,3267,1234,51,34,14144
10/1/2015,11,7782,1778,3239,1448,79,35,14361
10/1/2015,12,7781,1744,3431,1450,94,35,14535
10/1/2015,13,7782,1847,3250,1705,93,34,14711
10/1/2015,14,7776,1799,3187,1745,97,44,14648
10/1/2015,15,7778,1865,3138,1541,96,45,14463
10/1/2015,16,7777,1887,3201,1844,74,49,14832
10/1/2015,17,7782,1884,3609,2019,42,37,15373
10/1/2015,18,7813,1951,4259,1814,9,34,15880
10/1/2015,19,7826,2206,4543,1528,0,34,16137
10/1/2015,20,7815,2282,4264,1690,0,34,16085
10/1/2015,21,7659,1998,3752,1930,0,34,15373
10/1/2015,22,7248,1742,3077,2112,0,34,14213
10/1/2015,23,7249,1240,2897,2192,0,22,13600
10/1/2015,24,7252,921,2699,2175,0,17,13064
10/2/2015,1,7248,889,2848,2204,0,16,13205
10/2/2015,2,7245,890,2644,2210,0,19,13008
10/2/2015,3,7232,889,2393,2186,0,23,12723
10/2/2015,4,7232,922,2515,2132,0,24,12825
10/2/2015,5,7229,1048,2529,2116,0,24,12946
10/2/2015,6,7228,1510,3092,2212,0,29,14071
10/2/2015,7,7227,1779,3609,2229,1,36,14881
10/2/2015,8,7032,1807,3898,2140,15,37,14929
10/2/2015,9,6420,1962,4367,2171,23,45,14988
10/2/2015,10,6418,1787,3464,2402,35,48,14154
10/2/2015,11,6417,1631,3315,2611,51,35,14060
10/2/2015,12,6415,1553,2974,2587,51,37,13617
10/2/2015,13,6410,1455,3230,2514,42,41,13692
10/2/2015,14,6414,1699,3169,2506,47,53,13888
10/2/2015,15,6412,2106,3110,2550,54,36,14268
10/2/2015,16,6412,2347,3332,2632,47,37,14807
10/2/2015,17,6414,2346,3654,2594,23,37,15068
10/2/2015,18,6418,2506,4044,2401,3,36,15408
10/2/2015,19,6423,2923,4343,2238,0,36,15963
10/2/2015,20,6419,2661,4099,2348,0,36,15563
10/2/2015,21,6414,2530,3549,2425,0,35,14953
10/2/2015,22,6418,1755,3440,2413,0,36,14062
10/2/2015,23,6419,1500,3028,2541,0,12,13500
10/2/2015,24,6421,1034,2531,2505,0,0,12491
10/3/2015,1,6415,873,2478,2565,0,0,12331
10/3/2015,2,6410,873,2357,2431,0,0,12071
10/3/2015,3,6396,887,2324,2465,0,0,12072
10/3/2015,4,6362,898,2278,2431,0,0,11969
10/3/2015,5,6364,964,2299,2559,0,0,12186
10/3/2015,6,6359,1147,2455,2448,0,0,12409
10/3/2015,7,6328,1356,2803,2624,1,0,13112
10/3/2015,8,6307,1645,3096,2684,8,0,13740
10/3/2015,9,6300,1760,3354,2770,23,0,14207
10/3/2015,10,6302,1737,3478,2872,19,0,14408
10/3/2015,11,6303,1727,3522,2907,26,0,14485
10/3/2015,12,6302,1729,3298,2910,21,0,14260
10/3/2015,13,6305,1839,3200,2852,19,0,14215
10/3/2015,14,6305,2130,3044,2760,14,0,14253
10/3/2015,15,6304,2409,3164,2681,10,0,14568
10/3/2015,16,6302,2632,3232,2681,8,0,14855
10/3/2015,17,6313,2674,3584,2602,3,0,15176
10/3/2015,18,6323,2658,3816,2527,1,0,15325
10/3/2015,19,6324,2594,3801,2462,0,0,15181
10/3/2015,20,6326,2445,3710,2405,0,0,14886
10/3/2015,21,6324,2480,3342,2393,0,0,14539
10/3/2015,22,6315,2040,3113,2212,0,0,13680
10/3/2015,23,6317,1886,2999,1871,0,0,13073
10/3/2015,24,6316,1560,3249,1794,0,0,12919
10/4/2015,1,6275,1310,2951,1648,0,0,12184
10/4/2015,2,6278,1256,2969,1462,0,0,11965
10/4/2015,3,6279,1276,3089,1265,0,0,11909
10/4/2015,4,6281,1413,3106,951,0,0,11751
10/4/2015,5,6288,1700,2674,899,0,0,11561
10/4/2015,6,6295,1836,2755,888,0,0,11774
10/4/2015,7,6299,1805,2963,903,1,0,11971
10/4/2015,8,6300,2442,3093,801,17,1,12654
10/4/2015,9,6296,2696,3730,656,44,1,13423
10/4/2015,10,6282,3043,3480,513,61,1,13380
10/4/2015,11,6305,3060,3248,426,59,1,13099
10/4/2015,12,6341,3264,3063,359,46,0,13073
10/4/2015,13,6340,3200,3114,305,40,0,12999
10/4/2015,14,6348,3369,3138,280,42,0,13177
10/4/2015,15,6366,3528,3268,365,32,0,13559
10/4/2015,16,6368,4005,3349,326,37,0,14085
10/4/2015,17,6364,4398,3655,311,17,0,14745
10/4/2015,18,6365,4120,4355,338,2,0,15180
10/4/2015,19,6367,4559,4556,324,0,0,15806
10/4/2015,20,6364,4635,4318,333,0,0,15650
10/4/2015,21,6366,4354,3810,377,0,0,14907
10/4/2015,22,6362,3699,3593,437,0,0,14091
10/4/2015,23,6365,3142,3269,381,0,0,13157
10/4/2015,24,6373,2859,2845,244,0,0,12321
10/5/2015,1,6378,2267,3040,181,0,8,11874
10/5/2015,2,6403,2284,2673,159,0,12,11531
10/5/2015,3,6412,2073,2716,165,0,18,11384
10/5/2015,4,6424,2478,2637,130,0,22,11691
10/5/2015,5,6458,3249,2496,113,0,35,12351
10/5/2015,6,6476,3787,3122,162,0,42,13589
10/5/2015,7,6477,4605,3464,167,1,51,14765
10/5/2015,8,6477,4483,3829,85,10,55,14939
10/5/2015,9,6473,4901,3987,45,23,48,15477
10/5/2015,10,6470,5057,4005,28,16,54,15630
10/5/2015,11,6466,5172,3513,15,26,55,15247
10/5/2015,12,6469,4943,3619,9,50,55,15145
10/5/2015,13,6460,5061,3552,21,52,51,15197
10/5/2015,14,6459,4982,3791,50,59,23,15364
10/5/2015,15,6458,4765,4068,52,28,25,15396
10/5/2015,16,6462,4764,4131,82,16,35,15490
10/5/2015,17,6460,4808,4471,92,18,34,15883
10/5/2015,18,6458,4698,4923,89,1,33,16202
10/5/2015,19,6459,4886,5327,76,0,34,16782
10/5/2015,20,6455,4534,5186,111,0,34,16320
10/5/2015,21,6452,4097,4625,227,0,33,15434
10/5/2015,22,6457,4015,3618,230,0,34,14354
10/5/2015,23,6455,3560,3404,177,0,20,13616
10/5/2015,24,6466,2993,3272,160,0,17,12908
10/6/2015,1,6467,2676,2956,136,0,17,12252
10/6/2015,2,6469,2601,2805,86,0,17,11978
10/6/2015,3,6475,2603,2910,66,0,17,12071
10/6/2015,4,6476,2814,3159,69,0,18,12536
10/6/2015,5,6473,3098,3082,92,0,22,12767
10/6/2015,6,6472,3889,3294,106,0,30,13791
10/6/2015,7,6474,4399,3760,82,0,33,14748
10/6/2015,8,6472,4559,3846,59,2,33,14971
10/6/2015,9,6453,4673,3941,31,8,33,15139
10/6/2015,10,6455,4493,3984,30,16,33,15011
10/6/2015,11,6470,4643,3991,46,23,34,15207
10/6/2015,12,6512,4521,4246,51,22,34,15386
10/6/2015,13,6682,4330,4168,94,11,34,15319
10/6/2015,14,6673,4314,4235,84,13,34,15353
10/6/2015,15,6674,4317,4163,129,18,34,15335
10/6/2015,16,6881,4334,4332,118,13,34,15712
10/6/2015,17,7062,4170,4472,103,7,34,15848
10/6/2015,18,7361,3953,4672,106,1,34,16127
10/6/2015,19,7359,4042,4912,134,0,34,16481
10/6/2015,20,7357,3859,4570,161,0,34,15981
10/6/2015,21,7366,3628,3954,190,0,34,15172
10/6/2015,22,7515,3440,3506,192,0,34,14687
10/6/2015,23,7515,3012,3122,217,0,38,13904
10/6/2015,24,7516,2798,2944,222,0,22,13502
10/7/2015,1,7514,1898,3005,223,0,19,12659
10/7/2015,2,7618,1707,2954,286,0,19,12584
10/7/2015,3,7724,1724,2571,322,0,20,12361
10/7/2015,4,7783,1843,2514,263,0,23,12426
10/7/2015,5,7820,2135,2639,328,0,57,12979
10/7/2015,6,7842,2760,3225,361,0,70,14258
10/7/2015,7,7845,3209,3520,372,1,75,15022
10/7/2015,8,7850,3130,3722,373,8,76,15159
10/7/2015,9,7838,2987,4013,245,21,73,15177
10/7/2015,10,7836,3051,3855,229,48,73,15092
10/7/2015,11,7840,2988,3867,294,64,74,15127
10/7/2015,12,7841,2999,3886,447,81,68,15322
10/7/2015,13,7843,2816,3794,608,96,74,15231
10/7/2015,14,7844,2776,3872,799,66,74,15431
10/7/2015,15,7840,2702,3523,1034,46,75,15220
10/7/2015,16,7842,2704,3480,1085,18,77,15206
10/7/2015,17,7847,2706,3927,962,18,77,15537
10/7/2015,18,7852,2721,4387,807,4,76,15847
10/7/2015,19,7852,3219,4606,704,0,76,16457
10/7/2015,20,7855,3060,4296,730,0,72,16013
10/7/2015,21,7844,2818,4002,714,0,64,15442
10/7/2015,22,7850,2402,3533,630,0,54,14469
10/7/2015,23,7845,2177,3249,528,0,37,13836
10/7/2015,24,7854,1452,3146,484,0,41,12977
10/8/2015,1,7860,1140,3283,463,0,36,12782
10/8/2015,2,7859,1109,2763,482,0,37,12250
10/8/2015,3,7859,1127,2606,450,0,33,12075
10/8/2015,4,7857,1270,2550,431,0,19,12127
10/8/2015,5,7855,1705,2712,426,0,23,12721
10/8/2015,6,7863,2294,3254,510,0,32,13953
10/8/2015,7,7860,2425,3849,655,1,32,14822
10/8/2015,8,7850,2296,3737,850,28,32,14793
10/8/2015,9,7851,2274,3769,559,59,33,14545
10/8/2015,10,7852,2275,3771,448,82,34,14462
10/8/2015,11,7854,2296,3879,420,50,33,14532
10/8/2015,12,7840,2410,3952,347,57,32,14638
10/8/2015,13,7839,2839,3834,365,85,34,14996
10/8/2015,14,7893,2684,4020,347,74,33,15051
10/8/2015,15,7897,2861,4031,428,45,34,15296
10/8/2015,16,7895,2887,4224,505,37,34,15582
10/8/2015,17,7895,3005,4213,658,12,34,15817
10/8/2015,18,7887,3027,4467,1011,2,34,16428
10/8/2015,19,7888,3032,4547,1228,0,34,16729
10/8/2015,20,7884,2456,4535,1368,0,34,16277
10/8/2015,21,7880,2441,3862,1312,0,34,15529
10/8/2015,22,7878,2490,3106,1529,0,34,15037
10/8/2015,23,7880,1160,3045,1624,0,23,13732
10/8/2015,24,7881,907,3022,1517,0,18,13345
10/9/2015,1,7877,915,2951,1158,0,18,12919
10/9/2015,2,7890,919,2908,839,0,18,12574
10/9/2015,3,7874,992,3039,888,0,18,12811
10/9/2015,4,7860,1252,2724,1131,0,18,12985
10/9/2015,5,7873,1587,2587,1165,0,23,13235
10/9/2015,6,7881,2040,2835,1220,0,28,14004
10/9/2015,7,7877,2318,3327,1325,0,33,14880
10/9/2015,8,7877,2424,3611,1351,5,33,15301
10/9/2015,9,7877,2347,3906,1572,17,34,15753
10/9/2015,10,7880,2541,3909,1788,21,34,16173
10/9/2015,11,7900,2560,3839,1817,31,41,16188
10/9/2015,12,7907,2565,3684,2026,38,46,16266
10/9/2015,13,7909,2316,3533,2018,37,45,15858
10/9/2015,14,7926,2286,3291,1961,38,43,15545
10/9/2015,15,7936,2282,3438,2000,38,43,15737
10/9/2015,16,7939,2281,3444,2032,11,35,15742
10/9/2015,17,8018,2286,3443,2043,4,33,15827
10/9/2015,18,8028,2290,3959,1923,0,33,16233
10/9/2015,19,8034,2708,4644,1337,0,33,16756
10/9/2015,20,8028,2797,4473,934,0,33,16265
10/9/2015,21,8013,2688,4139,676,0,33,15549
10/9/2015,22,8017,2330,3613,494,0,33,14487
10/9/2015,23,8032,1618,3445,442,0,21,13558
10/9/2015,24,8050,968,3471,344,0,14,12847
10/10/2015,1,8060,849,3430,320,0,1,12660
10/10/2015,2,8054,829,3070,391,0,2,12346
10/10/2015,3,8058,818,3036,376,0,2,12290
10/10/2015,4,8060,829,2847,352,0,3,12091
10/10/2015,5,8064,964,3154,307,0,3,12492
10/10/2015,6,8070,1273,2888,271,0,3,12505
10/10/2015,7,8078,1547,3347,303,41,2,13318
10/10/2015,8,8076,1599,3428,287,43,2,13435
10/10/2015,9,8082,1578,3405,220,47,4,13336
10/10/2015,10,8085,1571,3307,237,84,4,13288
10/10/2015,11,8084,1541,3303,362,82,4,13376
10/10/2015,12,8084,1545,3366,363,59,5,13422
10/10/2015,13,8042,1342,3523,470,68,27,13472
10/10/2015,14,8069,1315,3515,539,72,40,13550
10/10/2015,15,8070,1350,3173,735,79,34,13441
10/10/2015,16,8068,1356,3197,836,62,29,13548
10/10/2015,17,8070,1358,3636,920,31,32,14047
10/10/2015,18,8074,1477,4135,933,4,33,14656
10/10/2015,19,8066,1652,4176,1156,0,31,15081
10/10/2015,20,8064,1388,3803,1499,0,29,14783
10/10/2015,21,8048,1203,3141,1829,0,28,14249
10/10/2015,22,8048,847,2674,2011,0,24,13604
10/10/2015,23,8054,796,2531,2011,0,23,13415
10/10/2015,24,8058,783,2509,1756,0,22,13128
10/11/2015,1,8061,795,2446,1596,0,24,12922
10/11/2015,2,8051,796,2333,1400,0,27,12607
10/11/2015,3,7666,796,2331,1387,0,19,12199
10/11/2015,4,7265,795,2338,1456,0,8,11862
10/11/2015,5,7235,794,2436,1459,0,5,11929
10/11/2015,6,7237,789,2484,1942,0,5,12457
10/11/2015,7,7239,789,2552,2193,1,5,12779
10/11/2015,8,7312,789,2746,2346,26,5,13224
10/11/2015,9,7790,788,2872,2253,41,5,13749
10/11/2015,10,8073,784,2911,1870,83,6,13727
10/11/2015,11,8071,780,2845,2184,92,6,13978
10/11/2015,12,8071,776,2842,1979,97,6,13771
10/11/2015,13,8067,775,2734,2152,97,6,13831
10/11/2015,14,8071,771,2797,1998,97,6,13740
10/11/2015,15,8071,767,2905,1938,88,5,13774
10/11/2015,16,8078,772,3148,1950,64,5,14017
10/11/2015,17,8078,775,3159,2094,32,4,14142
10/11/2015,18,8080,778,3387,2172,4,5,14426
10/11/2015,19,8067,778,3511,2403,0,5,14764
10/11/2015,20,8060,778,3578,2499,0,5,14920
10/11/2015,21,8075,779,3274,2276,0,5,14409
10/11/2015,22,8079,778,3008,2097,0,5,13967
10/11/2015,23,8083,776,2591,1828,0,5,13283
10/11/2015,24,8084,780,2568,1761,0,5,13198
10/12/2015,1,7689,781,2662,1532,0,5,12669
10/12/2015,2,7551,790,2535,1673,0,5,12554
10/12/2015,3,7549,810,2541,1439,0,5,12344
10/12/2015,4,7307,814,2527,1366,0,5,12019
10/12/2015,5,7251,815,2610,1460,0,4,12140
10/12/2015,6,7264,817,2634,1858,0,4,12577
10/12/2015,7,7269,828,2690,1963,1,4,12755
10/12/2015,8,7640,857,2871,1888,24,4,13284
10/12/2015,9,8056,869,2913,1565,57,4,13464
10/12/2015,10,8095,864,2915,1868,83,4,13829
10/12/2015,11,8092,859,2976,2119,97,5,14148
10/12/2015,12,8088,859,2965,1914,98,4,13928
10/12/2015,13,8091,853,2925,1786,97,4,13756
10/12/2015,14,8093,855,3040,1828,97,4,13917
10/12/2015,15,8092,858,3044,2058,42,4,14098
10/12/2015,16,8090,858,3325,2161,31,4,14469
10/12/2015,17,8085,864,3751,2149,10,4,14863
10/12/2015,18,8084,893,4277,2120,3,3,15380
10/12/2015,19,8080,948,4350,2212,0,3,15593
10/12/2015,20,8078,887,4110,2209,0,3,15287
10/12/2015,21,8069,872,3602,1956,0,3,14502
10/12/2015,22,8069,873,3412,1801,0,15,14170
10/12/2015,23,8071,874,2708,1857,0,17,13527
10/12/2015,24,8079,879,2605,1838,0,17,13418
10/13/2015,1,8076,880,2533,1673,0,16,13178
10/13/2015,2,7929,908,2513,1446,0,16,12812
10/13/2015,3,7775,913,2515,1520,0,15,12738
10/13/2015,4,7782,949,2539,1330,0,20,12620
10/13/2015,5,7792,992,2862,1727,0,22,13395
10/13/2015,6,8060,1116,3031,1938,1,27,14173
10/13/2015,7,8077,1287,3498,2073,1,33,14969
10/13/2015,8,8075,1446,3752,2142,2,34,15451
10/13/2015,9,8067,1592,3880,2096,14,36,15685
10/13/2015,10,8063,1566,3566,2320,36,57,15608
10/13/2015,11,8062,1447,3186,2538,68,59,15360
10/13/2015,12,8066,1448,3138,2484,74,61,15271
10/13/2015,13,8069,1448,3281,2547,23,63,15431
10/13/2015,14,8075,1456,3121,2682,24,52,15410
10/13/2015,15,8076,1494,3078,2802,16,37,15503
10/13/2015,16,8079,1649,3308,2775,10,42,15863
10/13/2015,17,8079,1648,3683,2625,1,40,16076
10/13/2015,18,8083,1647,4328,2533,1,37,16629
10/13/2015,19,8086,1650,4625,2566,0,29,16956
10/13/2015,20,8089,1655,4347,2464,0,27,16582
10/13/2015,21,8090,1653,3747,2455,0,31,15976
10/13/2015,22,8092,1155,3290,2224,0,31,14792
10/13/2015,23,8092,970,3141,2104,0,21,14328
10/13/2015,24,8101,974,2682,1798,0,17,13572
10/14/2015,1,8106,952,2653,1656,0,17,13384
10/14/2015,2,8112,1047,2620,1334,0,17,13130
10/14/2015,3,8116,1101,2592,1242,0,17,13068
10/14/2015,4,8118,1225,2586,965,0,18,12912
10/14/2015,5,8115,1306,2846,863,0,19,13149
10/14/2015,6,8119,1654,3123,986,0,26,13908
10/14/2015,7,8121,2280,3786,948,1,30,15166
10/14/2015,8,8126,2550,3837,768,9,30,15320
10/14/2015,9,8127,2444,3825,861,38,32,15327
10/14/2015,10,8124,2582,3166,853,37,33,14795
10/14/2015,11,8125,2720,3220,996,29,49,15139
10/14/2015,12,8126,2749,3041,1236,20,50,15222
10/14/2015,13,7985,2869,2964,1267,33,53,15171
10/14/2015,14,7965,2896,3076,1170,36,49,15192
10/14/2015,15,7970,2901,3113,1098,25,45,15152
10/14/2015,16,7966,2903,3733,891,29,31,15553
10/14/2015,17,7969,2906,4139,878,5,30,15927
10/14/2015,18,8106,2951,4636,609,1,30,16333
10/14/2015,19,8127,3940,4682,422,0,30,17201
10/14/2015,20,8124,3681,4713,428,0,30,16976
10/14/2015,21,8106,3130,4156,484,0,30,15906
10/14/2015,22,8099,2644,3741,528,0,31,15043
10/14/2015,23,8108,1915,3331,741,0,24,14119
10/14/2015,24,8112,1038,2869,934,0,19,12972
10/15/2015,1,8112,899,2632,1087,0,17,12747
10/15/2015,2,8116,891,2639,1041,0,16,12703
10/15/2015,3,8121,901,2615,1212,0,16,12865
10/15/2015,4,8119,991,2472,1357,0,16,12955
10/15/2015,5,8116,1202,2733,1630,0,18,13699
10/15/2015,6,8120,1588,3224,1592,0,23,14547
10/15/2015,7,8120,2060,3788,1623,1,30,15622
10/15/2015,8,8117,2302,3713,1535,16,30,15713
10/15/2015,9,8117,2158,3564,1293,28,31,15191
10/15/2015,10,8117,1844,3524,1387,80,31,14983
10/15/2015,11,8118,1680,3363,1824,87,47,15119
10/15/2015,12,8119,1635,2939,2258,96,55,15102
10/15/2015,13,8117,1638,2982,2262,97,54,15150
10/15/2015,14,8123,1651,2896,2511,92,53,15326
10/15/2015,15,8123,1358,3014,2714,43,55,15307
10/15/2015,16,8113,1100,3681,2705,16,36,15651
10/15/2015,17,8117,1318,3934,2692,5,50,16116
10/15/2015,18,8115,1369,4241,2506,0,50,16281
10/15/2015,19,8119,1678,4719,2087,0,50,16653
10/15/2015,20,8118,1407,4382,2036,0,47,15990
10/15/2015,21,8109,1244,4140,2033,0,48,15574
10/15/2015,22,8110,1244,3680,1540,0,46,14620
10/15/2015,23,8113,1226,3299,1367,0,26,14031
10/15/2015,24,8115,1231,3132,1178,0,17,13673
10/16/2015,1,8118,979,2740,1497,0,15,13349
10/16/2015,2,8112,905,2504,1361,0,14,12896
10/16/2015,3,8116,904,2607,1505,0,14,13146
10/16/2015,4,8115,992,2619,1288,0,14,13028
10/16/2015,5,8118,1016,3043,1468,0,19,13664
10/16/2015,6,8128,1202,3605,1516,0,26,14477
10/16/2015,7,8127,1563,3953,1437,1,33,15114
10/16/2015,8,8129,1814,4006,1249,20,48,15266
10/16/2015,9,8132,1694,3969,999,57,51,14902
10/16/2015,10,8132,1608,4194,1034,63,45,15076
10/16/2015,11,8132,1584,3769,1365,85,38,14973
10/16/2015,12,8128,1695,3263,1858,56,34,15034
10/16/2015,13,8128,1730,3068,2095,37,31,15089
10/16/2015,14,8130,1729,2880,2016,36,30,14821
10/16/2015,15,8130,1711,2967,2254,22,30,15114
10/16/2015,16,8125,1403,3259,2253,11,30,15081
10/16/2015,17,8130,1432,3647,2279,10,30,15528
10/16/2015,18,8127,1820,4082,1820,0,30,15879
10/16/2015,19,8125,2036,4468,1918,0,29,16576
10/16/2015,20,8127,1841,4342,1874,0,29,16213
10/16/2015,21,8115,1794,4049,1785,0,29,15772
10/16/2015,22,8116,1269,3275,1966,0,29,14655
10/16/2015,23,8115,1050,3310,1727,0,14,14216
10/16/2015,24,8123,955,3266,1454,0,0,13798
10/17/2015,1,8117,929,3047,1261,0,0,13354
10/17/2015,2,8123,987,2897,1146,0,0,13153
10/17/2015,3,8116,1054,2910,957,0,0,13037
10/17/2015,4,8126,1387,2542,882,0,0,12937
10/17/2015,5,8126,1792,2625,805,0,0,13348
10/17/2015,6,8130,1998,2756,757,0,0,13641
10/17/2015,7,8130,2281,3297,666,1,0,14375
10/17/2015,8,8123,2759,3608,607,26,0,15123
10/17/2015,9,8118,2951,3745,592,61,0,15467
10/17/2015,10,8125,2739,3692,793,88,0,15437
10/17/2015,11,8123,2536,3611,872,79,0,15221
10/17/2015,12,8127,2508,3540,951,67,0,15193
10/17/2015,13,8127,2545,3443,934,43,0,15092
10/17/2015,14,8129,2685,3062,945,33,0,14854
10/17/2015,15,8129,2735,2947,871,25,0,14707
10/17/2015,16,8127,2849,3498,832,15,0,15321
10/17/2015,17,8131,3229,3840,660,4,0,15864
10/17/2015,18,8130,3588,4440,469,0,0,16627
10/17/2015,19,8120,3725,4611,562,0,0,17018
10/17/2015,20,8123,3514,4365,471,0,0,16473
10/17/2015,21,8116,3405,3910,432,0,0,15863
10/17/2015,22,8125,2983,3618,374,0,0,15100
10/17/2015,23,8124,2415,3336,378,0,0,14253
10/17/2015,24,8129,2210,3165,367,0,0,13871
10/18/2015,1,8121,1316,3335,422,0,0,13194
10/18/2015,2,8128,1088,3344,415,0,0,12975
10/18/2015,3,8131,1017,2993,522,0,0,12663
10/18/2015,4,8113,953,2989,670,0,0,12725
10/18/2015,5,8114,961,2947,613,0,0,12635
10/18/2015,6,8116,1005,3058,649,0,0,12828
10/18/2015,7,8117,1272,3285,650,0,0,13324
10/18/2015,8,8120,1478,2950,658,17,0,13223
10/18/2015,9,8119,1707,3366,835,35,0,14062
10/18/2015,10,8122,1660,3360,1021,66,0,14229
10/18/2015,11,8116,1939,3450,949,85,0,14539
10/18/2015,12,8125,2208,3594,1084,52,0,15063
10/18/2015,13,8123,2349,3604,1056,35,0,15167
10/18/2015,14,8069,2460,3571,981,55,0,15136
10/18/2015,15,8090,2838,3553,868,35,0,15384
10/18/2015,16,8079,2860,3853,590,63,0,15445
10/18/2015,17,8077,3560,3990,382,22,0,16031
10/18/2015,18,8085,3865,4382,238,1,0,16571
10/18/2015,19,8088,4620,4546,259,0,0,17513
10/18/2015,20,8081,4383,4343,348,0,0,17155
10/18/2015,21,8082,4129,3931,329,0,0,16471
10/18/2015,22,8078,3566,3692,372,0,0,15708
10/18/2015,23,8070,2636,3382,496,0,0,14584
10/18/2015,24,8079,2013,3464,596,0,0,14152
10/19/2015,1,8077,1847,3210,846,0,0,13980
10/19/2015,2,8071,1639,2865,1145,0,0,13720
10/19/2015,3,8085,1530,2467,1357,0,10,13449
10/19/2015,4,8086,1697,2497,1558,0,9,13847
10/19/2015,5,8130,2087,2613,1791,0,12,14633
10/19/2015,6,8140,2498,3391,2103,0,21,16153
10/19/2015,7,8140,3002,4224,2324,0,26,17716
10/19/2015,8,8139,3128,4158,2341,5,26,17797
10/19/2015,9,8137,2661,4138,2368,44,29,17377
10/19/2015,10,8130,2268,3702,2480,85,30,16695
10/19/2015,11,8136,1989,3289,2690,98,30,16232
10/19/2015,12,8133,1718,3224,2923,96,30,16124
10/19/2015,13,8132,1597,3143,2942,77,30,15921
10/19/2015,14,8130,1533,3273,2966,94,30,16026
10/19/2015,15,8135,1590,3274,2979,79,31,16088
10/19/2015,16,8087,1873,3251,2982,45,31,16269
10/19/2015,17,8082,2004,3809,2964,9,31,16899
10/19/2015,18,8082,1886,4211,2963,1,30,17173
10/19/2015,19,8083,2038,4619,2969,0,30,17739
10/19/2015,20,8071,1574,4291,3011,0,30,16977
10/19/2015,21,8073,1482,3696,2997,0,30,16278
10/19/2015,22,8062,1144,3331,2956,0,30,15523
10/19/2015,23,8071,1071,2939,2922,0,22,15025
10/19/2015,24,8076,1071,2600,2812,0,18,14577
10/20/2015,1,8074,929,2453,2753,0,17,14226
10/20/2015,2,8074,876,2392,2690,0,15,14047
10/20/2015,3,8076,878,2497,2481,0,14,13946
10/20/2015,4,8075,955,2422,2382,0,14,13848
10/20/2015,5,8077,1156,2558,2403,0,18,14212
10/20/2015,6,8077,1413,3035,2298,0,29,14852
10/20/2015,7,8078,1630,3572,2579,0,30,15889
10/20/2015,8,8081,1596,3782,2452,3,30,15944
10/20/2015,9,8080,1548,3683,2289,11,31,15642
10/20/2015,10,8080,1757,3410,2216,25,30,15518
10/20/2015,11,8085,2084,3140,2011,63,30,15413
10/20/2015,12,8083,2290,3507,1685,32,30,15627
10/20/2015,13,8053,2548,3626,1628,34,30,15919
10/20/2015,14,8046,2567,3907,1573,35,30,16158
10/20/2015,15,8047,2573,4056,1456,7,31,16170
10/20/2015,16,8044,2708,4335,1167,3,31,16288
10/20/2015,17,8040,3147,4715,938,0,31,16871
10/20/2015,18,8041,3360,4864,847,0,30,17142
10/20/2015,19,8040,3396,4769,748,0,31,16984
10/20/2015,20,8025,3127,4690,799,0,30,16671
10/20/2015,21,8034,3000,4046,803,0,31,15914
10/20/2015,22,8022,2897,3339,780,0,30,15068
10/20/2015,23,8027,2407,3268,867,0,22,14591
10/20/2015,24,8033,1743,3120,853,0,15,13764
10/21/2015,1,8025,1628,2968,830,0,13,13464
10/21/2015,2,8019,1451,3076,808,0,13,13367
10/21/2015,3,8026,1509,3134,759,0,13,13441
10/21/2015,4,8019,1668,3227,732,0,13,13659
10/21/2015,5,8014,2040,3433,697,0,18,14202
10/21/2015,6,8016,2483,3811,651,0,24,14985
10/21/2015,7,8015,3199,4363,554,0,29,16160
10/21/2015,8,8001,3301,4121,644,3,30,16100
10/21/2015,9,8000,3178,3686,699,33,30,15626
10/21/2015,10,7993,3118,3778,769,59,30,15747
10/21/2015,11,7516,3146,3922,751,44,30,15409
10/21/2015,12,7176,3560,4077,801,25,30,15669
10/21/2015,13,7172,3440,3540,944,34,30,15160
10/21/2015,14,7156,3183,3415,1147,26,27,14954
10/21/2015,15,7152,3119,3803,1338,14,24,15450
10/21/2015,16,7157,3086,3803,1457,5,25,15533
10/21/2015,17,7156,3244,3982,1679,2,29,16092
10/21/2015,18,7156,3217,4043,2119,0,33,16568
10/21/2015,19,7153,2997,4477,2415,0,34,17076
10/21/2015,20,7136,2695,4101,2671,0,34,16637
10/21/2015,21,7124,2378,3558,2854,0,34,15948
10/21/2015,22,7127,1848,2821,2813,0,34,14643
10/21/2015,23,7120,1198,2881,2933,0,26,14158
10/21/2015,24,7120,960,2902,2989,0,21,13992
10/22/2015,1,7124,864,2716,3013,0,17,13734
10/22/2015,2,7115,877,2495,2988,0,17,13492
10/22/2015,3,7112,946,2471,2819,0,17,13365
10/22/2015,4,7114,1226,2620,2575,0,17,13552
10/22/2015,5,7110,1576,2819,2204,0,20,13729
10/22/2015,6,7110,2052,3635,1851,0,28,14676
10/22/2015,7,7109,2994,4035,1596,0,33,15767
10/22/2015,8,7102,3415,4207,1283,1,33,16041
10/22/2015,9,7098,3446,4178,1045,14,33,15814
10/22/2015,10,7095,3217,3820,1008,45,33,15218
10/22/2015,11,7094,2982,3711,1044,73,33,14937
10/22/2015,12,7080,2616,3571,1141,62,33,14503
10/22/2015,13,7077,3071,3548,1126,63,33,14918
10/22/2015,14,7078,3669,3378,1062,66,34,15287
10/22/2015,15,7079,3401,3769,1063,80,33,15425
10/22/2015,16,7083,3693,3939,1005,56,33,15809
10/22/2015,17,7092,3788,4095,1001,24,33,16033
10/22/2015,18,7097,4063,4542,954,1,33,16690
10/22/2015,19,7091,4339,4789,918,0,33,17170
10/22/2015,20,7085,4296,4325,1000,0,33,16739
10/22/2015,21,7081,3620,4120,921,0,33,15775
10/22/2015,22,7085,3513,3385,855,0,33,14871
10/22/2015,23,7088,3128,3156,1060,0,23,14455
10/22/2015,24,7096,2624,2677,1004,0,19,13420
10/23/2015,1,7093,2506,3034,947,0,17,13597
10/23/2015,2,7079,2554,3026,932,0,17,13608
10/23/2015,3,7078,2547,2840,957,0,17,13439
10/23/2015,4,7070,2670,3112,872,0,18,13742
10/23/2015,5,7064,2949,3133,814,0,21,13981
10/23/2015,6,7063,3538,3394,708,0,27,14730
10/23/2015,7,7062,4135,3698,580,1,32,15508
10/23/2015,8,7066,4163,3532,566,22,32,15381
10/23/2015,9,7033,3873,3563,442,58,32,15001
10/23/2015,10,6991,3837,3291,331,85,32,14567
10/23/2015,11,6991,3597,3445,394,98,32,14557
10/23/2015,12,7043,3449,3478,313,98,33,14414
10/23/2015,13,7339,3425,3346,315,98,33,14556
10/23/2015,14,7399,3197,3436,419,97,33,14581
10/23/2015,15,7404,3098,3501,455,85,33,14576
10/23/2015,16,7639,3289,3767,603,60,33,15391
10/23/2015,17,7833,3230,4275,823,13,33,16207
10/23/2015,18,7845,3451,4550,953,0,33,16832
10/23/2015,19,7850,3385,4521,1288,0,33,17077
10/23/2015,20,7844,2808,4031,1498,0,33,16214
10/23/2015,21,7833,2068,3826,1694,0,33,15454
10/23/2015,22,7810,1569,3238,2066,0,33,14716
10/23/2015,23,7810,1005,3090,2260,0,25,14190
10/23/2015,24,7816,933,3187,2050,0,7,13993
10/24/2015,1,7809,916,2751,2018,0,3,13497
10/24/2015,2,7825,915,2859,1718,0,3,13320
10/24/2015,3,7839,906,2821,1638,0,3,13207
10/24/2015,4,7844,860,2930,1561,0,4,13199
10/24/2015,5,7944,924,2942,1481,0,4,13295
10/24/2015,6,7973,946,3005,1350,0,4,13278
10/24/2015,7,7974,1082,3077,1462,0,4,13599
10/24/2015,8,7977,1271,2919,1806,0,4,13977
10/24/2015,9,7981,1265,3769,2009,1,5,15030
10/24/2015,10,7982,1201,4013,2237,7,5,15445
10/24/2015,11,7986,1161,3941,2493,8,5,15594
10/24/2015,12,8001,1149,3622,2557,9,5,15343
10/24/2015,13,8021,1166,3656,2528,7,4,15382
10/24/2015,14,8029,1166,3413,2608,4,4,15224
10/24/2015,15,8036,1156,3141,2559,6,4,14902
10/24/2015,16,8031,1193,3269,2807,5,5,15310
10/24/2015,17,8030,912,3625,3055,1,6,15629
10/24/2015,18,8032,827,4103,3123,0,5,16090
10/24/2015,19,8031,871,3864,3088,0,6,15860
10/24/2015,20,8028,899,4137,2859,0,5,15928
10/24/2015,21,8024,979,3677,2610,0,5,15295
10/24/2015,22,8027,1000,3408,2636,0,5,15076
10/24/2015,23,8019,955,2694,2625,0,5,14298
10/24/2015,24,8012,805,2498,2293,0,5,13613
10/25/2015,1,7999,800,2490,1912,0,5,13206
10/25/2015,2,8003,807,2372,1860,0,5,13047
10/25/2015,3,7989,812,2429,1628,0,5,12863
10/25/2015,4,7778,836,2491,1620,0,4,12729
10/25/2015,5,7780,842,2546,1530,0,4,12702
10/25/2015,6,7784,826,2608,2056,0,5,13279
10/25/2015,7,7834,833,3226,1853,1,5,13752
10/25/2015,8,8009,881,3013,1890,7,4,13804
10/25/2015,9,8007,933,3517,1509,27,4,13997
10/25/2015,10,8013,965,3509,1326,25,4,13842
10/25/2015,11,8033,932,3470,1026,36,5,13502
10/25/2015,12,8031,1166,3549,821,60,5,13632
10/25/2015,13,7978,1182,3391,707,71,5,13334
10/25/2015,14,8024,1334,3106,757,80,5,13306
10/25/2015,15,8027,1507,3208,712,56,5,13515
10/25/2015,16,8028,1723,3521,700,41,5,14018
10/25/2015,17,8031,1895,4432,486,15,5,14864
10/25/2015,18,8030,2194,4858,342,1,4,15429
10/25/2015,19,8028,2428,5071,381,0,4,15912
10/25/2015,20,8015,2173,4862,359,0,4,15413
10/25/2015,21,8024,1993,4317,434,0,3,14771
10/25/2015,22,8024,1720,3534,486,0,3,13767
10/25/2015,23,8031,1450,3139,454,0,3,13077
10/25/2015,24,8037,1123,3183,344,0,10,12697
10/26/2015,1,8034,1104,3040,230,0,17,12425
10/26/2015,2,8039,1257,3142,162,0,18,12618
10/26/2015,3,8037,1502,3140,208,0,18,12905
10/26/2015,4,8039,1779,3091,248,0,18,13175
10/26/2015,5,8037,2368,2932,239,0,24,13600
10/26/2015,6,8034,3243,3224,262,0,30,14793
10/26/2015,7,8034,4036,3577,255,0,35,15937
10/26/2015,8,8031,3799,3633,311,19,35,15828
10/26/2015,9,8025,3397,3852,264,55,66,15659
10/26/2015,10,8021,3705,3747,169,80,66,15788
10/26/2015,11,8020,3396,3689,178,74,59,15416
10/26/2015,12,8018,3739,3309,131,78,54,15329
10/26/2015,13,8018,3388,3349,171,76,49,15051
10/26/2015,14,8036,3545,3448,72,73,35,15209
10/26/2015,15,8038,3440,3502,89,48,35,15152
10/26/2015,16,8035,3429,4022,77,34,36,15633
10/26/2015,17,8032,3518,4553,111,14,36,16264
10/26/2015,18,8029,3823,4667,180,0,43,16742
10/26/2015,19,8026,4211,4769,274,0,49,17329
10/26/2015,20,8009,3644,4687,432,0,49,16821
10/26/2015,21,7994,3162,4417,584,0,37,16194
10/26/2015,22,8007,2824,3242,735,0,35,14843
10/26/2015,23,8020,2385,2940,838,0,26,14209
10/26/2015,24,8026,1841,3129,749,0,21,13766
10/27/2015,1,8027,1767,3105,675,0,21,13595
10/27/2015,2,8024,1747,3161,639,0,21,13592
10/27/2015,3,8020,1758,3055,650,0,21,13504
10/27/2015,4,8020,2071,3221,639,0,21,13972
10/27/2015,5,8020,2426,2917,682,0,24,14069
10/27/2015,6,8024,2921,3397,839,0,28,15209
10/27/2015,7,8032,3408,4248,1100,0,36,16824
10/27/2015,8,8034,3187,4273,1137,5,36,16672
10/27/2015,9,8038,3271,4308,973,25,36,16651
10/27/2015,10,8035,3233,4343,842,39,36,16528
10/27/2015,11,8032,3105,3840,998,36,36,16047
10/27/2015,12,8030,2999,3374,1237,36,37,15713
10/27/2015,13,8028,2973,3070,1418,34,36,15559
10/27/2015,14,8023,2641,3074,1615,37,36,15426
10/27/2015,15,8023,2543,3309,1759,51,36,15721
10/27/2015,16,8027,2901,3600,1952,25,36,16541
10/27/2015,17,8018,3111,4113,2079,6,37,17364
10/27/2015,18,8019,2941,4564,2232,0,36,17792
10/27/2015,19,8016,2766,4725,2451,0,36,17994
10/27/2015,20,8009,2224,4636,2487,0,36,17392
10/27/2015,21,8026,1809,4307,2489,0,36,16667
10/27/2015,22,8038,1259,3869,2507,0,36,15709
10/27/2015,23,8035,860,3467,2525,0,26,14913
10/27/2015,24,8027,804,2748,2525,0,21,14125
10/28/2015,1,8027,803,2498,2433,0,21,13782
10/28/2015,2,8035,804,2432,2417,0,21,13709
10/28/2015,3,8041,888,2442,2412,0,21,13804
10/28/2015,4,8041,1056,2453,2458,0,21,14029
10/28/2015,5,8038,1235,2589,2563,0,24,14449
10/28/2015,6,8038,1384,3234,2635,0,26,15317
10/28/2015,7,8033,1566,4059,3000,0,35,16693
10/28/2015,8,8031,2001,4260,2988,0,36,17316
10/28/2015,9,8023,2022,4338,2882,1,36,17302
10/28/2015,10,8026,2131,4292,2822,2,44,17317
10/28/2015,11,8029,2202,4070,2834,3,39,17177
10/28/2015,12,8031,2215,4081,2777,6,37,17147
10/28/2015,13,8030,2147,3883,2857,4,36,16957
10/28/2015,14,8030,1880,3650,3082,6,36,16684
10/28/2015,15,8030,1889,3700,3021,5,36,16681
10/28/2015,16,8037,1904,4270,2941,2,37,17191
10/28/2015,17,8060,2080,4477,2785,1,40,17443
10/28/2015,18,8062,1952,5062,2557,0,55,17688
10/28/2015,19,8065,1954,5181,2539,0,55,17794
10/28/2015,20,8064,1897,4591,2751,0,55,17358
10/28/2015,21,8057,1820,3787,2741,0,38,16443
10/28/2015,22,8051,1495,3101,2687,0,36,15370
10/28/2015,23,8054,961,3116,2637,0,25,14793
10/28/2015,24,8058,842,3036,2602,0,21,14559
10/29/2015,1,8051,841,2575,2622,0,21,14110
10/29/2015,2,8053,839,2474,2348,0,21,13735
10/29/2015,3,8039,916,2505,2422,0,21,13903
10/29/2015,4,8035,1009,2510,2557,0,23,14134
10/29/2015,5,8042,1018,2627,2715,0,29,14431
10/29/2015,6,8055,1047,3168,2743,0,46,15059
10/29/2015,7,8062,1057,3844,2982,1,58,16004
10/29/2015,8,8053,1059,4120,2980,2,60,16274
10/29/2015,9,8046,1063,3922,2997,26,59,16113
10/29/2015,10,8043,1058,3779,2971,22,60,15933
10/29/2015,11,8045,1129,3527,2898,19,58,15676
10/29/2015,12,8053,1246,3530,2962,10,57,15858
10/29/2015,13,8060,1402,3753,3079,30,59,16383
10/29/2015,14,8058,1304,4262,3208,18,57,16907
10/29/2015,15,8031,1398,4412,3265,25,54,17185
10/29/2015,16,8061,1797,4583,3297,13,55,17806
10/29/2015,17,8062,1825,4553,3283,2,54,17779
10/29/2015,18,8070,1729,4746,3217,0,53,17815
10/29/2015,19,8071,1723,4630,3131,0,54,17609
10/29/2015,20,8059,1728,4763,3080,0,49,17679
10/29/2015,21,8068,1579,4262,3076,0,36,17021
10/29/2015,22,8068,1368,3356,2940,0,32,15764
10/29/2015,23,8070,867,3346,2714,0,20,15017
10/29/2015,24,8069,810,2988,2516,0,0,14383
10/30/2015,1,8067,768,3148,2190,0,0,14173
10/30/2015,2,8072,768,3178,1835,0,0,13853
10/30/2015,3,8076,911,3380,1293,0,0,13660
10/30/2015,4,8076,1236,3310,1030,0,0,13652
10/30/2015,5,8081,1600,3418,972,0,0,14071
10/30/2015,6,8077,2527,3604,997,1,0,15206
10/30/2015,7,8072,3134,4409,873,1,1,16490
10/30/2015,8,8082,3649,4680,432,7,1,16851
10/30/2015,9,8084,3582,4641,260,33,0,16600
10/30/2015,10,8083,3025,4572,325,57,0,16062
10/30/2015,11,8080,3183,4480,265,50,0,16058
10/30/2015,12,8091,3101,4332,237,76,0,15837
10/30/2015,13,8097,3071,4319,248,71,0,15806
10/30/2015,14,8092,2889,4188,244,78,0,15491
10/30/2015,15,8096,2864,4175,241,84,0,15460
10/30/2015,16,8093,3130,4392,208,56,0,15879
10/30/2015,17,8094,3552,4980,183,14,0,16823
10/30/2015,18,8096,3794,4966,204,0,0,17060
10/30/2015,19,8083,3920,4910,187,0,0,17100
10/30/2015,20,8088,3791,4936,208,0,0,17023
10/30/2015,21,8111,3053,4822,277,0,0,16263
10/30/2015,22,8111,2593,4642,301,0,0,15647
10/30/2015,23,8289,2275,4031,408,0,0,15003
10/30/2015,24,8326,1688,3673,578,0,0,14265
10/31/2015,1,8311,937,3641,691,0,0,13580
10/31/2015,2,8274,786,3144,764,0,0,12968
10/31/2015,3,8277,756,2915,674,0,0,12622
10/31/2015,4,8276,756,3196,526,0,0,12754
10/31/2015,5,8278,774,3568,509,0,0,13129
10/31/2015,6,8578,1052,3748,420,0,0,13798
10/31/2015,7,8744,1274,4097,437,0,0,14552
10/31/2015,8,8743,1492,4397,479,4,0,15115
10/31/2015,9,8740,1859,4657,546,13,0,15815
10/31/2015,10,8745,2058,4590,661,12,0,16066
10/31/2015,11,8739,2112,4455,912,14,0,16232
10/31/2015,12,8743,1652,4182,1131,11,0,15719
10/31/2015,13,8745,1427,3872,1160,19,0,15223
10/31/2015,14,8709,1342,3980,1338,17,0,15386
10/31/2015,15,8807,1316,4094,1630,11,0,15858
10/31/2015,16,8904,1058,4799,1387,15,6,16169
10/31/2015,17,8912,1069,5283,1190,2,8,16464
10/31/2015,18,8911,1025,4176,1600,0,8,15720
10/31/2015,19,8912,901,3640,1547,0,0,15000
10/31/2015,20,8909,707,3480,2139,0,0,15235
10/31/2015,21,8904,685,3324,2465,0,0,15378
10/31/2015,22,8907,688,3163,2510,0,0,15268
10/31/2015,23,8912,690,2665,2550,0,0,14817
10/31/2015,24,8923,694,2563,2544,0,0,14724
11/1/2015,1,8934,690,2506,2398,0,0,14528
11/1/2015,2,8930,680,2509,2032,0,0,14151
11/1/2015,3,9063,679,2410,1807,0,0,13959
11/1/2015,4,9161,677,2466,2211,0,0,14515
11/1/2015,5,9178,676,2519,1906,0,0,14279
11/1/2015,6,9198,675,2509,2176,0,0,14558
11/1/2015,7,9194,678,2621,2146,1,0,14640
11/1/2015,8,9167,680,2904,2187,3,0,14941
11/1/2015,9,9168,682,3342,2357,49,0,15598
11/1/2015,10,9167,689,3419,2673,79,0,16027
11/1/2015,11,9161,688,3470,2387,86,0,15792
11/1/2015,12,9150,727,3451,2809,81,0,16218
11/1/2015,13,9148,824,3429,2539,91,0,16031
11/1/2015,14,9036,931,3525,2516,51,0,16059
11/1/2015,15,9232,1091,3365,2311,60,0,16059
11/1/2015,16,9648,1169,3395,2102,52,0,16366
11/1/2015,17,9650,1144,3866,1960,15,13,16648
11/1/2015,18,9656,1262,4806,1704,0,14,17442
11/1/2015,19,9661,1343,4846,1406,0,15,17271
11/1/2015,20,9666,1164,4805,1164,0,4,16803
11/1/2015,21,9664,1171,4627,1111,0,2,16575
11/1/2015,22,9667,1150,4335,973,0,2,16127
11/1/2015,23,9670,1174,3959,641,0,9,15453
11/1/2015,24,9733,819,3730,556,0,19,14857
11/2/2015,1,9829,741,3393,478,0,19,14460
11/2/2015,2,9833,751,3207,451,0,21,14263
11/2/2015,3,9847,761,3317,353,0,21,14299
11/2/2015,4,9866,846,3053,293,0,21,14079
11/2/2015,5,10067,1058,2589,274,0,21,14009
11/2/2015,6,10075,1318,3129,319,0,30,14871
11/2/2015,7,10085,1611,4160,412,1,35,16304
11/2/2015,8,10076,1623,4458,463,12,41,16673
11/2/2015,9,10076,1621,4700,482,50,54,16983
11/2/2015,10,10075,1627,4560,455,76,62,16855
11/2/2015,11,10027,1613,4478,563,93,64,16838
11/2/2015,12,10029,1607,4195,576,97,65,16569
11/2/2015,13,10176,1607,4041,538,97,56,16515
11/2/2015,14,10365,1442,4408,688,94,59,17056
11/2/2015,15,10515,946,4369,710,77,50,16667
11/2/2015,16,10518,805,4427,924,52,43,16769
11/2/2015,17,10521,969,4187,974,15,35,16701
11/2/2015,18,10517,975,4480,1230,0,38,17240
11/2/2015,19,10515,1082,4637,1414,0,46,17694
11/2/2015,20,10516,1083,4389,1607,0,34,17629
11/2/2015,21,10512,1121,4600,1700,0,35,17968
11/2/2015,22,10503,1109,4266,1718,0,36,17632
11/2/2015,23,10518,1044,3116,1588,0,37,16303
11/2/2015,24,10524,997,3033,1230,0,31,15815
11/3/2015,1,10382,859,2789,1411,0,25,15466
11/3/2015,2,10287,804,2719,1572,0,22,15404
11/3/2015,3,10288,804,2686,1489,0,20,15287
11/3/2015,4,10283,805,2716,1400,0,20,15224
11/3/2015,5,10282,807,2726,1484,0,20,15319
11/3/2015,6,10328,807,2847,1288,0,24,15294
11/3/2015,7,10485,810,3505,1172,0,31,16003
11/3/2015,8,10682,808,3871,973,11,37,16382
11/3/2015,9,10676,898,3884,698,47,37,16240
11/3/2015,10,10677,933,4487,327,74,37,16535
11/3/2015,11,10676,1141,4553,168,90,37,16665
11/3/2015,12,10672,1479,4237,134,97,37,16656
11/3/2015,13,10666,1603,4044,129,96,37,16575
11/3/2015,14,10667,1736,3820,150,90,37,16500
11/3/2015,15,10661,1790,3966,148,75,37,16677
11/3/2015,16,10659,1973,4144,120,50,37,16983
11/3/2015,17,10652,2223,4340,142,13,47,17417
11/3/2015,18,10651,2286,4771,247,0,50,18005
11/3/2015,19,10658,2430,5198,393,0,51,18730
11/3/2015,20,10660,2236,4991,457,0,52,18396
11/3/2015,21,10658,1986,4812,548,0,39,18043
11/3/2015,22,10641,1709,4189,723,0,37,17299
11/3/2015,23,10670,1067,3733,810,0,37,16317
11/3/2015,24,10674,856,3161,829,0,30,15550
11/4/2015,1,10674,855,2851,952,0,25,15357
11/4/2015,2,10671,862,2598,876,0,21,15028
11/4/2015,3,10673,878,2562,792,0,20,14925
11/4/2015,4,10484,808,2508,714,0,0,14514
11/4/2015,5,10437,898,2625,984,0,21,14965
11/4/2015,6,10433,883,2781,952,0,26,15075
11/4/2015,7,10504,907,4090,918,0,32,16451
11/4/2015,8,10679,992,4542,804,10,36,17063
11/4/2015,9,10683,1125,4297,627,48,36,16816
11/4/2015,10,10684,1227,3872,374,74,36,16267
11/4/2015,11,10684,1316,4176,262,88,36,16562
11/4/2015,12,10676,1311,4018,187,96,36,16324
11/4/2015,13,10675,1318,3871,188,96,36,16184
11/4/2015,14,10674,1330,4351,196,91,59,16701
11/4/2015,15,10681,1336,4560,205,75,59,16916
11/4/2015,16,10690,1403,4769,239,61,63,17225
11/4/2015,17,10684,1450,4958,312,61,74,17539
11/4/2015,18,10682,1441,5253,509,59,76,18020
11/4/2015,19,10689,1496,5321,750,14,80,18350
11/4/2015,20,10693,1332,4905,1069,0,44,18043
11/4/2015,21,10679,1329,4203,1320,0,36,17567
11/4/2015,22,10677,1020,3611,1357,0,36,16701
11/4/2015,23,10665,922,3624,1165,0,36,16412
11/4/2015,24,10381,912,3624,1147,0,26,16090
11/5/2015,1,10095,913,3421,1329,0,18,15776
11/5/2015,2,10104,913,2918,1312,0,19,15266
11/5/2015,3,10106,908,2595,1201,0,19,14829
11/5/2015,4,10126,910,2606,1074,0,22,14738
11/5/2015,5,10111,911,2657,1057,0,22,14758
11/5/2015,6,10403,912,2981,956,0,30,15282
11/5/2015,7,10711,913,3838,774,0,36,16272
11/5/2015,8,10717,930,4394,931,0,36,17008
11/5/2015,9,10713,918,4180,809,0,36,16656
11/5/2015,10,10709,933,4284,657,19,36,16638
11/5/2015,11,10711,927,4270,668,22,36,16634
11/5/2015,12,10708,905,3850,819,53,42,16377
11/5/2015,13,10707,899,3697,805,95,48,16251
11/5/2015,14,10705,894,3575,1090,88,51,16403
11/5/2015,15,10704,869,3657,1217,65,56,16568
11/5/2015,16,10703,844,3984,1289,27,53,16900
11/5/2015,17,10703,849,3964,1227,6,54,16803
11/5/2015,18,10698,882,4360,1676,0,54,17670
11/5/2015,19,10700,893,4433,1821,0,55,17902
11/5/2015,20,10700,901,3894,2006,0,43,17544
11/5/2015,21,10693,903,3903,2050,0,36,17585
11/5/2015,22,10686,903,3498,2180,0,36,17303
11/5/2015,23,10700,901,3178,1874,0,36,16689
11/5/2015,24,10589,889,2897,1703,0,20,16098
11/6/2015,1,10243,890,2827,1478,0,18,15456
11/6/2015,2,9948,893,2505,1654,0,19,15019
11/6/2015,3,9602,899,2565,1623,0,19,14708
11/6/2015,4,9588,899,2555,1646,0,21,14709
11/6/2015,5,9580,892,2610,1728,0,21,14831
11/6/2015,6,9580,890,2806,2060,0,30,15366
11/6/2015,7,9849,889,3328,2062,0,39,16167
11/6/2015,8,10457,899,3816,2134,0,59,17365
11/6/2015,9,10700,893,3839,2242,3,58,17735
11/6/2015,10,10695,903,3594,2142,8,59,17401
11/6/2015,11,10673,908,3440,2437,11,58,17527
11/6/2015,12,10535,902,3555,2363,25,59,17439
11/6/2015,13,10529,906,3568,2272,37,56,17368
11/6/2015,14,10524,911,3594,2006,59,56,17150
11/6/2015,15,10524,912,3609,1982,53,54,17134
11/6/2015,16,10533,913,3635,2127,35,54,17297
11/6/2015,17,10571,917,3868,2292,8,52,17708
11/6/2015,18,10698,915,4211,2198,0,42,18064
11/6/2015,19,10700,918,4222,2134,0,35,18009
11/6/2015,20,10703,919,4049,2065,0,35,17771
11/6/2015,21,10698,911,3856,1790,0,35,17290
11/6/2015,22,10686,920,3772,1525,0,35,16938
11/6/2015,23,10697,911,3397,1343,0,34,16382
11/6/2015,24,10682,788,3241,1140,0,6,15857
11/7/2015,1,10456,779,2893,942,0,3,15073
11/7/2015,2,10190,781,2840,803,0,2,14616
11/7/2015,3,10007,779,2808,872,0,2,14468
11/7/2015,4,9873,778,2582,961,0,3,14197
11/7/2015,5,9873,772,2679,962,0,3,14289
11/7/2015,6,9874,775,2678,859,0,3,14189
11/7/2015,7,10094,774,3127,866,1,2,14864
11/7/2015,8,10178,779,3248,905,4,3,15117
11/7/2015,9,10179,777,3561,868,28,3,15416
11/7/2015,10,10396,779,3493,680,45,3,15396
11/7/2015,11,10313,776,3410,899,55,3,15456
11/7/2015,12,9890,776,3430,1484,56,3,15639
11/7/2015,13,9867,755,3469,1603,48,3,15745
11/7/2015,14,9865,710,3434,1892,70,2,15973
11/7/2015,15,10031,770,3454,2104,34,2,16395
11/7/2015,16,10094,779,3735,1863,51,3,16525
11/7/2015,17,10193,783,4229,1851,11,3,17070
11/7/2015,18,10537,787,4484,2018,0,3,17829
11/7/2015,19,10623,784,4339,2089,0,2,17837
11/7/2015,20,10888,787,3726,1851,0,2,17254
11/7/2015,21,10890,791,3757,1669,0,2,17109
11/7/2015,22,10886,755,3463,1724,0,3,16831
11/7/2015,23,10823,692,3344,1533,0,3,16395
11/7/2015,24,10500,708,3311,1207,0,2,15728
11/8/2015,1,10276,710,2642,1162,0,2,14792
11/8/2015,2,10057,717,2652,1355,0,2,14783
11/8/2015,3,10054,719,2570,1255,0,2,14600
11/8/2015,4,10058,707,2540,1158,0,2,14465
11/8/2015,5,10057,676,2692,1028,0,2,14455
11/8/2015,6,10053,660,2926,866,0,0,14505
11/8/2015,7,10060,696,3382,697,0,0,14835
11/8/2015,8,10058,732,3436,603,10,0,14839
11/8/2015,9,10058,725,3856,372,48,1,15060
11/8/2015,10,10061,724,3909,316,78,9,15097
11/8/2015,11,10057,719,3706,377,95,30,14984
11/8/2015,12,10131,714,3999,419,98,33,15394
11/8/2015,13,10355,715,3998,562,83,37,15750
11/8/2015,14,10508,746,3621,694,87,32,15688
11/8/2015,15,10654,794,3310,817,80,28,15683
11/8/2015,16,10634,798,3604,722,51,24,15833
11/8/2015,17,10710,804,4494,666,11,28,16713
11/8/2015,18,10898,926,5271,719,0,26,17840
11/8/2015,19,10901,1142,5012,848,0,26,17929
11/8/2015,20,10907,1077,4444,943,0,28,17399
11/8/2015,21,10905,800,4197,1041,0,23,16966
11/8/2015,22,10906,802,3725,933,0,21,16387
11/8/2015,23,10911,803,3225,861,0,16,15816
11/8/2015,24,10839,807,2773,796,0,19,15234
11/9/2015,1,10663,811,2631,607,0,32,14744
11/9/2015,2,10542,807,2639,558,0,41,14587
11/9/2015,3,10363,809,3031,585,0,35,14823
11/9/2015,4,10369,854,2931,531,0,22,14707
11/9/2015,5,10349,871,3034,535,0,22,14811
11/9/2015,6,10379,925,3170,422,0,34,14930
11/9/2015,7,10769,1001,4070,406,0,44,16290
11/9/2015,8,10902,1068,4374,375,8,95,16822
11/9/2015,9,10899,1112,4350,324,46,176,16907
11/9/2015,10,10909,1133,4179,214,76,231,16742
11/9/2015,11,10922,1191,4037,231,90,97,16568
11/9/2015,12,10919,1295,3806,322,96,59,16497
11/9/2015,13,10926,1387,3718,283,98,58,16470
11/9/2015,14,10929,1408,3720,189,94,58,16398
11/9/2015,15,10918,1498,3747,145,78,72,16458
11/9/2015,16,10926,1705,4032,139,49,82,16933
11/9/2015,17,10930,1757,4567,132,11,109,17506
11/9/2015,18,10926,1936,5146,196,0,126,18330
11/9/2015,19,10922,2119,5404,286,0,134,18865
11/9/2015,20,10928,1988,5416,370,0,140,18842
11/9/2015,21,10926,2015,5253,392,0,177,18763
11/9/2015,22,10926,1440,4773,455,0,188,17782
11/9/2015,23,10918,1007,4233,472,0,186,16816
11/9/2015,24,10928,912,3756,498,0,174,16268
11/10/2015,1,10926,908,3122,628,0,140,15724
11/10/2015,2,10922,914,2866,739,0,61,15502
11/10/2015,3,10922,915,2861,674,0,22,15394
11/10/2015,4,10924,915,2950,534,0,23,15346
11/10/2015,5,10922,913,3125,456,0,34,15450
11/10/2015,6,10909,913,3223,423,0,52,15520
11/10/2015,7,10920,914,3958,581,0,78,16451
11/10/2015,8,10933,932,4607,688,0,94,17254
11/10/2015,9,10928,970,4684,699,2,145,17428
11/10/2015,10,10927,976,4668,630,7,177,17385
11/10/2015,11,10921,1022,4505,479,9,186,17122
11/10/2015,12,10926,1290,4780,389,11,193,17589
11/10/2015,13,10930,1592,4190,355,8,204,17279
11/10/2015,14,10936,1684,4240,415,5,221,17501
11/10/2015,15,10930,1556,4360,442,4,215,17507
11/10/2015,16,10919,1689,4822,553,1,212,18196
11/10/2015,17,10925,1824,5056,576,0,208,18589
11/10/2015,18,10927,1978,5173,597,0,206,18881
11/10/2015,19,10931,1844,5149,592,0,207,18723
11/10/2015,20,10931,1763,5085,478,0,197,18454
11/10/2015,21,10936,1858,4919,391,0,186,18290
11/10/2015,22,11079,1278,4642,335,0,154,17488
11/10/2015,23,11105,933,4176,249,0,151,16614
11/10/2015,24,11102,900,3538,226,0,147,15913
11/11/2015,1,11152,900,3055,231,0,104,15442
11/11/2015,2,11045,901,2938,257,0,25,15166
11/11/2015,3,11072,901,2797,219,0,18,15007
11/11/2015,4,10852,904,2795,246,0,18,14815
11/11/2015,5,10775,908,2839,366,0,18,14906
11/11/2015,6,10848,907,3185,349,0,26,15315
11/11/2015,7,11076,908,4085,318,0,40,16427
11/11/2015,8,11193,913,4546,364,0,78,17094
11/11/2015,9,11317,913,4730,241,8,100,17309
11/11/2015,10,11326,911,4785,129,12,107,17270
11/11/2015,11,11335,936,4645,104,0,109,17129
11/11/2015,12,11331,910,4420,125,0,110,16896
11/11/2015,13,11337,1014,4370,287,0,113,17121
11/11/2015,14,11344,1135,4266,348,10,112,17215
11/11/2015,15,11343,1305,3981,368,69,105,17171
11/11/2015,16,11354,1305,4028,467,39,108,17301
11/11/2015,17,11426,1308,4422,445,7,101,17709
11/11/2015,18,11432,1391,4700,437,0,97,18057
11/11/2015,19,11435,1329,4781,882,0,116,18543
11/11/2015,20,11433,1317,4733,1036,0,139,18658
11/11/2015,21,11430,995,4389,1516,0,192,18522
11/11/2015,22,11412,908,3839,1648,0,187,17994
11/11/2015,23,11163,916,3289,1556,0,171,17095
11/11/2015,24,10661,909,2628,1921,0,68,16187
11/12/2015,1,10436,907,2533,1494,0,23,15393
11/12/2015,2,10133,907,2463,1432,0,22,14957
11/12/2015,3,9693,903,2457,1574,0,21,14648
11/12/2015,4,9507,904,2432,1505,0,21,14369
11/12/2015,5,9339,904,2571,1684,0,23,14521
11/12/2015,6,9448,899,2756,2150,0,26,15279
11/12/2015,7,9924,900,3515,2346,0,33,16718
11/12/2015,8,10622,910,3972,2366,0,56,17926
11/12/2015,9,10933,908,3910,2447,0,47,18245
11/12/2015,10,11010,909,3988,2577,7,36,18527
11/12/2015,11,11304,907,3728,2890,11,36,18876
11/12/2015,12,11491,908,3762,2733,10,37,18941
11/12/2015,13,11488,922,3670,2531,2,42,18655
11/12/2015,14,11494,906,3523,2818,6,39,18786
11/12/2015,15,11495,905,3549,2659,2,36,18646
11/12/2015,16,11499,903,3708,2739,0,36,18885
11/12/2015,17,11495,909,4226,2604,0,35,19269
11/12/2015,18,11492,905,4621,2936,0,35,19989
11/12/2015,19,11492,903,5064,2459,0,35,19953
11/12/2015,20,11483,903,4904,2361,0,33,19684
11/12/2015,21,11468,906,4233,2177,0,34,18818
11/12/2015,22,11260,907,4090,2226,0,33,18516
11/12/2015,23,10823,905,3708,2075,0,34,17545
11/12/2015,24,10115,898,3582,1897,0,24,16516
11/13/2015,1,9484,896,3356,1652,0,20,15408
11/13/2015,2,9449,894,3338,1218,0,19,14918
11/13/2015,3,9453,896,3102,995,0,19,14465
11/13/2015,4,9459,898,2849,1578,0,20,14804
11/13/2015,5,9468,903,3151,1231,0,21,14774
11/13/2015,6,9474,903,2980,2105,0,24,15486
11/13/2015,7,9849,905,3486,2405,0,29,16674
11/13/2015,8,10656,917,3569,2606,0,34,17782
11/13/2015,9,11183,917,3631,2519,1,34,18285
11/13/2015,10,11287,912,3629,2816,4,35,18683
11/13/2015,11,11505,914,3876,2405,11,35,18746
11/13/2015,12,11528,917,3655,2459,20,35,18614
11/13/2015,13,11313,933,4389,1842,17,35,18529
11/13/2015,14,10747,955,4277,2311,48,35,18373
11/13/2015,15,10746,912,4122,2476,17,35,18308
11/13/2015,16,10751,915,4181,2313,38,36,18234
11/13/2015,17,10754,908,4568,2163,5,42,18440
11/13/2015,18,10757,891,4548,3054,0,45,19295
11/13/2015,19,10760,893,4563,2909,0,45,19170
11/13/2015,20,10756,889,4342,3008,0,36,19031
11/13/2015,21,10747,892,4150,2739,0,38,18566
11/13/2015,22,10734,893,3702,2438,0,38,17805
11/13/2015,23,10753,896,3247,2155,0,34,17085
11/13/2015,24,10757,597,3084,2074,0,12,16524
11/14/2015,1,10762,497,2902,1541,0,2,15704
11/14/2015,2,10704,496,2739,1196,0,2,15137
11/14/2015,3,10469,494,2651,1299,0,2,14915
11/14/2015,4,10215,495,2616,1415,0,2,14743
11/14/2015,5,10214,496,2691,1420,0,2,14823
11/14/2015,6,10210,499,3055,1281,0,2,15047
11/14/2015,7,10216,517,3371,1528,1,2,15635
11/14/2015,8,10494,427,3537,1408,1,3,15870
11/14/2015,9,10735,447,4035,1134,9,2,16362
11/14/2015,10,10739,588,4325,1152,25,2,16831
11/14/2015,11,10764,563,3885,1210,27,2,16451
11/14/2015,12,10767,618,4090,1041,23,2,16541
11/14/2015,13,10648,740,4252,1176,25,3,16844
11/14/2015,14,10581,900,4037,1253,16,3,16790
11/14/2015,15,10596,914,3942,1183,11,2,16648
11/14/2015,16,10617,913,3951,1233,2,3,16719
11/14/2015,17,10758,917,4404,1093,0,3,17175
11/14/2015,18,10762,944,5025,1215,0,3,17949
11/14/2015,19,10763,914,4883,1550,0,3,18113
11/14/2015,20,10769,914,4112,1870,0,3,17668
11/14/2015,21,10762,586,3942,2018,0,3,17311
11/14/2015,22,10753,499,3923,1599,0,3,16777
11/14/2015,23,10736,499,3540,1498,0,2,16275
11/14/2015,24,10636,502,3244,1269,0,3,15654
11/15/2015,1,10238,503,2999,1342,0,3,15085
11/15/2015,2,9807,533,2808,1415,0,3,14566
11/15/2015,3,9585,564,2599,1532,0,3,14283
11/15/2015,4,9418,566,2617,1526,0,3,14130
11/15/2015,5,9151,562,2693,1461,0,2,13869
11/15/2015,6,9022,560,3006,1679,0,5,14272
11/15/2015,7,9022,559,3264,1844,0,4,14693
11/15/2015,8,9185,558,3296,1814,5,13,14871
11/15/2015,9,9616,522,3326,1861,38,14,15377
11/15/2015,10,9888,504,3519,1475,69,7,15462
11/15/2015,11,10325,504,3638,1261,87,2,15817
11/15/2015,12,10633,535,3364,1155,95,2,15784
11/15/2015,13,10711,508,3425,1089,96,1,15830
11/15/2015,14,10705,498,3410,1043,88,0,15744
11/15/2015,15,10709,499,3300,1249,71,0,15828
11/15/2015,16,10708,497,3622,1249,41,0,16117
11/15/2015,17,10711,498,4231,1355,7,0,16802
11/15/2015,18,10716,518,5171,1697,0,0,18102
11/15/2015,19,10861,519,4909,1812,0,0,18101
11/15/2015,20,10959,507,4739,1806,0,0,18011
11/15/2015,21,10958,549,4197,1728,0,0,17432
11/15/2015,22,10927,509,3747,1700,0,0,16883
11/15/2015,23,11018,543,3544,1132,0,9,16246
11/15/2015,24,10984,543,3223,484,0,12,15246
11/16/2015,1,10578,501,3166,682,0,12,14939
11/16/2015,2,10279,525,2915,816,0,12,14547
11/16/2015,3,10155,582,2742,984,0,12,14475
11/16/2015,4,10153,586,2758,621,0,13,14131
11/16/2015,5,10157,635,2932,529,0,13,14266
11/16/2015,6,10220,680,3641,740,0,28,15309
11/16/2015,7,10740,777,4379,694,0,40,16630
11/16/2015,8,11233,889,4526,624,4,66,17342
11/16/2015,9,11284,908,4364,562,36,100,17254
11/16/2015,10,11264,918,4038,390,68,153,16831
11/16/2015,11,11198,916,4099,331,86,175,16805
11/16/2015,12,11188,874,4169,295,94,216,16836
11/16/2015,13,11249,967,4066,272,94,200,16848
11/16/2015,14,11266,1024,3805,288,86,150,16619
11/16/2015,15,11265,1178,3848,334,71,151,16847
11/16/2015,16,11264,1298,4114,291,39,140,17146
11/16/2015,17,11266,1308,4640,359,7,143,17723
11/16/2015,18,11264,1361,5171,506,0,135,18437
11/16/2015,19,11244,1358,5183,621,0,155,18561
11/16/2015,20,11242,1370,5326,772,0,157,18867
11/16/2015,21,11236,1417,5091,991,0,145,18880
11/16/2015,22,11235,1041,4195,1452,0,128,18051
11/16/2015,23,11122,939,3854,1389,0,88,17392
11/16/2015,24,10708,918,3387,1156,0,38,16207
11/17/2015,1,10124,921,3064,1127,0,20,15256
11/17/2015,2,9896,921,3010,1083,0,22,14932
11/17/2015,3,9895,925,3000,926,0,22,14768
11/17/2015,4,9899,935,2953,883,0,22,14692
11/17/2015,5,9908,935,2963,885,0,23,14714
11/17/2015,6,9911,934,3342,943,0,25,15155
11/17/2015,7,10111,931,3755,1962,0,29,16788
11/17/2015,8,10685,937,3955,2163,6,33,17779
11/17/2015,9,11235,945,3907,1565,64,33,17749
11/17/2015,10,11341,943,3864,1145,135,33,17461
11/17/2015,11,11338,939,3580,1103,159,35,17154
11/17/2015,12,11350,937,3499,1333,165,38,17322
11/17/2015,13,11440,936,3158,1332,161,38,17065
11/17/2015,14,11442,933,3164,1395,148,37,17119
11/17/2015,15,11443,931,3148,1574,116,38,17250
11/17/2015,16,11441,932,3583,1779,48,48,17831
11/17/2015,17,11432,931,4082,2240,1,79,18765
11/17/2015,18,11468,928,4712,2549,0,156,19813
11/17/2015,19,11514,929,4442,2672,0,188,19745
11/17/2015,20,11515,933,4200,2690,0,113,19451
11/17/2015,21,11512,933,4096,2400,0,92,19033
11/17/2015,22,11511,931,3967,2130,0,53,18592
11/17/2015,23,11252,929,3715,1575,0,38,17509
11/17/2015,24,10617,915,3234,1522,0,33,16321
11/18/2015,1,9844,913,2888,1553,0,25,15223
11/18/2015,2,9772,914,2874,1230,0,24,14814
11/18/2015,3,9766,912,2867,1000,0,24,14569
11/18/2015,4,9769,909,2902,853,0,22,14455
11/18/2015,5,9773,908,2953,944,0,23,14601
11/18/2015,6,9774,904,3115,1329,0,25,15147
11/18/2015,7,9995,910,3560,2143,0,34,16642
11/18/2015,8,10796,919,4051,2303,6,37,18112
11/18/2015,9,11244,915,3988,1934,31,37,18149
11/18/2015,10,11280,916,3730,1780,60,37,17803
11/18/2015,11,11277,913,3573,1688,114,37,17602
11/18/2015,12,11278,913,3363,1942,95,37,17628
11/18/2015,13,11277,910,3449,1981,80,36,17733
11/18/2015,14,11225,910,3339,2358,78,36,17946
11/18/2015,15,11341,912,3448,2152,60,36,17949
11/18/2015,16,11490,913,3365,2493,22,36,18319
11/18/2015,17,11505,911,4041,2343,2,45,18847
11/18/2015,18,11500,907,4472,2688,0,76,19643
11/18/2015,19,11501,905,4265,2746,0,145,19562
11/18/2015,20,11528,905,4018,2574,0,125,19150
11/18/2015,21,11544,903,3803,2576,0,131,18957
11/18/2015,22,11545,900,3264,2343,0,89,18141
11/18/2015,23,11373,904,3191,1556,0,39,17063
11/18/2015,24,10563,893,3304,1128,0,28,15916
11/19/2015,1,9872,891,3162,1202,0,24,15151
11/19/2015,2,9525,891,2975,1251,0,22,14664
11/19/2015,3,9524,867,2991,771,0,22,14175
11/19/2015,4,9529,835,2967,824,0,22,14177
11/19/2015,5,9550,834,2980,897,0,22,14283
11/19/2015,6,9550,836,3065,1375,0,27,14853
11/19/2015,7,9769,889,3335,2207,0,34,16234
11/19/2015,8,10133,906,3750,2911,0,37,17737
11/19/2015,9,10641,908,3680,2711,8,35,17983
11/19/2015,10,11161,912,3587,2161,42,36,17899
11/19/2015,11,11327,911,3799,1751,40,36,17864
11/19/2015,12,11328,909,3731,1529,89,36,17622
11/19/2015,13,11190,939,3719,1646,108,36,17638
11/19/2015,14,11035,915,3996,1676,126,36,17784
11/19/2015,15,11031,953,4002,1783,59,36,17864
11/19/2015,16,11030,992,3866,2196,4,37,18125
11/19/2015,17,11160,1101,4002,2450,0,36,18749
11/19/2015,18,11493,1098,4237,2728,0,51,19607
11/19/2015,19,11586,1098,4066,2608,0,84,19442
11/19/2015,20,11591,1102,3857,2552,0,86,19188
11/19/2015,21,11594,1104,3865,2563,0,86,19212
11/19/2015,22,11572,1107,3258,2170,0,86,18193
11/19/2015,23,11189,945,3249,1844,0,73,17300
11/19/2015,24,10250,915,3135,1760,0,27,16087
11/20/2015,1,9795,915,3126,1480,0,22,15338
11/20/2015,2,9502,913,2938,1538,0,20,14911
11/20/2015,3,9499,912,2910,1298,0,19,14638
11/20/2015,4,9496,912,2898,1182,0,19,14507
11/20/2015,5,9497,911,2991,1044,0,18,14461
11/20/2015,6,9515,913,3164,1757,0,24,15373
11/20/2015,7,10015,914,3523,2272,0,32,16756
11/20/2015,8,10514,949,4179,2554,6,33,18235
11/20/2015,9,10793,1025,3759,2431,70,33,18111
11/20/2015,10,10990,1022,3441,2164,148,33,17798
11/20/2015,11,10981,1021,3354,1794,139,36,17325
11/20/2015,12,10972,1014,3327,1680,158,36,17187
11/20/2015,13,10979,944,3377,1536,155,47,17038
11/20/2015,14,10978,919,3395,1654,181,50,17177
11/20/2015,15,10981,919,3460,1994,112,52,17518
11/20/2015,16,11007,938,3736,1862,67,65,17675
11/20/2015,17,11344,923,4760,1383,7,90,18507
11/20/2015,18,11530,978,5615,1226,0,147,19496
11/20/2015,19,11531,1241,5177,1220,0,208,19377
11/20/2015,20,11519,1214,4770,1014,0,209,18726
11/20/2015,21,11520,942,4944,850,0,211,18467
11/20/2015,22,11510,928,4670,695,0,212,18015
11/20/2015,23,11513,925,3959,554,0,209,17160
11/20/2015,24,11215,827,3581,386,0,112,16121
11/21/2015,1,10704,809,3491,581,0,19,15604
11/21/2015,2,10676,808,4145,496,0,2,16127
11/21/2015,3,10674,811,4319,369,0,2,16175
11/21/2015,4,10671,815,3307,270,0,2,15065
11/21/2015,5,10677,810,3074,173,0,2,14736
11/21/2015,6,10679,789,3536,71,0,2,15077
11/21/2015,7,10908,670,3984,114,0,2,15678
11/21/2015,8,11396,664,4179,145,3,1,16388
11/21/2015,9,11527,659,4504,192,10,1,16893
11/21/2015,10,11520,659,4776,219,15,2,17191
11/21/2015,11,11521,601,5031,385,52,2,17592
11/21/2015,12,11522,588,4695,388,32,2,17227
11/21/2015,13,11518,590,4469,413,68,2,17060
11/21/2015,14,11518,589,4269,671,41,2,17090
11/21/2015,15,11516,592,4144,648,25,2,16927
11/21/2015,16,11517,618,4233,982,10,2,17362
11/21/2015,17,11510,666,4524,982,2,1,17685
11/21/2015,18,11493,672,5411,894,0,2,18472
11/21/2015,19,11484,690,5055,1079,0,4,18312
11/21/2015,20,11478,787,4457,1174,0,2,17898
11/21/2015,21,11471,804,4088,1102,0,2,17467
11/21/2015,22,11475,769,3773,1529,0,2,17548
11/21/2015,23,11310,784,3352,1543,0,2,16991
11/21/2015,24,10525,795,3324,1547,0,2,16193
11/22/2015,1,9676,809,3052,1887,0,2,15426
11/22/2015,2,9384,810,2975,1506,0,2,14677
11/22/2015,3,9346,813,3018,1206,0,2,14385
11/22/2015,4,9340,817,3040,1097,0,2,14296
11/22/2015,5,9339,814,3044,1128,0,2,14327
11/22/2015,6,9337,816,3053,1242,0,2,14450
11/22/2015,7,9524,817,3254,1414,0,2,15011
11/22/2015,8,10072,814,3379,1376,3,0,15644
11/22/2015,9,10884,808,3267,1349,53,0,16361
11/22/2015,10,11319,852,3243,989,99,5,16507
11/22/2015,11,11500,840,3191,972,167,2,16672
11/22/2015,12,11505,905,3284,1242,139,3,17078
11/22/2015,13,11499,999,3538,1042,125,2,17205
11/22/2015,14,11466,1071,3618,717,105,2,16979
11/22/2015,15,11251,1245,3939,933,59,2,17429
11/22/2015,16,11295,1308,4003,1121,59,2,17788
11/22/2015,17,11528,1427,4623,969,4,21,18572
11/22/2015,18,11529,1423,5454,802,0,67,19275
11/22/2015,19,11525,1425,5147,782,0,156,19035
11/22/2015,20,11525,1420,5239,822,0,173,19179
11/22/2015,21,11523,1418,5123,782,0,182,19028
11/22/2015,22,11521,1174,5297,720,0,183,18895
11/22/2015,23,11518,1047,5087,761,0,180,18593
11/22/2015,24,11515,860,4540,789,0,181,17885
11/23/2015,1,11524,835,3675,710,0,146,16890
11/23/2015,2,11166,833,3572,570,0,66,16207
11/23/2015,3,10674,830,3347,735,0,31,15617
11/23/2015,4,10684,828,3108,731,0,15,15366
11/23/2015,5,10686,826,3391,746,0,19,15668
11/23/2015,6,10761,850,3699,746,0,26,16082
11/23/2015,7,11149,902,4493,724,0,30,17298
11/23/2015,8,11530,951,4684,861,6,31,18063
11/23/2015,9,11534,962,4422,937,59,36,17950
11/23/2015,10,11532,957,4374,883,83,38,17867
11/23/2015,11,11535,975,4321,1014,90,42,17977
11/23/2015,12,11534,1073,4167,1127,125,36,18062
11/23/2015,13,11532,1263,3984,1304,108,36,18227
11/23/2015,14,11535,1429,3974,1254,89,38,18319
11/23/2015,15,11534,1615,4035,1311,47,36,18578
11/23/2015,16,11529,1791,4248,1181,26,35,18810
11/23/2015,17,11532,1788,5067,1236,2,36,19661
11/23/2015,18,11527,1802,5681,1171,0,35,20216
11/23/2015,19,11526,1806,5327,1052,0,36,19747
11/23/2015,20,11528,1929,5397,1018,0,42,19914
11/23/2015,21,11530,1871,5274,1129,0,36,19840
11/23/2015,22,11518,1573,5130,1033,0,34,19288
11/23/2015,23,11515,1049,4317,880,0,34,17795
11/23/2015,24,11514,926,3847,799,0,20,17106
11/24/2015,1,11442,927,3475,845,0,16,16705
11/24/2015,2,11210,928,3226,868,0,15,16247
11/24/2015,3,10969,927,3412,793,0,15,16116
11/24/2015,4,10964,926,3403,854,0,19,16166
11/24/2015,5,10969,925,3438,812,0,21,16165
11/24/2015,6,11032,924,4001,717,0,41,16715
11/24/2015,7,11389,932,4529,602,0,82,17534
11/24/2015,8,11513,1037,5378,544,1,169,18642
11/24/2015,9,11514,996,4922,566,21,205,18224
11/24/2015,10,11513,964,4479,599,70,211,17836
11/24/2015,11,11517,1072,4388,492,89,211,17769
11/24/2015,12,11516,1217,4149,359,97,204,17542
11/24/2015,13,11517,1426,4077,366,107,207,17700
11/24/2015,14,11517,1694,4556,345,76,208,18396
11/24/2015,15,11514,1967,4703,264,78,210,18736
11/24/2015,16,11511,2028,4791,173,41,209,18753
11/24/2015,17,11511,2147,5046,87,3,200,18994
11/24/2015,18,11514,2391,5599,92,0,141,19737
11/24/2015,19,11505,2445,5691,118,0,75,19834
11/24/2015,20,11508,2319,5618,98,0,86,19629
11/24/2015,21,11509,2268,5412,108,0,145,19442
11/24/2015,22,11512,1740,5170,142,0,206,18770
11/24/2015,23,11510,1118,4652,240,0,210,17730
11/24/2015,24,11510,928,4155,373,0,198,17164
11/25/2015,1,11484,928,3608,560,0,181,16761
11/25/2015,2,11200,928,3334,818,0,181,16461
11/25/2015,3,10967,930,3200,877,0,146,16120
11/25/2015,4,10971,930,3162,924,0,41,16028
11/25/2015,5,10970,929,3233,1063,0,20,16215
11/25/2015,6,11040,929,3621,1132,0,23,16745
11/25/2015,7,11271,928,3988,1508,1,30,17726
11/25/2015,8,11461,941,4316,2013,2,35,18768
11/25/2015,9,11516,942,4398,1983,32,35,18906
11/25/2015,10,11516,940,4273,1758,80,35,18602
11/25/2015,11,11517,941,4141,1660,125,35,18419
11/25/2015,12,11517,940,3922,1124,143,35,17681
11/25/2015,13,11514,937,3823,825,160,35,17294
11/25/2015,14,11395,937,3841,948,171,35,17327
11/25/2015,15,11426,936,4033,1394,130,35,17954
11/25/2015,16,11491,931,4135,1522,57,35,18171
11/25/2015,17,11492,928,4325,1838,6,47,18636
11/25/2015,18,11501,930,4594,2214,0,81,19320
11/25/2015,19,11501,930,4650,2521,0,82,19684
11/25/2015,20,11501,928,4508,2616,0,82,19635
11/25/2015,21,11500,930,4423,2603,0,82,19538
11/25/2015,22,11489,928,4216,2390,0,82,19105
11/25/2015,23,11419,926,3603,2007,0,46,18001
11/25/2015,24,10804,922,3264,1786,0,24,16800
11/26/2015,1,10117,911,3285,1598,0,20,15931
11/26/2015,2,9714,910,3258,1620,0,19,15521
11/26/2015,3,9366,911,3311,1611,0,20,15219
11/26/2015,4,9327,908,3255,1524,0,23,15037
11/26/2015,5,9328,908,3308,1699,0,24,15267
11/26/2015,6,9332,909,3258,2035,0,25,15559
11/26/2015,7,9757,915,3491,2882,0,26,17071
11/26/2015,8,10760,919,3760,2935,2,26,18402
11/26/2015,9,11466,920,3660,2679,24,25,18774
11/26/2015,10,11476,920,3734,2509,62,25,18726
11/26/2015,11,11484,920,3653,2559,109,25,18750
11/26/2015,12,11484,920,3729,2217,112,25,18487
11/26/2015,13,11480,916,3677,2257,90,26,18446
11/26/2015,14,11484,916,3630,2254,67,26,18377
11/26/2015,15,11482,913,3655,1919,65,25,18059
11/26/2015,16,11485,911,3781,2022,9,25,18233
11/26/2015,17,11484,917,4281,2073,1,25,18781
11/26/2015,18,11484,917,4545,2581,0,25,19552
11/26/2015,19,11485,924,4544,2435,0,25,19413
11/26/2015,20,11486,928,4663,2102,0,25,19204
11/26/2015,21,11472,926,4466,1893,0,24,18781
11/26/2015,22,11414,926,3881,1854,0,26,18101
11/26/2015,23,10787,925,3397,1844,0,25,16978
11/26/2015,24,9915,912,3360,1759,0,6,15952
11/27/2015,1,9428,905,3211,1537,0,2,15083
11/27/2015,2,9314,911,3229,1093,0,1,14548
11/27/2015,3,9306,909,3247,846,0,1,14309
11/27/2015,4,9313,911,3193,754,0,0,14171
11/27/2015,5,9317,910,3248,885,0,0,14360
11/27/2015,6,9318,910,3319,1381,0,0,14928
11/27/2015,7,9754,916,3573,2124,0,0,16367
11/27/2015,8,10774,927,3520,2484,1,0,17706
11/27/2015,9,11410,932,3495,2487,6,0,18330
11/27/2015,10,11456,936,3804,2248,19,0,18463
11/27/2015,11,11450,935,3882,2105,22,0,18394
11/27/2015,12,11454,935,3911,2263,19,0,18582
11/27/2015,13,11466,880,3842,2109,13,0,18310
11/27/2015,14,11471,875,3797,1947,7,0,18097
11/27/2015,15,11483,872,3828,1672,3,0,17858
11/27/2015,16,11481,870,3964,1810,0,1,18126
11/27/2015,17,11485,873,4373,1995,0,0,18726
11/27/2015,18,11477,883,4864,2184,0,0,19408
11/27/2015,19,11485,886,4883,2108,0,1,19363
11/27/2015,20,11487,886,4670,1968,0,3,19014
11/27/2015,21,11481,883,4544,1766,0,3,18677
11/27/2015,22,11480,881,4190,1374,0,3,17928
11/27/2015,23,11486,906,4046,888,0,3,17329
11/27/2015,24,11486,818,4017,673,0,3,16997
11/28/2015,1,11486,803,3599,538,0,3,16429
11/28/2015,2,11484,831,3135,515,0,3,15968
11/28/2015,3,11205,831,3099,342,0,3,15480
11/28/2015,4,10941,829,3159,537,0,2,15468
11/28/2015,5,10961,834,3160,427,0,1,15383
11/28/2015,6,10969,842,3176,579,0,0,15566
11/28/2015,7,10970,853,3540,385,0,0,15748
11/28/2015,8,11118,891,3692,555,1,0,16257
11/28/2015,9,11453,914,4328,527,4,0,17226
11/28/2015,10,11505,960,4798,493,18,0,17774
11/28/2015,11,11504,1024,5194,464,21,1,18208
11/28/2015,12,11501,1080,5086,422,33,0,18122
11/28/2015,13,11498,1128,4850,341,32,0,17849
11/28/2015,14,11501,1220,4593,381,25,0,17720
11/28/2015,15,11456,1441,3909,339,24,0,17169
11/28/2015,16,11502,1585,4012,234,4,0,17337
11/28/2015,17,11510,1753,4637,354,1,0,18255
11/28/2015,18,11505,1789,5544,245,0,0,19083
11/28/2015,19,11544,1915,5637,222,0,0,19318
11/28/2015,20,11554,1811,5617,208,0,0,19190
11/28/2015,21,11555,1719,5499,208,0,0,18981
11/28/2015,22,11552,1489,5271,219,0,2,18533
11/28/2015,23,11556,1204,4415,298,0,2,17475
11/28/2015,24,11542,1162,4014,254,0,2,16974
11/29/2015,1,11412,845,3694,208,0,2,16161
11/29/2015,2,11303,756,3853,154,0,2,16068
11/29/2015,3,11306,756,3613,173,0,2,15850
11/29/2015,4,11295,756,3526,245,0,2,15824
11/29/2015,5,11305,757,3454,218,0,2,15736
11/29/2015,6,11316,756,3842,180,0,1,16095
11/29/2015,7,11321,756,4136,152,0,2,16367
11/29/2015,8,11320,755,4346,161,4,2,16588
11/29/2015,9,11320,755,4542,129,41,2,16789
11/29/2015,10,11318,757,4711,71,92,2,16951
11/29/2015,11,11313,790,4939,35,105,2,17184
11/29/2015,12,11309,950,5128,41,98,0,17526
11/29/2015,13,11334,959,4758,123,111,0,17285
11/29/2015,14,11559,1070,4519,179,99,2,17428
11/29/2015,15,11577,1133,4403,185,29,2,17329
11/29/2015,16,11575,1374,4691,264,15,2,17921
11/29/2015,17,11566,1370,5011,322,3,2,18274
11/29/2015,18,11567,1739,5576,317,0,2,19201
11/29/2015,19,11570,1729,5530,428,0,2,19259
11/29/2015,20,11574,1746,5529,465,0,2,19316
11/29/2015,21,11569,1436,5208,567,0,2,18782
11/29/2015,22,11559,1516,4865,563,0,2,18505
11/29/2015,23,11556,1206,4389,608,0,2,17761
11/29/2015,24,11551,848,3841,622,0,2,16864
11/30/2015,1,11547,758,3646,572,0,2,16525
11/30/2015,2,11548,753,3320,549,0,2,16172
11/30/2015,3,11548,755,3195,556,0,2,16056
11/30/2015,4,11565,757,3078,369,0,2,15771
11/30/2015,5,11565,754,3105,844,0,0,16268
11/30/2015,6,11563,780,3468,701,0,11,16523
11/30/2015,7,11562,827,4326,973,0,42,17730
11/30/2015,8,11563,872,4967,1137,2,125,18666
11/30/2015,9,11560,885,5206,1045,43,184,18923
11/30/2015,10,11565,969,5390,852,82,188,19046
11/30/2015,11,11559,1029,5256,847,105,189,18985
11/30/2015,12,11561,1135,4937,586,119,183,18521
11/30/2015,13,11562,1132,4814,400,110,178,18196
11/30/2015,14,11559,1322,4528,400,117,178,18104
11/30/2015,15,11563,1621,4150,503,105,179,18121
11/30/2015,16,11563,1692,4233,533,50,179,18250
11/30/2015,17,11564,1687,4923,724,4,180,19082
11/30/2015,18,11563,1661,5628,1088,0,184,20124
11/30/2015,19,11564,1668,5583,1459,0,186,20460
11/30/2015,20,11562,1659,5408,1499,0,185,20313
11/30/2015,21,11559,1350,5116,1632,0,180,19837
11/30/2015,22,11557,1272,4675,1587,0,181,19272
11/30/2015,23,11551,1273,3813,1570,0,177,18384
11/30/2015,24,11548,956,3705,1430,0,157,17796
12/1/2015,1,11549,868,3058,1159,0,93,16727
12/1/2015,2,11520,870,3052,925,0,42,16409
12/1/2015,3,11530,871,2978,898,0,23,16300
12/1/2015,4,11525,870,3024,673,0,34,16126
12/1/2015,5,11529,867,3031,912,0,40,16379
12/1/2015,6,11533,868,3463,1003,0,37,16904
12/1/2015,7,11528,868,4053,1385,0,49,17883
12/1/2015,8,11532,877,4486,1585,1,59,18540
12/1/2015,9,11533,927,4871,1579,4,53,18967
12/1/2015,10,11480,976,4854,1524,10,43,18887
12/1/2015,11,11383,1189,4917,1477,14,54,19034
12/1/2015,12,11539,1307,4566,1475,19,36,18942
12/1/2015,13,11533,1385,4331,1477,13,35,18774
12/1/2015,14,11533,1486,4331,1402,13,35,18800
12/1/2015,15,11528,1797,4464,1130,7,35,18961
12/1/2015,16,11526,1913,4767,866,4,35,19111
12/1/2015,17,11531,2164,5192,888,0,36,19811
12/1/2015,18,11531,2153,5552,969,0,40,20245
12/1/2015,19,11537,2128,5209,969,0,41,19884
12/1/2015,20,11533,2129,5143,933,0,35,19773
12/1/2015,21,11519,1644,5211,925,0,35,19334
12/1/2015,22,11522,1517,4757,1163,0,35,18994
12/1/2015,23,11527,1365,3855,1039,0,35,17821
12/1/2015,24,11523,1139,3475,704,0,29,16870
12/2/2015,1,11523,926,3073,530,0,25,16077
12/2/2015,2,11530,917,2987,501,0,23,15958
12/2/2015,3,11440,917,2938,299,0,22,15616
12/2/2015,4,11289,918,3206,378,0,22,15813
12/2/2015,5,11285,919,3455,288,0,27,15974
12/2/2015,6,11353,918,3854,224,0,34,16383
12/2/2015,7,11537,1021,4335,138,0,47,17078
12/2/2015,8,11540,1258,4672,162,0,88,17720
12/2/2015,9,11534,1209,4635,146,2,106,17632
12/2/2015,10,11531,1011,4548,198,11,89,17388
12/2/2015,11,11528,958,4786,115,25,88,17500
12/2/2015,12,11526,1169,4846,81,48,101,17771
12/2/2015,13,11524,1172,4526,55,39,102,17418
12/2/2015,14,11384,1426,4475,43,65,103,17496
12/2/2015,15,11458,1715,4370,64,16,134,17757
12/2/2015,16,11519,2096,4445,38,5,31,18134
12/2/2015,17,11518,2594,4855,49,0,142,19158
12/2/2015,18,11519,2899,5537,131,0,99,20185
12/2/2015,19,11515,2496,5531,271,0,46,19859
12/2/2015,20,11521,2183,5550,469,0,34,19757
12/2/2015,21,11519,2184,5061,564,0,34,19362
12/2/2015,22,11513,2345,4318,477,0,34,18687
12/2/2015,23,11501,1920,3953,415,0,34,17823
12/2/2015,24,11508,1673,3590,400,0,22,17193
12/3/2015,1,11507,1211,3323,522,0,18,16581
12/3/2015,2,11515,916,3261,544,0,20,16256
12/3/2015,3,11467,917,3043,346,0,20,15793
12/3/2015,4,11253,917,3042,591,0,21,15824
12/3/2015,5,11218,919,3047,526,0,22,15732
12/3/2015,6,11289,921,3288,871,0,24,16393
12/3/2015,7,11468,923,3871,1055,0,40,17357
12/3/2015,8,11469,927,4106,1351,3,76,17932
12/3/2015,9,11464,928,3969,1423,16,91,17891
12/3/2015,10,11465,927,4098,1260,72,91,17913
12/3/2015,11,11468,928,3784,1458,91,101,17830
12/3/2015,12,11470,927,3812,1499,95,134,17937
12/3/2015,13,11464,936,3659,1643,92,153,17947
12/3/2015,14,11461,990,3778,1755,50,150,18184
12/3/2015,15,11458,1127,3772,1783,40,98,18278
12/3/2015,16,11456,1126,4130,1633,22,93,18460
12/3/2015,17,11466,1156,4691,1349,1,67,18730
12/3/2015,18,11457,1280,5509,1326,0,82,19654
12/3/2015,19,11453,1304,5322,1355,0,84,19518
12/3/2015,20,11458,1305,5152,1326,0,67,19308
12/3/2015,21,11453,1157,4752,1390,0,37,18789
12/3/2015,22,11441,997,4156,1533,0,37,18164
12/3/2015,23,11442,926,3499,1430,0,37,17334
12/3/2015,24,11304,924,3212,1282,0,24,16746
12/4/2015,1,10967,924,3076,978,0,21,15966
12/4/2015,2,10417,920,3092,1135,0,20,15584
12/4/2015,3,10067,922,3005,1165,0,20,15179
12/4/2015,4,10001,921,3073,1060,0,20,15075
12/4/2015,5,10000,922,3074,1215,0,20,15231
12/4/2015,6,10248,922,3061,1496,0,23,15750
12/4/2015,7,10903,925,3455,1463,0,30,16776
12/4/2015,8,11331,928,3877,1404,1,36,17577
12/4/2015,9,11445,932,4386,1275,3,36,18077
12/4/2015,10,11444,1025,4755,1109,12,37,18382
12/4/2015,11,11444,956,4308,1112,30,37,17887
12/4/2015,12,11448,926,4178,1149,26,36,17763
12/4/2015,13,11447,924,4250,1012,29,37,17699
12/4/2015,14,11446,927,4336,854,33,37,17633
12/4/2015,15,11449,929,4600,764,19,37,17798
12/4/2015,16,11160,963,4656,750,7,37,17573
12/4/2015,17,10568,1288,5393,747,0,39,18035
12/4/2015,18,10565,1423,5407,882,0,38,18315
12/4/2015,19,10567,1196,5160,1204,0,37,18164
12/4/2015,20,10564,1115,4817,1332,0,37,17865
12/4/2015,21,10559,1112,4664,1343,0,37,17715
12/4/2015,22,10555,1110,4737,1216,0,37,17655
12/4/2015,23,10558,1102,4471,1064,0,38,17233
12/4/2015,24,10560,846,4313,979,0,31,16729
12/5/2015,1,10561,763,3857,777,0,15,15973
12/5/2015,2,10562,764,3437,720,0,6,15489
12/5/2015,3,10568,726,3099,722,0,5,15120
12/5/2015,4,10570,748,2983,726,0,5,15032
12/5/2015,5,10572,763,3009,743,0,5,15092
12/5/2015,6,10572,764,3259,775,0,5,15375
12/5/2015,7,10564,771,3791,734,0,5,15865
12/5/2015,8,10546,707,3961,757,1,5,15977
12/5/2015,9,10541,637,4705,691,8,5,16587
12/5/2015,10,10543,755,4783,634,40,5,16760
12/5/2015,11,10538,714,4445,616,100,5,16418
12/5/2015,12,10558,662,4181,521,88,5,16015
12/5/2015,13,10557,630,4151,482,79,5,15904
12/5/2015,14,10519,716,4055,477,82,5,15854
12/5/2015,15,10561,831,4391,373,38,5,16199
12/5/2015,16,10562,999,4755,336,10,11,16673
12/5/2015,17,10566,1187,5031,475,1,45,17305
12/5/2015,18,10583,1385,5769,741,0,87,18565
12/5/2015,19,10585,1340,5447,804,0,115,18291
12/5/2015,20,10586,1256,5200,790,0,97,17929
12/5/2015,21,10577,1171,4796,777,0,105,17426
12/5/2015,22,10575,1188,4628,764,0,126,17281
12/5/2015,23,10574,1175,4214,756,0,129,16848
12/5/2015,24,10578,1172,3387,663,0,57,15857
12/6/2015,1,10584,853,3596,598,0,11,15642
12/6/2015,2,10587,767,3426,533,0,6,15319
12/6/2015,3,10583,765,3167,555,0,6,15076
12/6/2015,4,10587,766,2992,527,0,6,14878
12/6/2015,5,10590,764,2961,536,0,6,14857
12/6/2015,6,10592,764,2951,653,0,6,14966
12/6/2015,7,10595,765,3307,627,0,6,15300
12/6/2015,8,10593,761,3481,614,0,6,15455
12/6/2015,9,10588,800,4039,616,8,6,16057
12/6/2015,10,10584,816,4428,531,23,6,16388
12/6/2015,11,10584,925,4422,439,40,6,16416
12/6/2015,12,10577,973,4034,442,63,5,16094
12/6/2015,13,10575,1015,4112,471,88,5,16266
12/6/2015,14,10579,1178,3806,531,91,9,16194
12/6/2015,15,10580,1324,3904,608,36,10,16462
12/6/2015,16,10563,1388,3940,626,16,17,16550
12/6/2015,17,10564,1379,4802,709,2,40,17496
12/6/2015,18,10563,1485,5664,832,0,86,18630
12/6/2015,19,10591,1495,5655,856,0,78,18675
12/6/2015,20,10598,1386,5225,845,0,77,18131
12/6/2015,21,10596,1477,5114,837,0,126,18150
12/6/2015,22,10588,1314,4925,684,0,86,17597
12/6/2015,23,10588,1328,4658,580,0,73,17227
12/6/2015,24,10590,901,4218,420,0,103,16232
12/7/2015,1,10590,771,3756,403,0,154,15674
12/7/2015,2,10592,778,3543,332,0,176,15421
12/7/2015,3,10596,792,3246,224,0,180,15038
12/7/2015,4,10606,783,3385,93,0,195,15062
12/7/2015,5,10612,848,3258,84,0,171,14973
12/7/2015,6,10614,880,3303,88,0,145,15030
12/7/2015,7,10613,976,3939,101,0,128,15757
12/7/2015,8,10610,1166,4737,163,0,174,16850
12/7/2015,9,10612,1468,5323,96,8,195,17702
12/7/2015,10,10610,1360,5414,78,21,155,17638
12/7/2015,11,10606,1472,5422,61,22,126,17709
12/7/2015,12,10606,1621,5363,47,21,108,17766
12/7/2015,13,10621,1804,5048,59,20,91,17643
12/7/2015,14,10627,2196,4415,49,20,88,17395
12/7/2015,15,10620,2577,4350,71,16,88,17722
12/7/2015,16,10618,2597,4661,91,5,88,18060
12/7/2015,17,10609,2642,5371,112,0,91,18825
12/7/2015,18,10614,2774,5888,149,0,94,19519
12/7/2015,19,10616,2630,5549,153,0,83,19031
12/7/2015,20,10613,2616,5154,201,0,83,18667
12/7/2015,21,10607,2617,5318,246,0,89,18877
12/7/2015,22,10603,2584,5163,270,0,125,18745
12/7/2015,23,10606,1944,4735,278,0,164,17727
12/7/2015,24,10608,1211,4327,307,0,149,16602
12/8/2015,1,10623,1022,3877,266,0,83,15871
12/8/2015,2,10625,927,3742,287,0,69,15650
12/8/2015,3,10631,927,3534,321,0,37,15450
12/8/2015,4,10624,924,3207,337,0,17,15109
12/8/2015,5,10627,924,3306,512,0,17,15386
12/8/2015,6,10636,922,3148,626,0,20,15352
12/8/2015,7,10645,928,3957,563,0,29,16122
12/8/2015,8,10650,982,4651,774,0,33,17090
12/8/2015,9,10649,1042,4850,782,4,33,17360
12/8/2015,10,10637,1052,4846,626,55,33,17249
12/8/2015,11,10629,1162,4724,774,96,33,17418
12/8/2015,12,10632,1278,4387,865,79,33,17274
12/8/2015,13,10634,1430,4156,1022,79,53,17374
12/8/2015,14,10637,1435,4179,1080,48,96,17475
12/8/2015,15,10638,1447,4454,1023,17,152,17731
12/8/2015,16,10633,1521,4767,870,6,148,17945
12/8/2015,17,10632,1720,5188,614,0,174,18328
12/8/2015,18,10618,1646,5471,680,0,143,18558
12/8/2015,19,10625,1807,5326,896,0,186,18840
12/8/2015,20,10636,1642,5275,1172,0,205,18930
12/8/2015,21,10639,1634,4679,1527,0,199,18678
12/8/2015,22,10634,1125,4332,1573,0,206,17870
12/8/2015,23,10632,1019,3788,1597,0,178,17214
12/8/2015,24,10643,1014,3222,1479,0,57,16415
12/9/2015,1,10637,1014,2970,1231,0,20,15872
12/9/2015,2,10480,1014,2844,954,0,18,15310
12/9/2015,3,9830,1008,2859,1065,0,17,14779
12/9/2015,4,9494,1002,2832,1069,0,17,14414
12/9/2015,5,9488,1007,2980,1100,0,18,14593
12/9/2015,6,9735,1018,2987,1594,0,24,15358
12/9/2015,7,10254,1023,3533,1666,1,30,16507
12/9/2015,8,10640,1041,3761,1663,1,34,17140
12/9/2015,9,10640,1071,3823,1717,28,35,17314
12/9/2015,10,10617,1104,3765,1539,95,34,17154
12/9/2015,11,10595,1107,3775,1316,154,52,16999
12/9/2015,12,10623,1150,3732,1246,170,74,16995
12/9/2015,13,10636,1295,3761,1343,150,89,17274
12/9/2015,14,10667,1493,3670,1564,111,83,17588
12/9/2015,15,10676,1594,3654,1491,43,91,17549
12/9/2015,16,10669,1793,3603,2262,14,82,18423
12/9/2015,17,10667,2006,4049,2060,0,93,18875
12/9/2015,18,10670,2015,4699,2068,0,87,19539
12/9/2015,19,10669,2010,4783,1681,0,87,19230
12/9/2015,20,10666,2014,4556,1960,0,61,19257
12/9/2015,21,10662,1867,4558,1397,0,34,18518
12/9/2015,22,10656,1812,4084,1090,0,32,17674
12/9/2015,23,10542,1784,3681,889,0,33,16929
12/9/2015,24,10082,1766,3039,869,0,23,15779
12/10/2015,1,9611,1101,3108,1024,0,28,14872
12/10/2015,2,9509,913,3038,979,0,46,14485
12/10/2015,3,9306,914,3028,845,0,47,14140
12/10/2015,4,9208,911,2979,934,0,43,14075
12/10/2015,5,9206,911,2972,1031,0,39,14159
12/10/2015,6,9285,913,3234,1160,0,40,14632
12/10/2015,7,9729,910,3908,1590,0,51,16188
12/10/2015,8,10087,930,4239,1818,0,54,17128
12/10/2015,9,10621,929,3816,1716,28,47,17157
12/10/2015,10,10672,921,3627,1733,78,41,17072
12/10/2015,11,10671,923,3727,1790,93,51,17255
12/10/2015,12,10670,924,3654,2212,82,73,17615
12/10/2015,13,10674,924,3668,2006,59,105,17436
12/10/2015,14,10676,924,3677,1934,33,102,17346
12/10/2015,15,10674,922,3661,2010,17,115,17399
12/10/2015,16,10673,922,3785,2123,8,116,17627
12/10/2015,17,10668,914,4240,1889,1,107,17819
12/10/2015,18,10668,905,4764,2616,0,66,19019
12/10/2015,19,10668,902,4826,2384,0,62,18842
12/10/2015,20,10668,909,4645,2262,0,55,18539
12/10/2015,21,10661,910,4717,2338,0,46,18672
12/10/2015,22,10650,912,3896,2145,0,42,17645
12/10/2015,23,10527,910,3397,1717,0,49,16600
12/10/2015,24,10084,908,3084,1415,0,45,15536
12/11/2015,1,9483,904,2973,1169,0,39,14568
12/11/2015,2,8918,906,2927,1569,0,37,14357
12/11/2015,3,8603,905,2948,1359,0,35,13850
12/11/2015,4,8600,903,2946,1436,0,32,13917
12/11/2015,5,8603,903,3007,1217,0,31,13761
12/11/2015,6,8757,902,3236,1701,0,27,14623
12/11/2015,7,9493,900,3358,2144,0,30,15925
12/11/2015,8,10077,909,3642,2808,1,36,17473
12/11/2015,9,10519,913,3650,2225,21,42,17370
12/11/2015,10,10555,912,3704,1954,97,44,17266
12/11/2015,11,10550,912,3721,1574,160,47,16964
12/11/2015,12,10555,913,3621,1765,184,38,17076
12/11/2015,13,10639,913,3597,1665,183,37,17034
12/11/2015,14,10651,912,3600,1969,152,38,17322
12/11/2015,15,10648,910,3607,2035,94,37,17331
12/11/2015,16,10650,914,3632,2048,40,35,17319
12/11/2015,17,10644,921,4209,1477,1,34,17286
12/11/2015,18,10645,923,4816,1455,0,35,17874
12/11/2015,19,10654,923,5305,1074,0,37,17993
12/11/2015,20,10655,924,5548,841,0,36,18004
12/11/2015,21,10654,924,5429,634,0,36,17677
12/11/2015,22,10652,923,5150,537,0,36,17298
12/11/2015,23,10647,926,4445,295,0,35,16348
12/11/2015,24,10600,920,3987,182,0,11,15700
12/12/2015,1,10209,917,3639,154,0,3,14922
12/12/2015,2,9810,912,3657,133,0,3,14515
12/12/2015,3,9586,890,3400,174,0,3,14053
12/12/2015,4,9499,842,3231,365,0,2,13939
12/12/2015,5,9497,825,2969,581,0,2,13874
12/12/2015,6,9494,826,3074,1036,0,2,14432
12/12/2015,7,9784,825,3145,982,0,2,14738
12/12/2015,8,10108,747,3415,938,1,2,15211
12/12/2015,9,10502,699,3801,971,12,2,15987
12/12/2015,10,10641,699,4554,696,24,2,16616
12/12/2015,11,10641,709,5048,505,52,2,16957
12/12/2015,12,10634,720,5282,385,66,0,17087
12/12/2015,13,10630,764,5239,301,52,0,16986
12/12/2015,14,10635,784,5139,202,37,0,16797
12/12/2015,15,10634,870,5188,161,18,0,16871
12/12/2015,16,10631,1108,4785,156,6,0,16686
12/12/2015,17,10629,1335,5481,146,0,0,17591
12/12/2015,18,10624,1365,5808,179,0,0,17976
12/12/2015,19,10614,1329,5864,240,0,0,18047
12/12/2015,20,10611,1278,5530,269,0,0,17688
12/12/2015,21,10601,1280,5028,240,0,0,17149
12/12/2015,22,10597,1320,4663,224,0,0,16804
12/12/2015,23,10597,1003,4426,234,0,0,16260
12/12/2015,24,10338,920,3671,315,0,0,15244
12/13/2015,1,9818,922,3260,433,0,0,14433
12/13/2015,2,9459,920,3302,607,0,0,14288
12/13/2015,3,9454,913,2989,689,0,0,14045
12/13/2015,4,9453,873,2892,575,0,0,13793
12/13/2015,5,9449,870,2917,538,0,0,13774
12/13/2015,6,9446,869,2966,629,0,0,13910
12/13/2015,7,9459,870,2985,920,0,0,14234
12/13/2015,8,9939,868,3189,1225,0,0,15221
12/13/2015,9,10403,868,3437,999,4,0,15711
12/13/2015,10,10581,869,3503,1162,17,0,16132
12/13/2015,11,10582,868,3685,1402,31,0,16568
12/13/2015,12,10575,870,3718,1724,22,0,16909
12/13/2015,13,10572,872,4090,1782,15,0,17331
12/13/2015,14,10568,870,4084,1780,11,0,17313
12/13/2015,15,10545,856,4457,1617,8,0,17483
12/13/2015,16,10538,845,4759,1661,4,0,17807
12/13/2015,17,10573,859,5119,1705,0,0,18256
12/13/2015,18,10572,991,5436,1915,0,0,18914
12/13/2015,19,10578,1004,4761,2081,0,0,18424
12/13/2015,20,10576,1033,4470,2184,0,0,18263
12/13/2015,21,10570,1042,4141,1885,0,0,17638
12/13/2015,22,10564,888,4008,1805,0,0,17265
12/13/2015,23,10560,833,3564,1563,0,0,16520
12/13/2015,24,10423,832,3115,1395,0,0,15765
12/14/2015,1,10062,838,2968,1134,0,4,15006
12/14/2015,2,9448,850,3000,1046,0,17,14361
12/14/2015,3,9097,854,2993,1309,0,18,14271
12/14/2015,4,9094,850,3033,984,0,18,13979
12/14/2015,5,9101,850,3101,1188,0,18,14258
12/14/2015,6,9122,855,3262,1639,0,21,14899
12/14/2015,7,9592,857,3564,2234,0,29,16276
12/14/2015,8,10395,857,3646,2187,0,36,17121
12/14/2015,9,10557,795,3689,2534,12,37,17624
12/14/2015,10,10555,846,3748,2456,54,36,17695
12/14/2015,11,10550,909,4138,2095,74,45,17811
12/14/2015,12,10551,906,4398,1877,34,39,17805
12/14/2015,13,10549,905,4052,1990,29,36,17561
12/14/2015,14,10549,907,4037,1768,57,34,17352
12/14/2015,15,10547,906,3969,2154,20,28,17624
12/14/2015,16,10543,908,4283,2105,7,26,17872
12/14/2015,17,10540,909,4985,2185,0,25,18644
12/14/2015,18,10560,908,5551,2642,0,25,19686
12/14/2015,19,10567,910,5033,2806,0,25,19341
12/14/2015,20,10565,912,4915,2588,0,25,19005
12/14/2015,21,10561,913,4691,2577,0,31,18773
12/14/2015,22,10555,910,4278,2340,0,33,18116
12/14/2015,23,10471,912,3867,2014,0,36,17300
12/14/2015,24,10004,910,3626,1612,0,27,16179
12/15/2015,1,9521,907,3438,1274,0,25,15165
12/15/2015,2,8881,909,3472,1421,0,20,14703
12/15/2015,3,8650,936,3409,1332,0,22,14349
12/15/2015,4,8488,943,3439,1456,0,21,14347
12/15/2015,5,8488,964,3388,1335,0,22,14197
12/15/2015,6,8710,1000,3520,1896,0,27,15153
12/15/2015,7,9804,1052,3787,1858,1,33,16535
12/15/2015,8,10351,1117,4425,1748,1,37,17679
12/15/2015,9,10535,1147,4276,1718,11,38,17725
12/15/2015,10,10539,1194,4560,1523,15,37,17868
12/15/2015,11,10535,1238,4362,1329,14,37,17515
12/15/2015,12,10550,1370,4556,1204,25,38,17743
12/15/2015,13,10553,1530,4633,1090,25,37,17868
12/15/2015,14,10549,1731,4495,923,41,38,17777
12/15/2015,15,10514,2156,4330,778,18,39,17835
12/15/2015,16,10511,2311,4464,799,8,38,18131
12/15/2015,17,10502,2311,5418,728,0,38,18997
12/15/2015,18,10503,2314,6114,501,0,38,19470
12/15/2015,19,10503,2313,6184,335,0,37,19372
12/15/2015,20,10507,2323,6068,312,0,38,19248
12/15/2015,21,10516,2486,5933,251,0,38,19224
12/15/2015,22,10517,2098,5588,207,0,37,18447
12/15/2015,23,10518,1365,5263,171,0,37,17354
12/15/2015,24,10517,989,4899,134,0,27,16566
12/16/2015,1,10524,926,4302,123,0,20,15895
12/16/2015,2,10313,927,4287,109,0,21,15657
12/16/2015,3,10224,926,4185,124,0,21,15480
12/16/2015,4,10222,923,4186,151,0,22,15504
12/16/2015,5,10229,927,4002,236,0,22,15416
12/16/2015,6,10236,924,4599,176,0,46,15981
12/16/2015,7,10319,924,5162,399,0,52,16856
12/16/2015,8,10546,979,5609,558,0,53,17745
12/16/2015,9,10536,990,5808,714,16,70,18134
12/16/2015,10,10537,970,5232,875,52,92,17758
12/16/2015,11,10484,944,5456,989,53,161,18087
12/16/2015,12,10396,1033,5384,1195,40,166,18214
12/16/2015,13,10521,1196,5357,1164,41,171,18450
12/16/2015,14,10530,1332,5099,1154,19,209,18343
12/16/2015,15,10528,1332,5365,1297,10,224,18756
12/16/2015,16,10527,1359,5322,1728,4,223,19163
12/16/2015,17,10531,1407,5278,2381,0,222,19819
12/16/2015,18,10520,1521,5329,2589,0,223,20182
12/16/2015,19,10518,1521,5307,2648,0,232,20226
12/16/2015,20,10518,1519,5382,2526,0,235,20180
12/16/2015,21,10517,1193,5561,2367,0,237,19875
12/16/2015,22,10523,1103,4947,2180,0,233,18986
12/16/2015,23,10528,1101,4308,1970,0,234,18141
12/16/2015,24,10511,931,4070,1704,0,182,17398
12/17/2015,1,9935,910,3790,1314,0,98,16047
12/17/2015,2,9490,913,3453,1500,0,92,15448
12/17/2015,3,9361,908,3373,1652,0,91,15385
12/17/2015,4,9365,910,3487,1317,0,91,15170
12/17/2015,5,9364,909,3558,1369,0,90,15290
12/17/2015,6,9500,911,3498,1685,0,95,15689
12/17/2015,7,9875,909,4558,1236,0,103,16681
12/17/2015,8,10390,918,5018,1622,1,158,18107
12/17/2015,9,10520,918,5066,1411,1,135,18051
12/17/2015,10,10510,929,5198,1491,11,145,18284
12/17/2015,11,10508,932,5149,1459,18,149,18215
12/17/2015,12,10510,1033,4740,1466,41,104,17894
12/17/2015,13,10511,1203,4798,1124,43,96,17775
12/17/2015,14,10499,1377,4864,1070,87,101,17998
12/17/2015,15,10491,1506,4907,1075,43,103,18125
12/17/2015,16,10500,1623,4842,1269,14,97,18345
12/17/2015,17,10492,1895,5086,1323,0,114,18910
12/17/2015,18,10492,1919,5532,1669,0,195,19807
12/17/2015,19,10493,1915,5663,1702,0,223,19996
12/17/2015,20,10487,1914,5531,1803,0,224,19959
12/17/2015,21,10483,1916,4969,1674,0,184,19226
12/17/2015,22,10481,1589,4894,1387,0,201,18552
12/17/2015,23,10479,1075,4569,1285,0,212,17620
12/17/2015,24,10473,931,3990,1173,0,199,16766
12/18/2015,1,10290,931,3437,1010,0,116,15784
12/18/2015,2,9836,930,3502,940,0,72,15280
12/18/2015,3,9626,941,3477,1026,0,82,15152
12/18/2015,4,9630,1053,3492,898,0,70,15143
12/18/2015,5,9627,1277,3470,781,0,72,15227
12/18/2015,6,9617,1423,3798,1006,0,95,15939
12/18/2015,7,9776,1534,5016,848,0,91,17265
12/18/2015,8,10097,1537,5404,1050,0,90,18178
12/18/2015,9,10459,1537,5437,1088,4,95,18620
12/18/2015,10,10428,1538,5459,1308,14,94,18841
12/18/2015,11,10365,1535,5505,1269,41,92,18807
12/18/2015,12,10464,1220,5424,1200,81,98,18487
12/18/2015,13,10611,1134,5289,1102,52,89,18277
12/18/2015,14,10577,1261,5418,1133,40,91,18520
12/18/2015,15,10618,1413,4862,1381,27,91,18392
12/18/2015,16,10623,1485,4755,1582,18,107,18570
12/18/2015,17,10623,1342,5109,1777,1,164,19016
12/18/2015,18,10619,1341,5769,2084,0,205,20018
12/18/2015,19,10613,1343,5537,2079,0,205,19777
12/18/2015,20,10615,1349,5035,2405,0,203,19607
12/18/2015,21,10613,1350,4730,2154,0,146,18993
12/18/2015,22,10606,1033,4374,2399,0,100,18512
12/18/2015,23,10603,943,4040,2051,0,85,17722
12/18/2015,24,10594,939,3770,1727,0,26,17056
12/19/2015,1,10298,939,3563,1465,0,3,16268
12/19/2015,2,10036,940,3296,1536,0,3,15811
12/19/2015,3,9967,933,3239,1294,0,2,15435
12/19/2015,4,9731,887,3265,1245,0,2,15130
12/19/2015,5,9668,887,3274,1243,0,2,15074
12/19/2015,6,9640,886,3243,1736,0,2,15507
12/19/2015,7,9639,885,3475,1974,0,2,15975
12/19/2015,8,9807,887,3650,2199,1,2,16546
12/19/2015,9,10254,885,3976,2322,33,2,17472
12/19/2015,10,10548,883,3720,2614,82,2,17849
12/19/2015,11,10550,882,3775,2674,148,2,18031
12/19/2015,12,10549,881,3802,2666,155,1,18054
12/19/2015,13,10548,883,3814,2841,76,2,18164
12/19/2015,14,10548,882,3896,3053,34,2,18415
12/19/2015,15,10547,898,3881,2784,25,2,18137
12/19/2015,16,10551,913,3995,2695,14,2,18170
12/19/2015,17,10556,890,4628,2945,0,2,19021
12/19/2015,18,10549,867,5148,2899,0,2,19465
12/19/2015,19,10558,869,5010,2919,0,2,19358
12/19/2015,20,10587,877,4694,2950,0,2,19110
12/19/2015,21,10613,914,4371,2798,0,2,18698
12/19/2015,22,10611,916,4288,2743,0,3,18561
12/19/2015,23,10611,918,3623,2377,0,4,17533
12/19/2015,24,10615,919,3527,1919,0,3,16983
12/20/2015,1,10616,919,3596,1360,0,2,16493
12/20/2015,2,10618,920,3449,1248,0,2,16237
12/20/2015,3,10616,921,3454,811,0,3,15805
12/20/2015,4,10615,918,3394,704,0,3,15634
12/20/2015,5,10570,896,3179,521,0,4,15170
12/20/2015,6,10548,903,3207,555,0,5,15218
12/20/2015,7,10551,937,3542,569,0,7,15606
12/20/2015,8,10550,946,4078,804,0,6,16384
12/20/2015,9,10541,947,4347,1018,16,5,16874
12/20/2015,10,10541,942,4528,1418,47,5,17481
12/20/2015,11,10542,962,4088,1981,37,7,17617
12/20/2015,12,10540,981,3854,1783,70,6,17234
12/20/2015,13,10546,986,3822,1938,110,3,17405
12/20/2015,14,10508,986,3934,2250,66,3,17747
12/20/2015,15,10572,985,3978,2382,38,3,17958
12/20/2015,16,10627,983,4235,2355,15,3,18218
12/20/2015,17,10638,982,4546,2500,1,3,18670
12/20/2015,18,10646,974,5232,3060,0,3,19915
12/20/2015,19,10651,975,4962,2975,0,3,19566
12/20/2015,20,10650,1002,4490,2921,0,3,19066
12/20/2015,21,10313,1033,4332,3037,0,2,18717
12/20/2015,22,9894,1041,4392,3122,0,2,18451
12/20/2015,23,9893,1027,3667,2970,0,2,17559
12/20/2015,24,9921,1025,3176,2212,0,7,16341
12/21/2015,1,9910,970,3115,1404,0,16,15415
12/21/2015,2,9535,938,3223,1451,0,16,15163
12/21/2015,3,9371,978,3218,1510,0,15,15092
12/21/2015,4,9369,996,3219,1645,0,14,15243
12/21/2015,5,9376,1018,3298,1642,0,15,15349
12/21/2015,6,9372,1020,3270,1966,0,20,15648
12/21/2015,7,9641,1043,3614,2097,0,30,16425
12/21/2015,8,9909,1100,4066,2205,0,37,17317
12/21/2015,9,9906,1140,4246,2460,0,43,17795
12/21/2015,10,9922,1157,4378,2729,5,40,18231
12/21/2015,11,9922,1162,5067,2464,7,42,18664
12/21/2015,12,9918,1244,5307,2441,16,44,18970
12/21/2015,13,9914,1392,4851,2647,17,44,18865
12/21/2015,14,9914,1442,4609,2562,14,43,18584
12/21/2015,15,9922,1578,4324,2520,7,47,18398
12/21/2015,16,9927,1732,4271,2520,0,44,18494
12/21/2015,17,10103,1732,4609,2435,0,44,18923
12/21/2015,18,10083,1734,5472,2299,0,75,19663
12/21/2015,19,10084,1723,5433,2299,0,154,19693
12/21/2015,20,10089,1738,5079,2267,0,209,19382
12/21/2015,21,10085,1438,4951,2399,0,210,19083
12/21/2015,22,10073,1046,4566,2478,0,196,18359
12/21/2015,23,10072,938,3829,2305,0,112,17256
12/21/2015,24,10074,935,3712,1658,0,59,16438
12/22/2015,1,9973,930,3424,1280,0,18,15625
12/22/2015,2,9833,930,3122,1230,0,18,15133
12/22/2015,3,9838,931,3097,1197,0,20,15083
12/22/2015,4,9837,933,3086,1028,0,19,14903
12/22/2015,5,9833,933,3160,1038,0,20,14984
12/22/2015,6,9968,933,3409,1112,0,24,15446
12/22/2015,7,10091,931,3972,1026,0,33,16053
12/22/2015,8,10090,929,5072,906,0,39,17036
12/22/2015,9,10087,923,5587,859,1,59,17516
12/22/2015,10,10098,961,5805,911,3,71,17849
12/22/2015,11,10099,960,5806,884,12,101,17862
12/22/2015,12,10072,1114,5608,884,12,179,17869
12/22/2015,13,9921,1349,5243,832,24,217,17586
12/22/2015,14,9927,1741,5200,645,33,232,17778
12/22/2015,15,9927,1929,4933,693,17,239,17738
12/22/2015,16,9920,2221,5021,591,10,247,18010
12/22/2015,17,9928,2422,5823,516,1,245,18935
12/22/2015,18,9930,2424,6074,590,0,245,19263
12/22/2015,19,9929,2505,5894,594,0,242,19164
12/22/2015,20,9923,2500,5913,360,0,242,18938
12/22/2015,21,9919,2522,5881,254,0,240,18816
12/22/2015,22,9905,2675,5538,180,0,206,18504
12/22/2015,23,9925,1623,5409,174,0,133,17264
12/22/2015,24,10120,1344,4797,365,0,66,16692
12/23/2015,1,10308,1024,3786,779,0,45,15942
12/23/2015,2,10340,936,3112,1273,0,42,15703
12/23/2015,3,10324,935,2931,839,0,40,15069
12/23/2015,4,10342,936,2951,692,0,41,14962
12/23/2015,5,9969,921,3004,887,0,40,14821
12/23/2015,6,10097,912,3084,1308,0,38,15439
12/23/2015,7,10475,925,3562,1482,0,55,16499
12/23/2015,8,10480,914,3930,1570,1,61,16956
12/23/2015,9,10478,911,4065,1840,7,64,17365
12/23/2015,10,10468,904,4260,1754,22,59,17467
12/23/2015,11,10463,909,4526,1914,30,50,17892
12/23/2015,12,10433,895,4640,1927,50,64,18009
12/23/2015,13,10468,862,4440,1951,34,63,17818
12/23/2015,14,10465,856,4433,2150,43,49,17996
12/23/2015,15,10465,873,4361,2112,20,47,17878
12/23/2015,16,10493,900,4419,2254,5,42,18113
12/23/2015,17,10551,910,4679,2526,1,36,18703
12/23/2015,18,10547,911,4882,3136,0,36,19512
12/23/2015,19,10548,903,4841,3097,0,36,19425
12/23/2015,20,10547,906,4519,3184,0,36,19192
12/23/2015,21,10545,920,4438,3152,0,36,19091
12/23/2015,22,10540,915,3771,2924,0,36,18186
12/23/2015,23,10474,918,3217,2573,0,36,17218
12/23/2015,24,10153,908,3073,2130,0,29,16293
12/24/2015,1,9694,900,2982,1671,0,24,15271
12/24/2015,2,8885,873,3075,1671,0,17,14521
12/24/2015,3,8412,871,3136,1588,0,18,14025
12/24/2015,4,8405,895,3173,1043,0,20,13536
12/24/2015,5,8407,904,3212,999,0,23,13545
12/24/2015,6,8500,905,3185,1426,0,24,14040
12/24/2015,7,8507,907,3338,2140,0,30,14922
12/24/2015,8,8573,915,3448,2642,0,34,15612
12/24/2015,9,8873,921,3491,2664,9,35,15993
12/24/2015,10,9111,925,3541,2391,64,34,16066
12/24/2015,11,9196,915,3558,1997,124,35,15825
12/24/2015,12,9190,913,3706,1679,173,34,15695
12/24/2015,13,9188,885,3668,1328,187,34,15290
12/24/2015,14,9192,920,3681,1299,173,33,15298
12/24/2015,15,9190,927,3734,1408,111,34,15404
12/24/2015,16,9193,930,3755,1850,43,35,15806
12/24/2015,17,9372,931,4373,1825,2,34,16537
12/24/2015,18,9958,948,5531,1374,0,34,17845
12/24/2015,19,10397,937,4930,1260,0,35,17559
12/24/2015,20,10416,931,4415,1047,0,35,16844
12/24/2015,21,10410,835,4142,833,0,34,16254
12/24/2015,22,10401,810,3907,776,0,34,15928
12/24/2015,23,10411,789,3861,654,0,34,15749
12/24/2015,24,10418,486,3780,607,0,27,15318
12/25/2015,1,10401,375,3122,498,0,14,14410
12/25/2015,2,9992,379,3083,320,0,0,13774
12/25/2015,3,9459,380,3412,176,0,0,13427
12/25/2015,4,9229,379,3533,139,0,0,13280
12/25/2015,5,9229,378,3449,143,0,0,13199
12/25/2015,6,9231,384,3587,98,0,0,13300
12/25/2015,7,9237,380,4052,89,0,0,13758
12/25/2015,8,9383,378,4503,103,0,0,14367
12/25/2015,9,9757,376,4492,96,0,4,14725
12/25/2015,10,9982,376,4983,108,7,1,15457
12/25/2015,11,10125,379,4796,124,14,0,15438
12/25/2015,12,10137,398,4898,171,24,0,15628
12/25/2015,13,10373,406,4241,273,35,0,15328
12/25/2015,14,10387,404,4189,428,36,0,15444
12/25/2015,15,10379,403,4056,546,29,0,15413
12/25/2015,16,10376,402,4128,611,15,0,15532
12/25/2015,17,10646,404,4530,554,2,0,16136
12/25/2015,18,10674,400,5281,620,0,0,16975
12/25/2015,19,10677,399,5065,708,0,0,16849
12/25/2015,20,10678,372,4757,854,0,0,16661
12/25/2015,21,10672,368,4545,866,0,0,16451
12/25/2015,22,10673,369,4410,888,0,0,16340
12/25/2015,23,10667,365,4111,854,0,0,15997
12/25/2015,24,10663,368,3910,647,0,0,15588
12/26/2015,1,10411,369,3818,465,0,0,15063
12/26/2015,2,9910,374,3539,795,0,0,14618
12/26/2015,3,9615,374,3299,652,0,0,13940
12/26/2015,4,9277,386,3317,522,0,0,13502
12/26/2015,5,9025,407,3323,713,0,0,13468
12/26/2015,6,8941,397,3422,1251,0,0,14011
12/26/2015,7,9376,388,3388,1243,0,0,14395
12/26/2015,8,9968,437,3317,1223,0,0,14945
12/26/2015,9,10351,477,3328,1416,16,6,15594
12/26/2015,10,10430,480,3316,1651,52,6,15935
12/26/2015,11,10423,480,3694,1111,78,6,15792
12/26/2015,12,10424,479,3745,1375,64,6,16093
12/26/2015,13,10429,480,3844,1286,50,0,16089
12/26/2015,14,10447,483,3834,1578,37,0,16379
12/26/2015,15,10625,483,3883,1886,13,0,16890
12/26/2015,16,10670,484,3907,2105,6,0,17172
12/26/2015,17,10676,485,4188,2229,0,0,17578
12/26/2015,18,10674,485,4689,2184,0,0,18032
12/26/2015,19,10681,483,4631,2200,0,0,17995
12/26/2015,20,10679,483,4531,2024,0,0,17717
12/26/2015,21,10668,506,5339,1291,0,10,17814
12/26/2015,22,10670,509,5362,743,0,11,17295
12/26/2015,23,10664,504,4977,520,0,4,16669
12/26/2015,24,10674,499,4709,514,0,0,16396
12/27/2015,1,10489,481,3740,390,0,0,15100
12/27/2015,2,10205,504,3865,216,0,0,14790
12/27/2015,3,10138,490,3803,149,0,0,14580
12/27/2015,4,10137,484,3407,254,0,0,14282
12/27/2015,5,9899,483,3287,448,0,0,14117
12/27/2015,6,9992,483,3200,515,0,0,14190
12/27/2015,7,10081,481,3287,605,0,0,14454
12/27/2015,8,10224,480,3376,854,0,0,14934
12/27/2015,9,10371,522,3538,1066,0,0,15497
12/27/2015,10,10564,522,3523,1778,3,0,16390
12/27/2015,11,10826,577,3740,2145,7,0,17295
12/27/2015,12,11005,665,3761,2248,16,0,17695
12/27/2015,13,11128,783,3878,2006,10,0,17805
12/27/2015,14,10985,931,3853,2274,6,0,18049
12/27/2015,15,11069,949,4032,1848,8,0,17906
12/27/2015,16,11270,976,4116,1634,10,0,18006
12/27/2015,17,11316,1099,4231,1701,3,0,18350
12/27/2015,18,11299,1119,4674,2105,0,0,19197
12/27/2015,19,11307,1122,4752,1905,0,0,19086
12/27/2015,20,11318,1141,4659,1815,0,0,18933
12/27/2015,21,11315,1104,4175,1577,0,0,18171
12/27/2015,22,11274,1086,3890,1662,0,0,17912
12/27/2015,23,10515,757,4036,1733,0,0,17041
12/27/2015,24,10561,517,4006,1741,0,0,16825
12/28/2015,1,10644,493,3801,1208,0,6,16152
12/28/2015,2,10586,496,3537,951,0,2,15572
12/28/2015,3,10392,597,3635,824,0,0,15448
12/28/2015,4,10130,756,3304,1253,0,0,15443
12/28/2015,5,10109,896,3256,1475,0,1,15737
12/28/2015,6,10110,898,3560,1333,0,0,15901
12/28/2015,7,10111,906,3976,1157,0,0,16150
12/28/2015,8,10325,901,4168,1247,1,0,16642
12/28/2015,9,10590,900,4273,1440,11,0,17214
12/28/2015,10,10652,891,4292,1645,41,0,17521
12/28/2015,11,10650,609,4277,2304,71,1,17912
12/28/2015,12,10651,491,4368,2357,64,0,17931
12/28/2015,13,10648,610,4278,2401,47,0,17984
12/28/2015,14,10648,801,4155,2368,30,0,18002
12/28/2015,15,10684,956,4151,2481,16,0,18288
12/28/2015,16,10694,1074,4290,2335,4,0,18397
12/28/2015,17,10702,1078,4893,2561,0,0,19234
12/28/2015,18,10701,1082,5814,2670,0,0,20267
12/28/2015,19,10689,1081,5684,2649,0,0,20103
12/28/2015,20,10691,1078,5500,2578,0,0,19847
12/28/2015,21,10625,1079,5419,2594,0,0,19717
12/28/2015,22,10609,636,5176,2622,0,0,19043
12/28/2015,23,10611,492,4350,2623,0,0,18076
12/28/2015,24,10616,491,3743,2590,0,0,17440
12/29/2015,1,10614,490,3208,2551,0,8,16871
12/29/2015,2,10615,493,3113,1973,0,16,16210
12/29/2015,3,10607,497,3064,1753,0,16,15937
12/29/2015,4,10652,533,3132,1759,0,12,16088
12/29/2015,5,10658,569,3066,1865,0,18,16176
12/29/2015,6,10659,591,3138,1952,0,23,16363
12/29/2015,7,10676,745,3607,2031,0,26,17085
12/29/2015,8,10673,876,3946,2227,0,26,17748
12/29/2015,9,10668,931,4469,2192,0,40,18300
12/29/2015,10,10668,936,5058,2176,4,67,18909
12/29/2015,11,10663,941,4632,2117,10,79,18442
12/29/2015,12,10670,943,4533,2172,20,81,18419
12/29/2015,13,10682,929,4607,2357,23,79,18677
12/29/2015,14,10685,901,4665,2426,37,103,18817
12/29/2015,15,10685,986,4662,2259,18,116,18726
12/29/2015,16,10709,1090,4682,2326,8,86,18901
12/29/2015,17,10719,1153,4956,2104,0,77,19009
12/29/2015,18,10727,1154,5461,2092,0,88,19522
12/29/2015,19,10729,1157,5784,1997,0,90,19757
12/29/2015,20,10727,1156,5653,1948,0,102,19586
12/29/2015,21,10714,1154,5448,1823,0,109,19248
12/29/2015,22,10715,1156,5263,1681,0,103,18918
12/29/2015,23,10731,1013,4588,1493,0,88,17913
12/29/2015,24,10713,945,4433,1314,0,115,17520
12/30/2015,1,10715,944,3901,1154,0,40,16754
12/30/2015,2,10721,944,3634,996,0,3,16298
12/30/2015,3,10724,939,3494,798,0,3,15958
12/30/2015,4,10720,945,3578,637,0,3,15883
12/30/2015,5,10723,941,3719,578,0,3,15964
12/30/2015,6,10724,940,4108,535,0,3,16310
12/30/2015,7,10910,941,4716,527,0,16,17110
12/30/2015,8,11071,943,4963,335,0,39,17351
12/30/2015,9,11157,942,5506,284,0,73,17962
12/30/2015,10,11361,941,5594,205,3,147,18251
12/30/2015,11,11381,965,5528,227,8,173,18282
12/30/2015,12,11386,1074,5562,320,16,170,18528
12/30/2015,13,11391,1327,5218,441,14,143,18534
12/30/2015,14,11258,1558,5377,420,16,147,18776
12/30/2015,15,11365,1572,5360,301,10,168,18776
12/30/2015,16,11405,1579,5479,319,3,174,18959
12/30/2015,17,11451,1594,5812,315,0,169,19341
12/30/2015,18,11504,1724,6226,437,0,182,20073
12/30/2015,19,11505,1729,5947,530,0,180,19891
12/30/2015,20,11505,1566,5876,701,0,181,19829
12/30/2015,21,11504,1539,5570,785,0,180,19578
12/30/2015,22,11518,1101,5171,1010,0,133,18933
12/30/2015,23,11519,943,4277,1123,0,62,17924
12/30/2015,24,11524,937,3731,1005,0,15,17212
12/31/2015,1,11452,940,3336,928,0,3,16659
12/31/2015,2,11288,940,3113,851,0,3,16195
12/31/2015,3,11070,941,3032,663,0,3,15709
12/31/2015,4,10776,941,3032,564,0,3,15316
12/31/2015,5,10693,942,3138,989,0,3,15765
12/31/2015,6,10843,942,3117,1085,0,3,15990
12/31/2015,7,11227,943,3634,901,0,6,16711
12/31/2015,8,11297,951,4162,658,1,7,17076
12/31/2015,9,11403,948,4421,1062,2,5,17841
12/31/2015,10,11540,948,4461,1000,8,9,17966
12/31/2015,11,11540,949,4504,1327,13,10,18343
12/31/2015,12,11549,950,4451,1410,17,7,18384
12/31/2015,13,11532,947,4328,1562,22,3,18394
12/31/2015,14,11545,950,4154,1550,31,3,18233
12/31/2015,15,11546,947,4130,1420,31,3,18077
12/31/2015,16,11550,944,4571,1258,9,3,18335
12/31/2015,17,11550,945,4918,1452,1,3,18869
12/31/2015,18,11550,946,5171,1461,0,3,19131
12/31/2015,19,11551,948,5261,1482,0,3,19245
12/31/2015,20,11552,948,4830,1372,0,3,18705
12/31/2015,21,11550,946,4469,1504,0,4,18473
12/31/2015,22,11547,946,3930,1284,0,3,17710
12/31/2015,23,11556,944,3576,1441,0,3,17520
12/31/2015,24,11551,923,3213,1543,0,3,17233
